ID,Name,Power,Killpoints,Deads,T1 Kills,T2 Kills,T3 Kills,T4 Kills,T5 Kills,Total Kills,T45 Kills,Ranged,Rss Gathered,Rss Assistance,Helps,Alliance
179940560,ᴸᵛ k,101797771,624165539,4332796,2317026,868211,971623,35537052,13135435,52829347,48672487,0,6093678454,1873979817,81169,[LV21]Lords of Valinor
186145908,ʳᵉʸEscanor,88648171,1509738014,3712561,4272170,915441,1734412,124749839,12630833,144302695,137380672,0,3525293555,4398233340,22358,[LV21]Lords of Valinor
188540500,TakeMe2Valhalla,86066280,1450691759,5160258,12511616,5652155,10639829,106979181,16226700,152009481,123205881,0,2834278325,7061247251,44645,[LV21]Lords of Valinor
180304933,LilLƴ,78809844,310835931,3361470,2381705,2764385,3236435,17046340,6071084,31499949,23117424,0,1161908726,4870554697,22117,[LV21]Lords of Valinor
188858506,Cúchulainn 쵸,76569709,238811517,1945923,640335,273416,425482,21013013,1315228,23667474,22328241,0,4994945067,512651627,37248,[LV21]Lords of Valinor
179655012,ᴸᵛDØØPER,73929958,545841108,2483117,2452504,973544,1254625,34862614,9487944,49031231,44350558,0,8427275581,1451282008,38089,[LV21]Lords of Valinor
178695066,SokoDrake,69346696,110764976,2739209,966390,105667,147411,7890524,1543274,10653266,9433798,0,7839350887,115903540,17470,[LV21]Lords of Valinor
180560115,TripEhh,63060978,382282505,1420469,2306786,813884,294450,23200346,7350606,33966072,30550952,0,6655036837,1225250480,11306,[LV21]Lords of Valinor
184964288,ᴾᴿFïshböy,62555899,267323761,2100314,2057085,4656295,3958131,20536365,1820179,33028055,22356544,0,3459246433,632742525,38437,[LV21]Lords of Valinor
179977300,ᴸᵛTmulla,60669886,775621279,1802231,3860548,417684,1492228,43428983,16687753,65887196,60116736,0,6968070360,5600679937,17660,[LV21]Lords of Valinor
186009654,Dooby ᴼᴺᴱ,60418300,276262150,699771,2071412,347817,487446,25104921,1107662,29119258,26212583,0,7524655514,137216122,35307,[LV21]Lords of Valinor
188839265,A 10 Warthog,57571237,12330470,230642,42253,74269,128873,999555,83122,1328072,1082677,0,3695508836,724780894,10936,[LV21]Lords of Valinor
188341936,ᴸᵛ Vatson67,55988982,253770748,1694949,1326311,557828,595665,21826241,1587238,25893283,23413479,0,6483491203,384720155,41980,[LV21]Lords of Valinor
188918989,ᴼᴸ Kaymo,54854492,125177460,1092879,2484352,1386449,2529103,10279320,449904,17129128,10729224,0,3781874456,1075163587,41572,[LV21]Lords of Valinor
178814644,ᵁʷᵘØtòt,54612245,444858744,3140400,18550973,3385819,2356133,31505688,5494775,61293388,37000463,0,2295222519,2329433716,15846,[LV21]Lords of Valinor
182514982,ᴸoᵛeSalmon,51334676,376799183,2976384,17730788,655039,737772,24941470,5978858,50043927,30920328,0,5474784573,1000488180,52564,[LV21]Lords of Valinor
186985518,HornyAPOLLOS,51289206,223000625,1410219,2886798,1515750,3176209,18737023,965835,27281615,19702858,0,2760514801,594947984,18049,[LV21]Lords of Valinor
185836736,ᴸᵛMasonFTW,50617643,469451313,2378870,5724465,2214818,4769431,38471820,3004043,54184577,41475863,0,3356207047,2802859223,28665,[LV21]Lords of Valinor
180060983,ᴸᵛRumRamsey,49106207,361650345,2220332,95115478,5048028,991336,26651157,3102714,130908713,29753871,0,6040389106,417518493,93358,[LV21]Lords of Valinor
142628224,Dae jang goon,47125497,162550305,2387504,1946869,718048,367829,12883812,1520770,17437328,14404582,0,4895512429,102794418,16841,[LV21]Lords of Valinor
181825355,ᴸoᵛePUMA,47122712,216446119,1342478,1382047,359419,531778,15341020,2995678,20609942,18336698,0,3290245647,3599759382,35186,[LV21]Lords of Valinor
184871937,ScazBigLion,46948942,1216726311,4527691,56591135,23364142,26120855,94321262,5549188,205946582,99870450,0,5923543674,13704268108,20836,[LV21]Lords of Valinor
181308342,ᴸᵛRockSolid,46414933,186964373,2675960,2673547,709463,1391557,12483367,2730542,19988476,15213909,0,3441554811,5902949920,40482,[LV21]Lords of Valinor
176994964,Cpl Rage,45661173,114311798,476802,2377013,1506916,2122761,8942854,645149,15594693,9588003,0,1897067015,63265830,17101,[LV21]Lords of Valinor
185808036,Ze Bosh,45657049,324557669,903869,8598579,2626646,3862918,28938009,637645,44663797,29575654,0,5524831742,631820319,29935,[LV21]Lords of Valinor
188920797,FreyaFullBosom,45381742,85700883,1751730,1735115,953550,1150730,6844204,520090,11203689,7364294,0,3548149134,1323334617,24012,[LV21]Lords of Valinor
179750493,GuiltyMahiru,44682435,154270223,976622,2885917,770432,1180564,13125334,808829,18771076,13934163,0,1474960359,1965360302,39989,[LV21]Lords of Valinor
184826667,ᴸᵛAHERUS勇,43231290,513672701,1416939,12789309,5927578,11125761,44119962,677851,74640461,44797813,0,5860868288,1396853955,24942,[LV21]Lords of Valinor
182423962,シValkyrieCillaﾒ,42506008,115810413,1858806,5641345,822285,707431,8897411,1061687,17130159,9959098,0,5093331132,1265202822,15065,[LV21]Lords of Valinor
179813923,ㄴ Bless ㄱ,42294580,236773429,2185386,7761519,5947505,5144214,18830978,721974,38406190,19552952,0,2461122531,978016636,23406,[LV21]Lords of Valinor
181739549,kylinn,41829522,97526701,3321903,2389177,278410,278364,6880327,1328766,11155044,8209093,0,5128390117,10337862643,31310,[SFIS]Sky Fighters
185690465,Dictator  Goat,41597143,350310517,2053726,6070059,2159337,1277583,31857908,1054421,42419308,32912329,0,6070127366,1005155698,34940,[LV21]Lords of Valinor
188976136,ᴸᵛ MUSE,41189859,95702490,1184156,2079562,2348513,921788,7351764,669238,13370865,8021002,0,5154168948,365719425,47692,[LV21]Lords of Valinor
187247613,Queen Padmé,41166398,199823782,3146312,4400830,2992217,3977513,15780469,962222,28113251,16742691,0,7586639516,4488542203,86363,[LV21]Lords of Valinor
188241812,Gilgamesh2323,40501666,92731574,775600,2470154,200187,260810,8319215,380089,11630455,8699304,0,5056105684,62620586,24759,[LV21]Lords of Valinor
188785515,Johnvin,40487552,165186519,1692593,737645,467737,1071559,14239168,871280,17387389,15110448,0,4934158493,93446315,56655,[LV21]Lords of Valinor
188969478,ᴰᴹMePaul,40414804,87978111,983206,1953068,3290337,2573561,6140862,465198,14423026,6606060,0,3660479095,278578838,3516,[LV21]Lords of Valinor
188483360,ᴼᴸTryxan,39689633,200408316,1209835,21229570,2837205,2706913,15624592,1170721,43569001,16795313,0,6050495403,2169436768,40298,[LV21]Lords of Valinor
186199010,Daphneᴵᴿ,39539257,197063335,1701241,1778105,1269505,3330126,15047888,1518466,22944090,16566354,0,4161919681,1498857670,54985,[LV21]Lords of Valinor
187423027,ᴸᴳPandaFr3d,39141237,187064700,2048263,1957321,794040,914974,14509374,1816576,19992285,16325950,0,2826421917,6820681844,26192,[LV21]Lords of Valinor
188485523,ᴸᵛIMPERADOR,38880364,183385840,1007660,550634,31074,81329,14992345,1648240,17303622,16640585,0,6199693633,201752989,36529,[LV21]Lords of Valinor
188882878,Rtthyr,38874937,91535900,842990,232093,106385,116963,7877092,601897,8934430,8478989,0,7354654337,93046400,19186,[LV21]Lords of Valinor
185282531,Jëster,38399289,45496988,2695521,469962,132883,175975,4001273,221030,5001123,4222303,0,3451908286,592793562,26230,[LV21]Lords of Valinor
185457048,Cman9918,38231477,133602129,1160939,3704156,1184975,873737,11641776,528932,17933576,12170708,0,1996001700,126071365,16769,[LV21]Lords of Valinor
188880730,ᴸᵛMarlone,37662083,140317721,1911316,485948,371025,197873,11777629,1045535,13878010,12823164,0,5913990572,136720000,44694,[LV21]Lords of Valinor
180368631,ᴸᵛWinfields,37549699,164411936,4670313,23224272,189123,611409,12073974,1810173,37908951,13884147,0,5185935982,1877834074,13652,[LV21]Lords of Valinor
188651683,Sol Aliyaa,37464200,12427327,140221,119895,49805,35722,1146505,34790,1386717,1181295,0,3939718129,201676244,15519,[LV21]Lords of Valinor
178213242,ᶦˢLOCOOZ,37389810,135357462,3850546,2103734,957035,1554554,8056707,2311868,14983898,10368575,0,4368166294,1274602396,21890,[LV21]Lords of Valinor
187726069,ᵀᴿvSpryth,37295489,65857461,731133,1327439,163988,333442,5630975,381024,7836868,6011999,0,5429072341,15763287,23102,[LV21]Lords of Valinor
188303104,HokieHighlander,37151825,66064627,1304590,343718,109840,53066,5504852,525771,6537247,6030623,0,1052361096,84975248,13308,[LV21]Lords of Valinor
188569749,ᴵᴾEndoloris,37018743,135932617,1872172,1390988,2616276,1563397,10769220,823804,17163685,11593024,0,1822151378,163440000,5369,-
179816952,Hell CAT GTR,36941463,59619348,2896557,79058810,1765741,1889101,2592212,339879,85645743,2932091,0,5471658983,1636698071,10820,[LV21]Lords of Valinor
188648613,Känguruᴵᴰ,36524926,25517194,340067,377701,272323,171077,2089716,165777,3076594,2255493,0,2953884233,286935074,13509,[LV21]Lords of Valinor
188805469,BossAlienᴾᴴ,36230769,69982101,1237857,250538,604492,927660,5960481,270378,8013549,6230859,0,4971504024,134750966,39514,[LV21]Lords of Valinor
188789133,MiniMe,36216897,37392567,340034,258586,224998,167551,3406889,107588,4165612,3514477,0,4918800483,34179151,11696,[LV21]Lords of Valinor
189060019,Tušiš,36150857,82025285,775218,722106,635078,1036387,7046742,299887,9740200,7346629,0,2930345541,552362595,20196,[LV21]Lords of Valinor
189072394,ᴵᴾLaura,36070011,46649925,1312098,7341019,383206,780510,3626089,251619,12382443,3877708,0,6269170266,362529904,27198,[LV21]Lords of Valinor
182338045,亗ƧHiꟻT亗,36059015,134754048,1095353,2640524,1006449,1310254,8852061,1922571,15731859,10774632,0,5509973221,2515586970,32301,[LV21]Lords of Valinor
185048534,Han Sansan,35780152,129267326,816325,790111,342096,539228,11531464,547678,13750577,12079142,0,6056739907,357367305,31617,[LV21]Lords of Valinor
186444772,Dr4gonツ,35688112,260958571,3064361,5671315,3502249,3856115,22578811,580362,36188852,23159173,0,5324256195,4177255259,38617,[LV21]Lords of Valinor
188276623,ᴸᵛArork,35664010,85244332,934057,7261071,1265703,1364258,7039244,270562,17200838,7309806,0,3764696132,360935366,16458,[LV21]Lords of Valinor
189065897,W3llsFargo,35637085,36866964,662685,1191313,898257,213767,3194692,101510,5599539,3296202,0,3882437714,2754424297,18928,[LV21]Lords of Valinor
185341770,ᶜᵘRalfish,35152878,55383969,2488511,825738,394052,497142,4126843,558686,6402461,4685529,0,2674137443,25760000,15761,[LV21]Lords of Valinor
181534760,ᴸᵛSongoku,34703095,78588918,1418818,947363,718037,1206878,6729084,242251,9843613,6971335,0,3872250154,755945265,15856,[LV21]Lords of Valinor
188969981,ᵸᵒWand0,34351536,65261424,1286067,2054730,706949,524275,5320812,406568,9013334,5727380,0,4292634395,306699275,22599,[LV21]Lords of Valinor
188333348,ᴷᴺLinh,34347540,68182309,935539,1886379,1645656,5139453,3781263,307164,12759915,4088427,0,4866392540,550111352,11013,[LV21]Lords of Valinor
185089489,ᴼᴾZOROGRANJ,34332185,89977952,1885507,550571,355159,737615,7809122,405792,9858259,8214914,0,5703855206,2083599610,21232,[LG21]Lords of Gondor
185986678,卂尺丂,34129198,85165499,1209220,680685,1395198,1286689,7045359,331931,10739862,7377290,0,3322051623,1193919485,14866,[LV21]Lords of Valinor
188794709,ᶦᵗˢᵘRYU,33923748,105999414,993557,1318150,2549412,2529700,8464960,293428,15155650,8758388,0,3642039287,94094214,35579,[LV21]Lords of Valinor
189017405,ᵸᵒWizzy,33832518,36300354,1128087,812593,975948,1093260,2745400,117945,5745146,2863345,0,2733458729,170159151,14291,[LV21]Lords of Valinor
188336265,ᴸᵛiGREC,33750803,34239030,354919,533661,195122,279696,3003565,129381,4141425,3132946,0,2450337076,175934276,17225,[LV21]Lords of Valinor
188501467,direraven,33411811,97524912,744306,5169512,2366933,2785371,7053194,504186,17879196,7557380,0,4867310249,4551820,26992,[LV21]Lords of Valinor
188970345,PitBlue,33373245,100803181,862627,1120668,1623539,1658595,8170621,449569,13022992,8620190,0,3997584500,1077393393,22894,[LV21]Lords of Valinor
188826595,Saf1974,33277773,106999784,1400434,1284520,555245,574540,8517171,908126,11839602,9425297,0,5138726866,230946040,49350,[LV21]Lords of Valinor
182317160,G  O  P  A  Rr,33252528,165961188,1939750,3134912,2312668,2727770,14047011,466384,22688745,14513395,0,4138877688,738465485,28312,[LV21]Lords of Valinor
189154415,ᵸᵒMDKMB,33120120,64025434,785334,2572471,865337,727479,4950755,468140,9584182,5418895,0,2148591836,2596649243,19975,[LV21]Lords of Valinor
187029935,HolySpirit,32903390,130482449,1420613,1243047,1343710,1577860,11278752,422373,15865742,11701125,0,2699626296,1104079437,18498,[LV21]Lords of Valinor
190252265,Jamong,32856340,47896421,986556,240286,331111,224508,4124413,252199,5172517,4376612,0,5227282298,81003240,23467,[LV21]Lords of Valinor
188651684,Milo San,32839098,7521953,256838,5998,5637,18715,663262,40100,733712,703362,0,2967474331,359753808,11927,[LV21]Lords of Valinor
182713036,쵸ﾒMØTÃSÊMツ쵸,32705439,23711018,662283,107410,239091,451161,2068875,35898,2902435,2104773,0,5072388801,123301386,20338,[LV21]Lords of Valinor
188837916,Silent Kakashi,32590633,105876915,889638,839969,754922,750377,9809221,155268,12309757,9964489,0,1770919189,103761097,13997,[LV21]Lords of Valinor
188544046,G4mine,32447417,26635738,854807,262602,631545,296942,2070874,171181,3433144,2242055,0,4317317823,247760315,20193,[LV21]Lords of Valinor
188362493,亗MrDuck ツ,32406686,53343903,1162431,14212609,2043574,1147191,3945647,118450,21467471,4064097,0,2815936144,909611190,16730,[LV21]Lords of Valinor
185037763,ᵛBEARDY,32277187,51437912,2227119,28222212,2319488,801981,2906415,444121,34694217,3350536,0,4921911553,554484409,19513,-
188368264,funne,32215639,29061061,1265037,834275,642636,595616,2141909,190369,4404805,2332278,0,3758342275,61698120,16543,[LV21]Lords of Valinor
185612447,Chaudary Zain,32199983,144090805,1440237,9266996,1590757,914083,12340112,599922,24711870,12940034,0,4461057919,1323892732,25209,[LV21]Lords of Valinor
187559873,ｱ尺ﾉ丂ᄃﾉﾚﾚﾑ,31983704,62577567,524842,786256,540194,444292,5234590,360843,7366175,5595433,0,2629725287,626443180,15365,[LV21]Lords of Valinor
188736727,Alex9003,31943454,36474730,1660154,2964172,704741,765686,2511975,314496,7261070,2826471,0,4191027498,38138060,14279,[LV21]Lords of Valinor
188352541,ᴾᴿ Mèoッ,31837806,127518876,1258710,7188100,1700314,1303642,10538936,603835,21334827,11142771,0,6155018627,0,14364,[LV21]Lords of Valinor
188242643,hoahaizz,31780513,110848281,931394,3622569,968129,568030,9052325,769607,14980660,9821932,0,3743633739,567041937,29642,[LV21]Lords of Valinor
186841127,Anossss,31728098,92740074,1396074,5659752,161764,119554,8036040,522299,14499409,8558339,0,4227453465,4253401,14513,[LV21]Lords of Valinor
188451175,ᵸᵒTerra,31593505,59456104,870910,3422823,860914,534113,4795714,347806,9961370,5143520,0,4031048274,92432122,22399,[LV21]Lords of Valinor
188833519,JulieLaTueuse쵸,31492867,26083364,621039,141152,346846,94148,2242289,128098,2952533,2370387,0,3563842711,37720000,19818,[LV21]Lords of Valinor
185724517,Feldgraŭ,31158956,146940777,1759421,439339,3849630,1436815,11099577,1120531,17945892,12220108,0,4251264117,178066760,33312,[LV21]Lords of Valinor
188225231,ᴾᴿSko0p,31143188,32524184,356756,168570,89071,72567,3026488,87859,3444555,3114347,0,4545798280,0,27126,[LV21]Lords of Valinor
186765655,KönigsKlãsse,31119059,189652202,930323,2111571,1361404,1848800,15668954,1121117,22111846,16790071,0,3547614721,407789115,8107,[LV21]Lords of Valinor
189045190,Azura21,31097936,28813819,1079446,528436,682624,3020226,1479906,23146,5734338,1503052,0,2787495027,423984134,8058,[LV21]Lords of Valinor
190407807,동탄불주먹,30876273,26808448,1056665,693230,330666,695585,2029013,146800,3895294,2175813,0,5309697864,433522789,15376,[LV21]Lords of Valinor
188598120,ᶻSharineko〤,30532544,78037894,830245,858293,1456432,803718,5877148,648351,9643942,6525499,0,2367619167,51185747,16558,[LV21]Lords of Valinor
188847278,ᴸᵛQuang,30249275,140550013,1217495,1213518,1436737,1289374,12315180,456227,16711036,12771407,0,4084111339,1610824614,33588,[LV21]Lords of Valinor
188961098,Chocolalat,29975575,2573117,220977,51569,65233,15462,226397,5326,363987,231723,0,4167613453,21199999,3583,[LG21]Lords of Gondor
188836483,YenifferDeRivia,29968955,38806650,1193983,1783484,2318341,1691838,2651180,26706,8471549,2677886,0,3406965725,140738085,4879,[LR21]Lords of Rohan
184882401,Ферма а,29797791,92178131,1751595,22831138,3000621,3316968,6263461,285409,35697597,6548870,0,2669728364,3538154179,17468,[LV21]Lords of Valinor
177013392,ᴸᵛ UCC15,29704499,39005363,2664930,1200338,936753,880990,2885533,225625,6129239,3111158,0,5322754348,192271545,16134,[LV21]Lords of Valinor
188293704,ᴸᵛDrMusaab,29663753,41885366,1576702,191211,427716,173783,3585582,222037,4600329,3807619,0,3767930304,84578452,14466,[LV21]Lords of Valinor
188316323,ᴸᵛ SAKURA,29493292,100248419,1378468,2351048,1068606,1856632,8576471,222488,14075245,8798959,0,4128588153,539454569,26489,[LV21]Lords of Valinor
181581608,Fledermauz DB,29469721,32237433,694585,248895,300074,511759,2915789,19129,3995646,2934918,0,3577184021,377676127,7714,[LV21]Lords of Valinor
188797972,21LuviVilu21,29408384,19399984,1222428,579952,518648,328487,1463837,114719,3005643,1578556,0,4336553021,34539709,15805,[LV21]Lords of Valinor
185923730,JFDLCA,29380354,269931842,434687,5131053,3803977,6044357,22922445,394790,38296622,23317235,0,4712053420,386336005,36484,[LV21]Lords of Valinor
188262339,Kitty27,29162896,7152993,100178,54908,178359,33366,453425,105879,825937,559304,0,3799713498,23588840,10656,[LV21]Lords of Valinor
188789684,ᴿᵃtMadson,29094035,22711880,542169,1177460,162620,152532,1936728,108687,3538027,2045415,0,3908932521,72421016,40440,[LV21]Lords of Valinor
189001955,ᴸᵛTruNguyen,28846329,22782486,718506,844954,157659,366262,1932239,75537,3376651,2007776,0,4423174180,231678867,16341,[LV21]Lords of Valinor
185651937,ᴳᵃʸGrizzy,28827761,394704092,1530202,11881112,5833583,11664631,32492852,453683,62325861,32946535,0,3744084354,952357579,20305,[LV21]Lords of Valinor
188876886,ᴸᵛTheanh,28661784,125601253,1326532,617089,306133,579340,11483719,385551,13371832,11869270,0,5549097940,107966937,34373,[LV21]Lords of Valinor
188853241,Алёнаа,28643989,26362229,749181,246727,344883,856812,1737317,241135,3426874,1978452,0,4479339253,45525540,12925,[LV21]Lords of Valinor
188543996,ᴸᴳﾒNØHOPEツ,28568979,22008742,750166,321061,76882,175524,1884059,112404,2569930,1996463,0,3385662053,31608954,11619,[LV21]Lords of Valinor
188830020,ᴸᴳVersized,28541139,54879333,842032,600749,938250,417681,4508174,306511,6771365,4814685,0,3722835912,46055668,10428,[LV21]Lords of Valinor
188364390,ᴸᵛLeonPoi,28462240,149231276,1317830,495443,399103,640818,12955815,810628,15301807,13766443,0,3756359747,108004980,36382,[LV21]Lords of Valinor
186295211,ᶠˡVENDETTA,28458542,115576250,2742984,4081984,1084740,528626,9229579,909004,15833933,10138583,0,3885646386,1050356942,20067,[LV21]Lords of Valinor
188819438,ᴸᴳLuca,28424513,46044144,573803,296542,432636,250296,4088058,161890,5229422,4249948,0,4226971836,286280200,24190,[LG21]Lords of Gondor
185282573,ᴸᵛ3621 BANK,28344977,62632106,771884,668111,1267167,649115,4855577,440596,7880566,5296173,0,1360685180,923285969,8657,[LV21]Lords of Valinor
182720562,ᶜᴹᵈSkyy,28092367,19752884,2388318,291902,77615,310791,1289299,270156,2239763,1559455,0,3999667646,685652689,12498,-
186709522,ᴸᵛ SHERY,28006430,62181428,1562880,609853,401512,544566,5212383,347717,7116031,5560100,0,3407463504,99489407,9533,[LV21]Lords of Valinor
188944242,Đạt Feet,27928515,19953968,758416,769072,733958,1500022,1065295,83960,4152307,1149255,0,4562611659,16457231,9066,[LV21]Lords of Valinor
186043643,卂几Ҝ卂,27662342,56710111,1181956,888325,301712,375673,4840429,301102,6707241,5141531,0,3286294965,501165307,29845,[LV21]Lords of Valinor
188335709,Rebel Rogue,27578307,73969387,1366902,1040029,700124,771386,6274509,326525,9112573,6601034,0,3450487694,34205137,33710,[LV21]Lords of Valinor
188547640,Kitty8152,27383866,1630693,12032,78078,153637,150776,70470,0,452961,70470,0,6232060457,2547000,7582,[LG21]Lords of Gondor
188788713,Sam smith,27373007,32959149,760222,583097,331614,179458,2828243,158952,4081364,2987195,0,3889931323,33958258,12559,[LV21]Lords of Valinor
188880546,Graf000007,27262952,4086246,1602923,195112,206722,115320,276770,20240,814164,297010,0,3458927900,0,4003,[LG21]Lords of Gondor
185538462,UMAYKIZ,27237943,81648366,1210994,2427602,751593,861735,7001694,309789,11352413,7311483,0,4058555649,8566632,6413,[LV21]Lords of Valinor
188806334,Emrah 51,26971037,3751158,1312229,1012,10602,4008,371372,0,386994,371372,0,4126810750,0,4417,[LR21]Lords of Rohan
188294260,CЦEПИOH,26956093,10421111,1855157,581297,556310,288078,772954,15519,2214158,788473,0,2716905400,173206292,7519,[LG21]Lords of Gondor
188285810,ᴵᴰJupanu,26923573,46572577,1043044,864619,1573717,521185,3674114,221317,6854952,3895431,0,4774615279,57408174,19995,[LV21]Lords of Valinor
188852900,Scorpionking乂,26761806,81402827,2564465,698557,536746,1654576,6921922,217605,10029406,7139527,0,2209564738,58256706,31961,[LV21]Lords of Valinor
188453555,Puyols,26720609,53755829,1090161,414135,352520,193153,4625835,296850,5882493,4922685,0,6708756727,127173124,23952,[LV21]Lords of Valinor
188575943,BATUMSKİ08,26591929,122321723,2518476,8713459,9991171,6956425,6953415,161842,32776312,7115257,0,2787646071,529137921,20613,[LV21]Lords of Valinor
188872694,DELİ ÜSTAD,26475521,5962066,716649,208561,290491,524323,257508,33350,1314233,290858,0,4255062435,39905983,2108,[LG21]Lords of Gondor
189040679,ㄴHORIZONㄱ,26472811,74776471,764075,947828,1035889,885967,6855262,20932,9745878,6876194,0,4541244942,188105599,14263,[LG21]Lords of Gondor
188364525,ᴵᴾEmrys II,26412458,3119874,218964,53070,30135,8285,294045,3770,389305,297815,0,2091717356,0,2715,-
188319889,亗ChancellorT,26292095,19038322,395290,392020,290920,381817,1561679,61701,2688137,1623380,0,2876805661,1085215,13309,[LG21]Lords of Gondor
188877484,ᴵᵀBLOOM,26240463,73412319,1615750,429658,286070,678042,6496736,253736,8144242,6750472,0,1847010287,111895750,28933,[LV21]Lords of Valinor
189141193,ᴸᵛJankels,26081827,54078589,819486,2368695,1924928,2323951,3756563,144678,10518815,3901241,0,3300444942,28726902,16208,[LV21]Lords of Valinor
188818127,ᴿᶝ风华,25879894,2158531,1064759,62955,74067,33164,157987,14264,342437,172251,0,4125803307,64472747,3849,[LG21]Lords of Gondor
188192835,SвулканS,25837943,19947464,388225,2031363,306088,979874,1431780,34586,4783691,1466366,0,3364532541,52162299,9060,[LV21]Lords of Valinor
189939798,ʰᵒDestructor,25820014,18469100,52616,21684,68111,82633,1799801,0,1972229,1799801,0,2833941168,11281500,855,[LG21]Lords of Gondor
188806124,ᴵᴾAltar,25682493,111614407,1481141,3177848,4192360,2583327,8685363,270359,18909257,8955722,0,2531022967,7742830,26734,[LG21]Lords of Gondor
188939030,TBILISI,25613787,7839538,1253222,516150,1297487,330601,372081,4906,2521225,376987,0,3033892164,460258,11671,[LG21]Lords of Gondor
188836051,Cheops Pyramide,25503226,69241955,1096532,644865,285017,461502,6262634,203530,7857548,6466164,0,4412275791,751419894,36410,[LV21]Lords of Valinor
186010544,Mehmet027,25408589,55990992,1540749,1745924,1605817,1988711,4394543,26495,9761490,4421038,0,2998418962,173638054,8747,[LV21]Lords of Valinor
188835262,vinzsou,25342733,16369953,334531,46309,92071,38810,1474085,64023,1715298,1538108,0,2293899163,0,12949,[LV21]Lords of Valinor
188891048,7BeLa,25337382,57642914,872000,370252,777201,2820258,4394591,39376,8401678,4433967,0,3249200119,137794496,5868,[LG21]Lords of Gondor
188365363,diegokristy,25105509,42915909,464864,421018,640200,815724,3350701,239070,5466713,3589771,0,3724189269,246281206,15428,[LV21]Lords of Valinor
188855274,GOLTEB,25017985,127682614,1327294,1219432,175391,426239,11709807,414246,13945115,12124053,0,3368825262,35237187,41779,[LV21]Lords of Valinor
188320476,ᴿᵃЛиса,24936813,37818816,1141689,367832,506674,543458,3162843,146482,4727289,3309325,0,4769337707,362428945,39552,[LV21]Lords of Valinor
188912287,ᴸʳgCoelho,24907282,32322103,820622,1419717,814999,1014738,2403191,115865,5768510,2519056,0,2451677612,113818904,6925,[LV21]Lords of Valinor
146179581,lupepvp,24805533,11445255,602010,166315,115101,34970,951227,76482,1344095,1027709,0,5333141130,108915418,14915,[LV21]Lords of Valinor
184845080,ᴸᵛSCAR德,24784199,55014834,645401,187812,313729,200941,4908393,223106,5833981,5131499,0,3808049425,46674299,28077,[LV21]Lords of Valinor
84905552,Schwazzier,24677013,10472396,506526,147563,86882,62010,824074,89017,1209546,913091,0,3184466277,60672597,7972,[LV21]Lords of Valinor
188319008,ᴸᵛКэп21,24483757,10075514,29597,216150,128394,92909,914970,12708,1365131,927678,0,2233408969,0,10985,[LG21]Lords of Gondor
188324838,ХОНДА,24355553,7990779,1618420,319927,430706,215833,601619,9293,1577378,610912,0,2514329809,122738819,6012,[LR21]Lords of Rohan
188937309,Velikiy Govard,24184388,9823194,638326,125640,141509,280242,795672,21868,1364931,817540,0,2658730819,85678023,5224,[LG21]Lords of Gondor
189236516,ᴿᶝ年华,24141429,2290337,936926,56107,169818,48265,162204,6219,442613,168423,0,3737108678,48671853,2925,[LG21]Lords of Gondor
181974650,IDEM City,23791400,2030305,1163258,142285,141908,58538,141798,3295,487824,145093,0,3776027518,86095121,2071,[LG21]Lords of Gondor
184872506,ᴾᴿF A J A R,23766513,81330450,1396757,2282220,2097345,3030279,6197714,129053,13736611,6326767,0,3250277163,28252952,13422,[LG21]Lords of Gondor
185602720,ˢᵉAbdallah,23631965,37680310,200395,749910,727131,953454,2914261,155982,5500738,3070243,0,1707106341,127071312,9562,[LV21]Lords of Valinor
188840841,ᴸᵛNotZach,23578921,30110904,506333,591643,826092,444463,2318528,168863,4349589,2487391,0,1585804394,107725390,4480,[LV21]Lords of Valinor
185094982,Phi Dương F2P,23510261,38331232,1940175,2842133,5213473,4079345,964930,68459,13168340,1033389,0,2109637550,147926355,5350,[LV21]Lords of Valinor
188793523,FerAmaya,23454838,11963941,506442,129947,223590,105868,817780,144475,1421660,962255,0,3610487668,43532335,5232,[LV21]Lords of Valinor
188376202,ᴵᴾ云霄,23416323,6413730,1214571,147461,159504,83670,504869,34093,929597,538962,0,2593018500,17020000,4263,[LV21]Lords of Valinor
188390528,ᶦᶠAkrosh,23277756,14179254,358164,80861,884019,546131,1021052,0,2532063,1021052,0,1408491622,139317710,2243,[21If]Immortal Falcons
188994494,Snowplow,23056854,1094552,236306,8504,103749,19351,80795,0,212399,80795,0,2884348899,0,3451,[LR21]Lords of Rohan
188880486,Kỳ tiktok,22886927,8487802,1062340,68271,30446,79884,622510,93431,894542,715941,0,3888609792,0,3144,[LV21]Lords of Valinor
144563085,ᴵᶜPARANOIA,22856166,4730553,1770534,15817,22531,23272,408292,25316,495228,433608,0,2824407119,1021382,4809,[LG21]Lords of Gondor
188937116,ᴵᶜTom,22847232,4798418,78668,26543,281358,25756,401873,5432,740962,407305,0,2254933220,6485919,12148,-
188661481,Kängurufarm,22685146,2847269,781585,208965,117034,10247,253042,0,589288,253042,0,2409834236,1128542199,4146,[LG21]Lords of Gondor
188899189,QuantSist,22544102,1720056,385409,11624,68715,76283,127517,0,284139,127517,0,2045556445,296458,5522,[LG21]Lords of Gondor
185134660,PetitDr,22413048,3101404,85261,63894,67172,12418,288305,1078,432867,289383,0,1499181335,17979430,10865,-
188842111,JJ00,22308907,12581657,546042,13757,120082,40863,1073927,71801,1320430,1145728,0,2619609251,3999999,3638,[LV21]Lords of Valinor
188234979,iGRECfarm,22298461,15844038,286311,273003,46153,43158,1490992,30729,1884035,1521721,0,2703807026,315563112,10672,-
189057248,Cekko23,22201933,21794144,595985,139303,267141,394238,1780223,92641,2673546,1872864,0,3600194660,76002446,11262,[LV21]Lords of Valinor
191454845,ᴸᵛTueAnh,22646686,18757057,664298,42867,104981,279588,1608507,66755,2102698,1675262,0,5581371778,1009408023,11748,[LV21]Lords of Valinor
188851823,ᴸʳMent001,22090851,706360,45963,213744,185983,43829,11633,0,455189,11633,0,1960779946,0,2746,[LR21]Lords of Rohan
186016235,卂丂卂千,21966768,5455072,172363,142922,151729,14030,395527,55582,759790,451109,0,1901796534,12932669,3819,[LV21]Lords of Valinor
185905587,Ze Boshman,21929998,4802837,1158706,309125,97861,13805,369719,39644,830154,409363,0,2770839083,41584565,2619,-
188870613,xXVincinetteXx,21868756,8307709,1851059,867867,503902,29008,656394,22318,2079489,678712,0,4699104174,5876311,23600,-
188639928,The亗SCARFACE,21743294,2476955,64606,145589,285116,162864,116131,3242,712942,119373,0,3216210208,44040000,4300,[LG21]Lords of Gondor
188846843,BoboFranek,21704370,1436892,86860,96434,230127,133623,42286,0,502470,42286,0,1842439115,45731253,5585,[LG21]Lords of Gondor
188878743,Jetare,21671900,14895206,984262,914090,1762279,1205895,593283,21571,4497118,614854,0,3207276291,91210728,3000,[LV21]Lords of Valinor
188830522,ᴸʳTylnmrl,21599912,1670861,37663,32839,20609,4164,155652,2495,215759,158147,0,2261045846,16585000,4637,[LG21]Lords of Gondor
188255601,Ant Man21,21587050,21740037,261646,303216,192688,238972,1939567,47123,2721566,1986690,0,3143089623,0,3958,[LG21]Lords of Gondor
188337674,ᴵᴸAxan,21313802,13852737,908861,382486,81728,81286,1314956,6904,1867360,1321860,0,2629219749,376836150,9605,[OP1]OP CLAN
188838640,Presidente CIAO,21308494,3248958,61803,13150,115426,83389,268192,0,480157,268192,0,1633998877,23800000,4508,[LG21]Lords of Gondor
184817793,meto 313,21246237,2940073,2001835,184629,125724,112750,75554,72258,570915,147812,0,2961189642,1827622,1793,[LR21]Lords of Rohan
186018265,yıldırımsefa,20954512,12642300,258459,159713,850626,471324,812371,45005,2339039,857376,0,3099115891,50620184,8851,-
188889549,СЦEПИОН,20926077,2997871,1241527,21675,25683,72660,248333,8410,376761,256743,0,1923428853,102567597,3693,[LR21]Lords of Rohan
187503097,Romulus1991,20859938,29065913,179996,189776,70341,268479,2393394,193971,3115961,2587365,0,3818410187,82802391,17149,[LV21]Lords of Valinor
188819819,fox77778,20827083,3782562,738594,75581,204618,428450,164441,0,873090,164441,0,3301387202,1037349,4686,[LG21]Lords of Gondor
189036655,Vitia back 1990,20736043,9551108,2056000,172660,105414,21917,821704,50052,1171747,871756,0,2657262776,9800000,8571,[LR21]Lords of Rohan
188443825,йкйцк,20721165,48743894,1313992,1943111,2457331,1223280,2839555,507597,8970874,3347152,0,2532968576,1971457076,21172,-
188856715,ᴸᴳJackie,20620135,14142270,284873,80252,30041,24787,1275405,60647,1471132,1336052,0,1249994749,20000000,4061,[LV21]Lords of Valinor
188876948,Ruberoid,20460236,1308095,30041,24678,63862,55794,95226,0,239560,95226,0,1481823105,3846529,4610,[21If]Immortal Falcons
184819319,joe200,20426646,2022401,1197317,130789,249677,21520,45323,47879,495188,93202,0,1631673131,91263980,5852,[LG21]Lords of Gondor
183360513,ᵀᴸмønoメ,20415868,26110591,478300,186118,247673,221163,2277659,95839,3028452,2373498,0,2125813241,85509847,6981,[LG21]Lords of Gondor
188884272,ZHIANZD,20398835,1216090,246973,127800,150740,29760,77001,0,385301,77001,0,2488342395,0,2033,[LR21]Lords of Rohan
184859052,ᴸᵛamadxd1,20277982,10023642,1080886,167940,454668,303192,677143,54826,1657769,731969,0,2196328965,315992716,7081,[LV21]Lords of Valinor
188903920,JoshuaSeil,20270304,5346112,817155,57531,197583,100305,414492,19665,789576,434157,0,2945614962,301497,4019,[LV21]Lords of Valinor
188847403,Vali188847403,20263336,1805843,502942,88125,113717,240436,59904,0,502182,59904,0,1174440329,0,641,[_NDM]New Jersey Nol
188790227,СУЛИМАH,20234807,2937806,1265520,69552,52214,89972,230812,7573,450123,238385,0,1837825253,102878721,3411,[LR21]Lords of Rohan
188884453,dm152,20220031,261473,0,20838,55033,4660,12860,0,93391,12860,0,2667692032,0,4327,[LG21]Lords of Gondor
188325495,쵸 See La Meet 쵸,20218723,26136473,714725,1038428,1614240,1553702,1521512,63519,5791401,1585031,0,3512199870,0,7931,-
145631489,BABA SON,20073281,6127632,290848,136434,494296,267396,291067,56575,1245768,347642,0,2144912846,4400000,4799,[LV21]Lords of Valinor
188806434,ᴸᴳ Bimz,20019093,4858833,658635,38897,29786,6973,372389,51985,500030,424374,0,2953317864,29458520,9750,[LV21]Lords of Valinor
188836639,Ndiaye,20011621,5853377,660696,352077,491543,747064,181162,0,1771846,181162,0,2967907641,383503,1616,[LLA]Lost legion academia
188898779,kral jon snow,19738727,113087,6227,15339,20427,859,6573,0,43198,6573,0,2753058077,8327554,2899,[21If]Immortal Falcons
188857113,GritNGravy,19671984,1953070,46395,39362,14347,20181,183578,0,257468,183578,0,2932002636,3200971,3732,[LG21]Lords of Gondor
189075824,NooByZ,19621709,8523920,1530004,77034,121760,128921,748617,13157,1089489,761774,0,3365718003,99259891,19016,-
188261313,freezebee 21,19580571,2027071,234347,244875,375237,108803,79241,0,808156,79241,0,1749135846,5187959,14536,[LG21]Lords of Gondor
188232993,AKON311,19570367,17474104,658995,571073,531874,842388,1182997,54831,3183163,1237828,0,1770213436,850687088,12260,[LG21]Lords of Gondor
186613612,Inigo Montoya1,19518004,4781554,1455414,349831,116242,28761,403220,16593,914647,419813,0,2626562622,103076547,8548,[LV21]Lords of Valinor
191530671,ᶦᶠtMadsonn,19452754,1846035,34099,69047,86817,200703,85578,0,442145,85578,0,2628251362,910375198,4588,[LR21]Lords of Rohan
188539042,Chieu F2p,19425535,23706450,464904,857871,1727252,652023,1402402,172413,4811961,1574815,0,2115157774,35342934,11041,[LV21]Lords of Valinor
188814205,SUBUTAİ 38,19349422,1466044,274608,292102,181430,22696,95398,0,591626,95398,0,1962129755,3080000,2306,[LG21]Lords of Gondor
188430882,JapayuKingBILAT,19305349,13535022,558328,244614,718820,347450,998294,33786,2342964,1032080,0,2842930846,142262581,15396,[LV21]Lords of Valinor
188838663,ERON,19113610,7419903,732610,190505,250716,72425,647213,5927,1166786,653140,0,2000951222,20081022,12072,[LG21]Lords of Gondor
188818238,PoTaPyh,19086561,17945708,847850,488230,854873,981299,1155520,32896,3512818,1188416,0,3095818179,301072527,13039,-
188853064,TerrorBlade98,19083226,4698786,941546,120572,115534,39441,414286,7149,696982,421435,0,3336284105,0,1347,[LG21]Lords of Gondor
188282297,MinasTirith秋,19050064,67391767,1935936,4739757,348069,495597,5982319,197105,11762847,6179424,0,2949663138,2562027272,30485,-
188776545,ᴳᵒᵈ Ingle,18984968,1048600,93501,85140,135892,24107,66336,0,311475,66336,0,1698573935,3404666,5139,[LR21]Lords of Rohan
188845810,BARBALIAS,18899874,5080729,1177937,167048,291925,201260,352189,6827,1019249,359016,0,1731230822,0,5851,-
188869412,dân chơi đá,18877333,8228309,246570,288205,739830,1185717,194814,0,2408566,194814,0,2106256471,1154652,1641,-
188827507,Dug1man,18738440,106428,5346,18103,18794,0,6522,0,43419,6522,0,2522176166,0,2485,[LG21]Lords of Gondor
188360951,SATORUGOJO1,18452933,9398145,472927,508838,996498,575503,431459,34339,2546637,465798,0,1605356212,317828071,6669,[LV21]Lords of Valinor
188844580,RedHoodJT,18336017,3724748,210774,117223,615129,546669,28437,0,1307458,28437,0,1660838024,0,1451,[LR21]Lords of Rohan
188836606,Black AngEL,18316975,8655975,1937740,908418,995278,553139,422312,2403,2881550,424715,0,2137121812,18536152,1820,[LG21]Lords of Gondor
187197359,Demir Bilek,18279896,9273471,779097,120768,235808,174193,781889,13102,1325760,794991,0,2204678390,30192868,11149,[LG21]Lords of Gondor
188490339,Eudaimonia,18194656,5238222,227320,56910,36785,12770,453803,28208,588476,482011,0,3217760852,30962500,5617,[LG21]Lords of Gondor
188336750,SKY EAGLE,18136313,7121747,985124,330019,49903,45477,677403,0,1102802,677403,0,1931799839,213802552,9588,-
189014302,magister,18034793,11593788,947900,205152,1188782,528161,695989,5133,2623217,701122,0,1327725746,15363819,7383,[LG21]Lords of Gondor
188806199,Op khan,18021797,4774879,1311876,240925,827408,507637,83281,10426,1669677,93707,0,2868738669,4253716,3124,[LR21]Lords of Rohan
150165925,ᴸᴳken arok,17994523,19213481,614040,4461145,278014,115931,1557424,86363,6498877,1643787,0,2451531684,26909895,11125,[LV21]Lords of Valinor
188367613,ᶦᶠKinkyTail,18010081,28085998,652235,1415633,750063,721224,2111177,115304,5113401,2226481,0,969079636,42186939,11671,[LV21]Lords of Valinor
188865329,Việt hoang 07,17892195,607097,64769,419495,234049,900,5150,0,659594,5150,0,2214217502,1833721,888,[21M]Immortal Myrmidons
188884243,HiagoLira,17826049,1285899,1,5567,1871,82946,94926,0,185310,94926,0,1639328596,0,2363,[21If]Immortal Falcons
188787622,MalandrageX,17806659,20690,0,2434,1687,245,1585,0,5951,1585,0,2520328655,0,3277,[LG21]Lords of Gondor
189231766,darkkiller666,17669854,3746982,286312,236683,195194,50737,294065,8283,784962,302348,0,2533244060,20289481,14046,[LG21]Lords of Gondor
190852683,BossAlien FARM,17421235,6771910,168409,19244,81805,135783,606132,0,842964,606132,0,4274136271,1694123182,2647,[LR21]Lords of Rohan
188904786,Shadow vahalla,17295435,951871,236630,6845,11062,4462,91053,0,113422,91053,0,2836724714,0,3009,[LG21]Lords of Gondor
187016834,ƐƘÁ,17217297,5969476,107689,89142,174787,122716,511121,0,897766,511121,0,2748771134,1489060086,4795,[LR21]Lords of Rohan
188368666,Derik 災,17193465,17311218,78795,189202,156137,96806,1633226,12081,2087452,1645307,0,1504456225,57910439,4670,-
188487100,Kir8,17188463,744292,46498,47082,45400,57564,41382,0,191428,41382,0,604975853,0,4405,[LG21]Lords of Gondor
188879533,Qertt7,17089163,188791,322,8039,23990,816,10230,1682,44757,11912,0,4082466692,38000000,2148,[LG21]Lords of Gondor
196566747,Codrin4Valhalla,17056013,5520141,195307,259178,157063,124705,407542,28997,977485,436539,0,653908880,89594454,6178,[LV21]Lords of Valinor
188585266,メDragønメ,17046256,6200803,260935,13008,75292,24207,548489,23295,684291,571784,0,1565973095,73489482,19339,-
188503741,SİYAH KAZ,16994656,2745204,35926,148261,185391,246920,121345,7182,709099,128527,0,1557000457,38351774,6878,-
164927516,iven0007,16997177,10077159,800589,584997,950594,899393,404788,20676,2860448,425464,0,1100230102,29829009,5983,[LG21]Lords of Gondor
188823442,VIP shooter,16944425,3305125,846887,132688,41914,75500,277768,5754,533624,283522,0,1617663134,41800001,5163,[LG21]Lords of Gondor
188928573,Thànhteo,16834657,1269484,231737,5214,47138,152454,56435,0,261241,56435,0,1518718910,0,3090,[21M]Immortal Myrmidons
189068044,Hsotits7,16808848,13123610,995230,966771,1440390,1040579,499742,44487,3991969,544229,0,2102837958,16241240,3420,[LG21]Lords of Gondor
188824641,Sabesaur312,16783039,178017,72,61605,21023,10955,7983,0,101566,7983,0,717328751,0,1962,[LR21]Lords of Rohan
188833114,Quent2,16747166,22793082,342325,313030,76329,372177,1907169,100871,2769576,2008040,0,1453996284,21298007,10244,[LV21]Lords of Valinor
189181702,222mb222,16498210,2096107,769471,199359,63662,40288,176776,0,480085,176776,0,3060111650,225401626,1732,[LR21]Lords of Rohan
188845980,Azadi,16495090,2414584,591878,280392,474111,105066,99002,0,958571,99002,0,1862936476,3366983,1070,[I-am]RoyalLoyalMembers
189579148,стратег,16475452,2439007,1269763,90576,272116,146355,125592,1766,636405,127358,0,2309890690,1378833,2187,-
188868206,Quocbao05032012,16443045,1765350,652703,140343,12908,5049,169127,0,327427,169127,0,1733085895,6000000,2023,[LR21]Lords of Rohan
188861925,blackbandito,16360070,3299236,432177,181283,407143,143151,130863,28373,890813,159236,0,1478085947,24105565,1977,[LG21]Lords of Gondor
188432088,BandAid,16341404,6291099,303434,23738,88926,146960,503492,24287,787403,527779,0,2998496547,308659606,8309,[LG21]Lords of Gondor
188513738,MooSáke,16233970,198927,96089,15385,14235,12870,11590,0,54080,11590,0,1790394692,0,1221,[RC21]ROYAL CROWN
188894198,Tomioka senpai,16147774,379272,52185,4153,47557,61967,3546,0,117223,3546,0,2576870647,0,1807,[21If]Immortal Falcons
188852196,DarkExecutioner,16132302,1452447,100617,60616,84044,164244,61526,0,370430,61526,0,1216662089,28060602,1834,[TFS:]The Forsaken Souls
188823187,AZERBAIJAN90,16127248,891992,1273713,78632,32607,42323,49764,7206,210532,56970,0,2188918647,3040,1275,[~AKT]BR AKATSUKI
187880560,wcwc,16017764,230115722,1527635,19485000,18674475,23053443,9591814,36893,70841625,9628707,0,3214040764,596448438,13547,[21if]farm 21If
188876717,DEWO YEAGER,15905321,4619081,1089416,433008,785790,289890,180134,0,1688822,180134,0,2421182032,0,1725,[21if]farm 21If
188376429,ᴵᶜmySoul,15812605,447638,94861,165290,199177,4054,1,0,368522,1,0,1311135078,7488905,8464,[LR21]Lords of Rohan
188436016,KiLLedYouhaha,15677356,6294970,234650,186713,224968,166558,470080,22033,1070352,492113,0,2589194587,79055118,9750,[LV21]Lords of Valinor
187078010,Dr4gonsFarmerツ,15450978,22163921,1316246,641729,1799365,1256244,1338903,1142,5037383,1340045,0,2602487365,1725005764,7885,-
188825941,S0SKA,15447745,1189854,237525,181770,115056,123932,42766,0,463524,42766,0,1573181792,17191302,2471,[21M]Immortal Myrmidons
188134384,ˢ carlossainz,15380671,6601011,1300774,21788,65922,52235,498539,63524,702008,562063,0,1190118090,25406959,4001,[LG21]Lords of Gondor
188878343,Cheiron City,15325813,2006372,65708,76640,299335,127026,88427,0,591428,88427,0,1345077538,0,1658,[21if]farm 21If
188809474,Edgar15,15275743,46285,13168,43659,11087,2650,478,0,57874,478,0,2116886110,0,1245,[21M]Immortal Myrmidons
188879219,Akglate,15231878,247677,40137,19567,121882,0,0,0,141449,0,0,2071709078,1758755,592,[LR21]Lords of Rohan
186073361,卂尺丂Farm,15221962,3668107,345837,39537,204145,32135,312337,0,588154,312337,0,2285339693,489706596,1512,-
188857667,Apoathou,15147673,1322660,1124764,128214,19733,13903,120194,0,282044,120194,0,230139173,156690,1082,[LG21]Lords of Gondor
188781490,Fra1d,14963604,1187031,100258,39857,116341,94712,56753,0,307663,56753,0,1220961083,5509155,3143,[LG21]Lords of Gondor
188825002,Namiq Cebrayilo,14970647,3934535,1259596,213707,290110,151386,270603,0,925806,270603,0,2157174332,0,7127,[21MA]Myrmidons Academy
188877463,Se Tuath De,14931606,1904865,811661,93157,158781,182383,83914,0,518235,83914,0,2513469503,5600000,2404,[LG21]Lords of Gondor
190329472,F1Quang,14923627,14222941,1403680,76015,288128,303523,1225945,7897,1901508,1233842,0,3907726117,2734670795,8473,[LR21]Lords of Rohan
188858878,lisabella,14916438,237752,277117,67710,112105,0,0,0,179815,0,0,571086411,0,1607,[21M]Immortal Myrmidons
186035363,Klgi20,14910733,1079100,1084576,54111,135908,7883,18115,29189,245206,47304,0,1858912284,1200000,3126,[21If]Immortal Falcons
187560016,Kyubi Farm1,14903377,43242083,1156562,1634869,1976614,1528733,3245429,19633,8405278,3265062,0,1348799318,409430369,6744,[LG21]Lords of Gondor
188800436,LilPiglet,14862004,769658,220953,34240,152043,47076,27042,0,260401,27042,0,1362486306,0,1293,[LR21]Lords of Rohan
188365295,ᴿᵃTsumiki,14849316,2089406,0,8924,38778,19749,193107,0,260558,193107,0,1063300942,3762398,6032,-
188785649,priam,14810043,1750608,803133,48303,27617,11291,164055,0,251266,164055,0,1469952822,18007168,327,[tgqm1]amarl
189036275,TheBlackDragon,14751862,163506,24134,22964,32186,14353,3713,0,73216,3713,0,2029281597,0,1764,[LG21]Lords of Gondor
188963486,GÖZTEPELİ35,14745890,131575,0,26938,85,5222,10513,0,42758,10513,0,1956299993,230887100,3805,-
183848200,Ei Farm,14731064,38195393,1298931,2526718,1320489,1044558,2973860,56612,7922237,3030472,0,3111047090,519374881,13485,[LG21]Lords of Gondor
188281290,1GuiltyCrown1,14696109,19247655,1007323,1096697,1425467,992963,1183957,18298,4717382,1202255,0,3386925799,1967206382,17064,[LG21]Lords of Gondor
188863496,dark8582,14615579,408222,113485,9062,63839,37988,12678,0,123567,12678,0,1872766030,0,707,[jk10]jk 3621
188802524,Mickodem,14591192,193221,131028,1699,7453,9839,13862,0,32853,13862,0,1204501232,13257436,2987,[LG21]Lords of Gondor
12113325,Elena23EV,14563503,1817847,131418,8455,10921,55191,154067,1644,230278,155711,0,1110168978,24431024,5725,[LG21]Lords of Gondor
188986083,KyoHN,14511350,58505,16806,10125,15173,711,2329,0,28338,2329,0,2320890410,69,2856,[LG21]Lords of Gondor
188796842,Menda2137,14283951,321687,136804,21106,48638,8855,18477,0,97076,18477,0,1116877840,0,1469,[LR21]Lords of Rohan
188873290,FarmЛиса,14259213,5508494,596991,64191,23711,6956,527131,7455,629444,534586,0,1445614874,122800001,4138,[LG21]Lords of Gondor
188287771,ᅟᅠᅠᅠᅠᅟᅠᅠᅠᅠ ᅟᅠᅠ,14191865,55138144,428726,330732,673936,319444,5244635,0,6568747,5244635,0,5000896100,2156968833,28867,[LG21]Lords of Gondor
188885945,whyreall,14191004,1427513,1410059,61686,45602,10688,128122,0,246098,128122,0,1497367838,862617,2035,-
188858305,Palestine313,14127310,3028033,1334422,129577,527939,188640,119168,0,965324,119168,0,1380980727,0,4,[Alg]Palestine313
188847086,Dimiboy,14045754,75311,0,179,37638,0,0,0,37817,0,0,1215211623,0,23,[Tick]Tick tack
170835406,ᴵᶜ Has,13955620,1445859,679890,46009,32626,7559,101847,16135,204176,117982,0,687055286,298517,2940,-
188806889,Gouverneur188806889,13944353,785370,316714,61610,182543,80923,8427,0,333503,8427,0,1084023412,0,1024,[21MS]Myrmidons Farm
188931757,ᴸʳANTHRAX,13899726,659165,84307,164935,187652,32931,11915,0,397433,11915,0,1392553221,0,2094,[LR21]Lords of Rohan
188896546,БорисBao,13857624,1182765,168254,14668,118405,170863,25957,0,329893,25957,0,1761224189,22966398,1423,[LR21]Lords of Rohan
188856535,HOIANA,13839015,1190153,693357,435295,160981,54643,43890,6183,700992,50073,0,1765591108,400000,1166,[21if]farm 21If
188953179,SarahVinyard017,13756390,5795264,260817,103502,87804,304494,438098,0,933898,438098,0,1388844714,31860199,3832,[LG21]Lords of Gondor
188832666,ChifOJ,13637833,2361104,125471,94442,41533,55215,203829,0,395019,203829,0,2521454361,0,533,[21IR] Corral
44936497,젝스킹,15991483,6996924,923387,39204,54846,41378,523118,74135,732681,597253,0,2183506756,0,9052,-
191177358,RtthyrFarm,13443830,52258,8925,14892,0,0,4928,0,19820,4928,0,3508328088,1594265331,1137,[LG21]Lords of Gondor
188787790,You  andl,13347703,920284,416012,51124,134014,82128,31352,0,298618,31352,0,1320000643,4084888,1936,[LR21]Lords of Rohan
187795145,SOTER,13336432,8447735,539910,529189,65018,309343,652149,22650,1578349,674799,0,1281516203,112215799,15241,[LG21]Lords of Gondor
191069538,Shinnygamyy,13259416,3037148,499817,235031,755080,228183,56725,0,1275019,56725,0,1083252012,5089962,691,-
187257305,HolySpirits,13221458,4186335,271743,116035,83670,59317,375642,105,634769,375747,0,1164962213,477259605,5804,[21If]Immortal Falcons
188836866,zlucifer,13134321,2684582,271491,220751,328964,145856,139908,0,835479,139908,0,1701695970,0,1524,-
188837379,안정아남자,13123803,885792,199719,262430,137821,8581,52334,0,461166,52334,0,1839746876,0,1102,[LG21]Lords of Gondor
185484265,Tors228,13083005,7740094,636018,1305674,1878812,627539,120762,178,3932965,120940,0,1312958755,25325363,7376,-
193596249,Korkusuz 51,12958052,239160,358859,12402,0,0,23668,0,36070,23668,0,1401609699,60357336,943,[LR21]Lords of Rohan
188817273,Munmon,12901737,1116310,211912,39551,42589,125343,52185,0,259668,52185,0,2476678488,0,125,-
188291209,ROCKS  D  XEBEC,12853105,3694092,969555,42334,42629,46712,328702,6325,466702,335027,0,1822462533,37349860,9225,[jk10]jk 3621
188845348,ᴸʳLUNICTUS,12837874,104914,26926,6884,16888,8978,3385,0,36135,3385,0,1548657979,0,453,[LR21]Lords of Rohan
190539451,puyolF,12788234,972686,309560,2673,66571,105265,41795,0,216304,41795,0,4642338924,1818372170,2032,[LR21]Lords of Rohan
188292201,쵸Bear,12762411,3636617,863462,127956,652623,13205,183272,21012,998068,204284,0,1398516677,0,8400,-
188887466,Jensamtresen,12655435,2851467,834974,287219,392239,254799,99035,0,1033292,99035,0,877409886,10799999,841,[I-am]RoyalLoyalMembers
123456386,Igoryan,12525193,4604101,193112,1352415,222892,143876,329557,838,2049578,330395,0,1342704802,11392165,1300,[LG21]Lords of Gondor
188899884,hanaaaa230,12522618,3656113,993138,112016,538707,284659,141766,0,1077148,141766,0,1474873878,3785937,1103,[K~R~]3621 Utility Box
192581999,LilitЛиса,12405100,3348907,2586,4079,12074,27936,321220,0,365309,321220,0,2081766181,516525710,3587,[LG21]Lords of Gondor
188986347,Pimpammm,12386241,390745,21517,13926,70135,29655,12907,0,126623,12907,0,1444868924,9172286,4484,[OP1]OP CLAN
189266244,ᴵᴾRágnär,12376390,2424921,681640,338989,350984,104124,70352,26757,891206,97109,0,245500638,11642489,7444,-
142371438,NokedliF11,12302691,3005981,754566,516818,830716,67154,61715,17771,1494174,79486,0,1496304971,2400001,10465,[21M]Immortal Myrmidons
188816893,WARRIOR FARM 10,12298512,242793,17769,22009,47558,10254,10226,0,90047,10226,0,1311205884,0,1891,[21If]Immortal Falcons
178904209,MorFarm2,12182432,243458,0,0,0,3117,23099,0,26216,23099,0,1692919713,335244116,803,-
188829162,Mkジinsane,12152527,911799,856240,15867,56941,24326,65024,2360,164518,67384,0,1543783586,1400000,3486,[LR21]Lords of Rohan
188880051,qftydhunvfezbjj,12100235,18338939,1337013,1249255,1030656,1111224,1086802,35743,4513680,1122545,0,1422326310,88951930,7822,-
190430624,IMPERADOR FARM,12042430,449281,436505,3716,0,322,44725,0,48763,44725,0,4734124241,2527734725,1557,[LR21]Lords of Rohan
188900034,Rajpoots,11995365,854381,223016,55556,81433,13291,62724,0,213004,62724,0,1864778635,0,3109,[LG21]Lords of Gondor
188217778,ᴵᴰKing Nemo,11974922,1852509,716667,684238,272077,322,117022,0,1073659,117022,0,1857331281,0,12936,-
185259121,Lets go Os,11960614,913938,1168728,282,16846,7330,13445,35821,73724,49266,0,1375527451,4800000,1575,[LG21]Lords of Gondor
188479340,ㅡᅟᅟF2P 8      ㅡ,11891971,9974813,173571,883535,766581,262971,721306,0,2634393,721306,0,2712491721,956471741,8845,[LG21]Lords of Gondor
188838338,boble 79,11868832,306757,46338,1697,52760,41937,3315,0,99709,3315,0,1273489470,0,2119,[21MA]Myrmidons Academy
188952266,ErDegui,11804335,7108681,230822,125436,58773,125367,620570,12944,943090,633514,0,1173596936,13045768,5397,[LG21]Lords of Gondor
188946350,BaabyyKiller,11764448,45777543,823248,1480408,3397133,2896319,2635750,37221,10446831,2672971,0,1760569996,20189360,9196,-
187384799,C H A D 3 3 3,11746674,5025006,638494,336794,550030,58137,356220,3142,1304323,359362,0,942780690,0,4530,[LG21]Lords of Gondor
188819203,Cominogr,11691827,347521,71452,268238,123679,11074,222,0,403213,222,0,1674650487,0,850,[ANTB]ANnti Banned Club
188887462,Dunks,11594070,1538565,760926,36818,198678,122594,64347,0,422437,64347,0,1107672787,0,1040,[LR21]Lords of Rohan
187155907,Yuzhi,11574734,5032590,1641848,115533,189407,294655,290433,27386,917414,317819,0,2031355980,257605,2009,[LR21]Lords of Rohan
188801943,Brunk100,11490847,938220,200395,171290,279130,31043,22153,0,503616,22153,0,1330342807,2513093,2827,[21If]Immortal Falcons
188363322,쵸Belmont,11471499,726781,18931,225245,250029,43961,583,0,519818,583,0,1181365988,1410552,11058,-
185877603,ㄴ Aurelio ㄱ,11431660,3426162,734268,194294,519109,17374,220713,3623,955113,224336,0,909665868,1758080,3481,[LG21]Lords of Gondor
188900167,Charles grand 3,11405778,4207791,779277,591939,722430,168606,197012,0,1679987,197012,0,1768784449,8400000,915,[Tick]Tick tack
188892262,Udi lopez,11350308,286475,30519,120358,27289,7419,17815,0,172881,17815,0,259364387,3001045,1837,[21If]Immortal Falcons
188885079,ᴵᶜnoobhuhu,11287294,4932153,869902,263679,640053,58918,316980,9692,1289322,326672,0,1694858992,26599999,5002,-
188856725,Uranusuki,11259481,268914,32838,25630,66282,25841,2786,0,120539,2786,0,810300318,3859996,719,[LR21]Lords of Rohan
188840453,La pampara,11236164,3361807,943783,169799,430270,305562,124506,0,1030137,124506,0,1459453200,0,306,[21if]farm 21If
184327666,ツاحمدᴰᴮ,11192367,2577997,532046,681079,488185,101508,80134,12902,1363808,93036,0,1429069279,72130,2218,[LV21]Lords of Valinor
174523518,ㅡᅟᅟF2P 5      ㅡ,11192049,3700033,325966,825415,1309771,123637,42086,0,2300909,42086,0,2231549845,808382628,2416,[LG21]Lords of Gondor
188307234,ᴵᵀJessyS2,11159564,3418968,138406,130180,168640,9783,301652,0,610255,301652,0,1509177777,180913621,6306,-
188818543,GodAnubis,11155982,3265470,842158,347813,333503,280538,140675,0,1102529,140675,0,1219611149,473118,748,[21IR] Corral
188840730,FurkiTolki,11118560,1839593,1140153,3217,12856,72657,143339,4461,236530,147800,0,1674302274,3600000,2030,[21M]Immortal Myrmidons
189182502,ᴵᶜVatson67F,11024173,137197,213594,1669,4693,617,12501,0,19480,12501,0,3462431502,1724148322,1601,[LR21]Lords of Rohan
188818957,alonsoisma,11015317,2300239,762386,25316,47973,75270,189815,0,338374,189815,0,1520667888,4826393,1396,[LR21]Lords of Rohan
189443468,Hubey,10948714,2171604,462536,189562,257421,35910,147521,0,630414,147521,0,918945909,0,1967,-
188320795,Fïshböy F1,10866585,1130852,410313,146172,398,5918,103727,1994,258209,105721,0,1502906063,649927741,1097,[LR21]Lords of Rohan
189007908,vua đại du,10847143,2010095,594035,32817,68882,36737,135324,18279,292039,153603,0,1664459657,27506603,6095,-
188309795,ᴵᶜ TAZIEX,10844048,8618161,951227,435439,559362,399095,559725,10936,1964557,570661,0,1632163083,0,8839,-
188817859,oktaev,10640795,401425,359467,33669,31021,2770,32157,0,99617,32157,0,1078709555,0,100,[DD21])Dragon of Death
188839518,Zaragoza,10633166,1181120,88062,120100,376712,100919,0,0,597731,0,0,1410347159,0,1120,[LR21]Lords of Rohan
188847841,Lj1208,10594812,314850,314434,984,0,1961,30681,0,33626,30681,0,1172899928,0,904,[21If]Immortal Falcons
188889920,Carolk,10385443,642390,541227,49383,96269,35954,29616,0,211222,29616,0,1154274410,1349311,322,[fagr]alpha table
189182788,Vatson67f3,10363013,260412,485136,2684,4031,13106,19939,0,39760,19939,0,3447099036,1133268751,1350,[LR21]Lords of Rohan
117517315,ᴵᶜBOTAN,10360428,13712356,945529,506093,1444925,965222,611992,37024,3565256,649016,0,1235813199,498018246,20006,-
188522411,Ваn,10341550,1095208,3365,36724,120447,26500,74097,0,257768,74097,0,727419882,1,2218,[21If]Immortal Falcons
189442766,Gubernur189442766,10299474,77204,41779,1313,9937,12737,612,0,24599,612,0,2474805806,1989430704,706,[21IR] Corral
195403312,môngcổ,10266207,1446809,783623,85946,65345,87040,95077,0,333408,95077,0,1259796129,0,1035,-
188295840,ッ Yakuza ッ 6,10205094,395204,0,3871,70818,40591,9043,0,124323,9043,0,992758872,82882904,4847,[21if]farm 21If
188906315,ᴵᶜИвaн,10115924,1248369,45240,148765,274837,58418,43527,0,525547,43527,0,943901017,16348226,12804,-
188840603,andyrendy,10073872,1722850,894100,10373,99042,247058,53446,0,409919,53446,0,1032365452,0,459,[Slon]Slonii
188899095,Minuz,10077590,1614469,364375,167345,306671,102167,55899,0,632082,55899,0,721786492,0,1694,[LR21]Lords of Rohan
188300029,Hoàng Saa,10033084,5137975,463048,87026,120041,279872,368510,3795,859244,372305,0,1261504636,9873378,8148,[LR21]Lords of Rohan
188857096,Di 1,10019335,909985,10470,103819,160058,85834,22577,0,372288,22577,0,934774982,1843151,2952,-
188881481,678907,9987200,4054167,576543,566707,812285,378314,80300,0,1837606,80300,0,1222845461,53227,1512,[LLA]Lost legion academia
189285062,Linh farm 2,9969596,9739359,1413236,1086939,10938,8479,938116,4251,2048723,942367,0,5421938176,3128768761,1815,[LR21]Lords of Rohan
189869613,Алёнааа,9843753,3146615,691598,31047,82951,360086,153416,0,627500,153416,0,1469270043,503089664,1094,[GW21]GOATED WARRIORS
188898591,Dthomas,9838220,468487,81006,125157,122286,22516,10882,0,280841,10882,0,434478065,0,1343,[LR21]Lords of Rohan
188471943,NoCoboY,9816138,413116,95171,64153,54918,15880,22693,0,157644,22693,0,1081418218,0,3619,[LG21]Lords of Gondor
188846435,psilva3,9706543,1390439,255473,331056,379662,122656,7428,0,840802,7428,0,938223457,0,583,[21IR] Corral
189915380,BJXXX,9702866,4168395,1002299,38629,16464,369203,265093,0,689389,265093,0,1405441613,0,1626,[LR21]Lords of Rohan
194265891,쵸MØTÃSÊMツ쵸 2,9772269,2112115,0,5126,24684,21098,197733,0,248641,197733,0,1401383201,125453620,1372,[LG21]Lords of Gondor
191785327,ᴿᵃQueen,9625702,3017237,247312,228656,300820,10824,232657,0,772957,232657,0,2123392947,813781963,1187,[LR21]Lords of Rohan
186988267,Panda ᴸᴺ,9616784,2766515,1120377,7927,2980,11995,264463,3318,290683,267781,0,3082740466,512115698,1981,-
188962647,卂几Ҝ卂2,9578262,2082291,325396,3405,6149,30163,194866,0,234583,194866,0,1618176948,1219440595,2004,[LR21]Lords of Rohan
188844387,Dark omen,9537255,3440562,757307,393182,695255,208669,113674,0,1410780,113674,0,1006196711,188732373,3911,[TFS:]The Forsaken Souls
188815675,KōbøLord,9517898,145859,16647,15805,9235,19277,4712,0,49029,4712,0,843374303,0,1696,[LR21]Lords of Rohan
186065635,MASONFTW WOOD,9501931,1910931,810165,6189,9403,5772,186780,0,208144,186780,0,1676823126,950725213,1283,[LR21]Lords of Rohan
188790900,Dom Daddy,9486409,3388766,1222043,27914,83403,91562,276497,4258,483634,280755,0,1764988253,0,1443,[OP1]OP CLAN
