ID,Name,Power,Killpoints,Deads,T1 Kills,T2 Kills,T3 Kills,T4 Kills,T5 Kills,Total Kills,T45 Kills,Ranged,Rss Gathered,Rss Assistance,Helps,Alliance
179940560,ᴸᵛ ink,103239901,641100700,4332796,2556731,868211,971623,36847634,13324505,54568704,50172139,0,6140001983,1873979817,81821,[LV21]Lords of Valinor
188540500,TakeMe2Valhalla,85853610,1452108729,5160258,12511616,5652155,10639829,107120878,16226700,152151178,123347578,0,2834278325,7061247251,44686,[LV21]Lords of Valinor
186145908,ʳᵉʸEscanor,85754181,1529355190,3712561,4655002,915441,1734412,126358994,12803286,146467135,139162280,0,3550490685,4498233340,22575,[LV21]Lords of Valinor
180304933,LilLƴ,78805224,320790462,3361824,2782862,2764385,3236435,17772190,6201874,32757746,23974064,0,1170004249,5020554697,22334,[LV21]Lords of Valinor
188858506,Cúchulainn 쵸,76761393,249045604,1946106,713072,273416,425482,21811325,1427049,24650344,23238374,0,5065211387,552651627,37729,[LV21]Lords of Valinor
179655012,ᴸᵛDØØPER,76225969,546315064,2487869,2616693,973544,1255147,34880353,9501026,49226763,44381379,0,8476610689,1471282008,38330,[LV21]Lords of Valinor
178695066,SokoDrake,69521216,111516376,2739209,966390,105667,147411,7965664,1543274,10728406,9508938,0,7949224866,115903540,17599,[LV21]Lords of Valinor
180560115,TripEhh,63138134,401422644,1420469,2616534,813884,294450,24694543,7557417,35976828,32251960,0,6676653726,1225250480,11316,[LV21]Lords of Valinor
179977300,ᴸᵛTmulla,62715520,775621279,1802231,3860548,417684,1492228,43428983,16687753,65887196,60116736,0,6986046478,5600679937,17699,[LV21]Lords of Valinor
184964288,ᴾᴿFïshböy,62635359,269979041,2107093,2057085,4656295,3958131,20674973,1883639,33230123,22558612,0,3500326493,632742525,38808,[LV21]Lords of Valinor
186009654,Dooby ᴼᴺᴱ,59865616,291055795,699771,2460788,347817,487446,26344666,1223578,30864295,27568244,0,7606762914,137216122,35671,[LV21]Lords of Valinor
188839265,A 10 Warthog,58183885,12330470,230642,42253,74269,128873,999555,83122,1328072,1082677,0,3734979244,724780894,11099,[LV21]Lords of Valinor
188341936,ᴸᵛ Vatson67,56133042,268833908,1694949,1326311,557828,595665,23068111,1719461,27267376,24787572,0,6569911311,384720155,42234,[LV21]Lords of Valinor
178814644,ᵁʷᵘØtòt,55081959,444858744,3140400,18550973,3385819,2356133,31505688,5494775,61293388,37000463,0,2295222519,2329433716,15898,[LV21]Lords of Valinor
188918989,ᴼᴸ Kaymo,55066631,125177460,1092879,2484352,1386449,2529103,10279320,449904,17129128,10729224,0,3808277288,1075163587,41638,[LV21]Lords of Valinor
182514982,ᴸoᵛeSalmon,51218220,402462962,2976384,17816580,655039,737772,27169916,6146966,52526273,33316882,0,5491036998,1060488180,52850,[LV21]Lords of Valinor
185836736,ᴸᵛMasonFTW,50807001,470304243,2378902,5724465,2214818,4769431,38553207,3005996,54267917,41559203,0,3360417953,2802859223,28701,[LV21]Lords of Valinor
186985518,HornyAPOLLOS,50398022,231878732,1468969,2892482,1515750,3176209,19587198,984596,28156235,20571794,0,2765686093,594947984,18123,[LV21]Lords of Valinor
180060983,ᴸᵛRumRamsey,48495435,372980062,2220332,115639914,5048028,991336,27285932,3146568,152111778,30432500,0,6096830365,417518493,94005,[LV21]Lords of Valinor
184871937,ScazBigLion,48244198,1217022721,4527691,56591135,23364142,26120855,94350903,5549188,205976223,99900091,0,5925433539,13704268108,20867,[LV21]Lords of Valinor
181308342,ᴸᵛRockSolid,48132788,187242543,2676039,2673547,709463,1391557,12511026,2730621,20016214,15241647,0,3443690050,6002949920,40776,[LV21]Lords of Valinor
142628224,Dae jang goon,47842502,163659155,2387504,1946869,718048,367829,12969389,1533424,17535559,14502813,0,4921553708,102794418,16920,[LV21]Lords of Valinor
181825355,ᴸoᵛePUMA,46367624,224481913,1342478,1450618,359419,531778,15955680,3089452,21386947,19045132,0,3290245647,3599759382,35326,[LV21]Lords of Valinor
188920797,FreyaFullBosom,46327443,91726750,1751730,1764654,953550,1150730,7328032,579174,11776140,7907206,0,3609174052,1323334617,24212,[LV21]Lords of Valinor
176994964,Cpl Rage,45840250,114315818,476905,2377013,1506916,2122761,8943256,645149,15595095,9588405,0,1910844064,63265830,17119,[LV21]Lords of Valinor
185808036,Ze Bosh,45657049,324557669,903869,8598579,2626646,3862918,28938009,637645,44663797,29575654,0,5524831742,631820319,29935,[LV21]Lords of Valinor
179750493,GuiltyMahiru,44727817,170017490,976622,2932954,770432,1180564,14459134,928822,20271906,15387956,0,1489342278,2025360302,40344,[LV21]Lords of Valinor
184826667,ᴸᵛAHERUS勇,43400422,513672701,1416939,12789309,5927578,11125761,44119962,677851,74640461,44797813,0,5939147541,1446853955,25045,[LV21]Lords of Valinor
179813923,ㄴ Bless ㄱ,42475973,236773429,2185386,7761519,5947505,5144214,18830978,721974,38406190,19552952,0,2493602433,978016636,23498,[LV21]Lords of Valinor
182423962,シValkyrieCillaﾒ,42335019,116461763,1859110,5641345,822285,707431,8901168,1092376,17164605,9993544,0,5101320318,1265202822,15161,[LV21]Lords of Valinor
181739549,kylinn,41829522,97526701,3321903,2389177,278410,278364,6880327,1328766,11155044,8209093,0,5128390117,10337862643,31310,[SFIS]Sky Fighters
185690465,Dictator  Goat,41789132,350310517,2053726,6070059,2159337,1277583,31857908,1054421,42419308,32912329,0,6136047104,1005155698,35012,[LV21]Lords of Valinor
187247613,Queen Padmé,41642018,206445398,3171048,4415860,2992217,3977513,16277592,1044591,28707773,17322183,0,7672680960,4648542203,87087,[LV21]Lords of Valinor
188241812,Gilgamesh2323,41397395,107486898,858128,24164471,200187,260810,9191245,464897,34281610,9656142,0,5111726388,62620586,25314,[LV21]Lords of Valinor
188976136,ᴸᵛ MUSE,41306496,98252030,1184156,2079562,2348513,921788,7589404,677895,13617162,8267299,0,5178653584,365719425,48041,[LV21]Lords of Valinor
188969478,ᴰᴹMePaul,40700204,91594451,983206,1953068,3290337,2573561,6497964,467464,14782394,6965428,0,3704991893,278578838,3575,[LV21]Lords of Valinor
188785515,Johnvin,40654205,170904059,1692593,738996,467737,1071559,14709297,922079,17909668,15631376,0,4951631450,93446315,56952,[LV21]Lords of Valinor
188483360,ᴼᴸTryxan,40332167,200408316,1209835,21229570,2837205,2706913,15624592,1170721,43569001,16795313,0,6108748961,2169436768,40422,[LV21]Lords of Valinor
187423027,ᴸᴳPandaFr3d,39851868,187853630,2048263,1957321,794040,914974,14588267,1816576,20071178,16404843,0,2849115211,6820681844,26270,[LV21]Lords of Valinor
186199010,Daphneᴵᴿ,39570385,199358295,1701241,1778105,1269505,3330126,15273890,1520213,23171839,16794103,0,4182897058,1498857670,55332,[LV21]Lords of Valinor
188485523,ᴸᵛIMPERADOR,39272022,194318576,1007660,600362,31074,81329,15846910,1767097,18326772,17614007,0,6243727731,281752989,36915,[LV21]Lords of Valinor
188882878,Rtthyr,39056109,97058353,842990,232908,106385,116963,8286205,673455,9415916,8959660,0,7465205768,93046400,19414,[LV21]Lords of Valinor
185282531,Annıɛ,38580849,45496988,2695521,469962,132883,175975,4001273,221030,5001123,4222303,0,3456998406,592793562,26265,[LV21]Lords of Valinor
186765655,KönigsKlãsse,38516364,201219856,930323,2111571,1361404,1850126,16813409,1127007,23263517,17940416,0,3593126333,407789115,8405,[LV21]Lords of Valinor
185457048,Cman9918,38231477,133602129,1160939,3704156,1184975,873737,11641776,528932,17933576,12170708,0,1996001700,126071365,16769,[LV21]Lords of Valinor
187726069,ᵀᴿvSpryth,37987544,65878818,731133,1372570,163988,333442,5632208,381024,7883232,6013232,0,5495726639,15763287,23443,[LV21]Lords of Valinor
180368631,ᴸᵛWinfields,37750563,165249366,4670313,23224274,189123,611409,12141439,1818312,37984557,13959751,0,5229630288,1877834074,13731,[LV21]Lords of Valinor
178213242,ᶦˢLOCOOZ,37716814,139155605,3850546,2141345,957035,1554554,8335675,2361915,15350524,10697590,0,4376264944,1274602396,22049,[LV21]Lords of Valinor
188880730,ᴸᵛMarlone,37696995,140359101,1911316,485948,371025,197873,11781767,1045535,13882148,12827302,0,5959048572,136720000,44901,[LV21]Lords of Valinor
188651683,Sol Aliyaa,37556300,12427327,140221,119895,49805,35722,1146505,34790,1386717,1181295,0,3967345637,201676244,15548,[LV21]Lords of Valinor
188303104,HokieHighlander,37462871,70664918,1498746,344971,109840,53066,5807172,604613,6919662,6411785,0,1074205799,84975248,13522,[LV21]Lords of Valinor
179816952,Hell CAT GTR,37403531,59843748,2896557,79058810,1765741,1889101,2614652,339879,85668183,2954531,0,5512842125,1636698071,10858,[LV21]Lords of Valinor
189060019,Tušiš,37353838,82068235,775218,722106,635078,1036387,7051037,299887,9744495,7350924,0,2962455184,572362597,20404,[LV21]Lords of Valinor
188569749,ᴵᴾEndoloris,37018743,135932617,1872172,1390988,2616276,1563397,10769220,823804,17163685,11593024,0,1822151378,163440000,5369,-
188648613,Känguruᴵᴰ,36553614,25538784,340214,377701,272323,171077,2091875,165777,3078753,2257652,0,2953884233,286935074,13516,[LV21]Lords of Valinor
188789133,MiniMe,36526052,38822357,340034,258586,224998,167551,3543518,110763,4305416,3654281,0,4988406665,34179151,11806,[LV21]Lords of Valinor
188805469,BossAlienᴾᴴ,36319961,69990201,1238059,250538,604492,927660,5961291,270378,8014359,6231669,0,5009332198,134750966,39856,[LV21]Lords of Valinor
189072394,ᴵᴾLaura,36296986,49846939,1312098,13850638,383206,780510,3810508,254164,19079026,4064672,0,6301284744,362529904,27317,[LV21]Lords of Valinor
182338045,亗ƧHiꟻT亗,36137720,134754048,1095353,2640524,1006449,1310254,8852061,1922571,15731859,10774632,0,5535479569,2515586970,32381,[LV21]Lords of Valinor
188276623,ᴸᵛArork,36097066,85975102,934057,7261071,1265703,1364258,7111817,270814,17273663,7382631,0,3816920043,360935366,16565,[LV21]Lords of Valinor
185048534,Han Sansan,35862904,135645165,816325,909706,342096,539228,12049948,606132,14447110,12656080,0,6136114257,357367305,31877,[LV21]Lords of Valinor
189065897,W3llsFargo,35856002,36866964,662685,1191313,898257,213767,3194692,101510,5599539,3296202,0,3950571293,2754424297,19000,[LV21]Lords of Valinor
186444772,Dr4gonツ,35498902,274255716,3169933,5679943,3502249,3856115,23842015,613531,37493853,24455546,0,5330698271,4327255259,39110,[LV21]Lords of Valinor
188333348,ᴷᴺLinh,35486192,69285283,935539,1902695,1645656,5139453,3850216,327673,12865693,4177889,0,4931623028,550111352,11048,[LV21]Lords of Valinor
185341770,ᶜᵘRalfish,35227182,56693661,2488511,836048,394052,497142,4218442,578268,6523952,4796710,0,2694197853,25760000,15899,[LV21]Lords of Valinor
181534760,ᴸᵛSongoku,34754439,78665598,1418818,947363,718037,1206878,6736752,242251,9851281,6979003,0,3892866977,755945265,15918,[LV21]Lords of Valinor
185986678,卂尺丂,34400182,85165499,1209220,680685,1395198,1286689,7045359,331931,10739862,7377290,0,3322054768,1193919485,14952,[LV21]Lords of Valinor
185089489,ᴼᴾZOROGRANJ,34332185,89977952,1885507,550571,355159,737615,7809122,405792,9858259,8214914,0,5703855206,2083599610,21232,[LG21]Lords of Gondor
188969981,ᵸᵒWand0,34190884,65852934,1286067,2054730,706949,524275,5336241,428429,9050624,5764670,0,4299659159,306699275,22624,[LV21]Lords of Valinor
188826595,Saf1974,34066686,110024792,1400434,1286164,555245,574540,8756715,939588,12112252,9696303,0,5203093254,230946040,50199,[LV21]Lords of Valinor
188336265,ᴸᵛiGREC,34051010,35173980,354919,533661,195122,279696,3044464,155679,4208622,3200143,0,2450337076,175934276,17328,[LV21]Lords of Valinor
189017405,ᵸᵒWizzy,33892994,36841204,1128087,812593,975948,1093260,2799485,117945,5799231,2917430,0,2753368797,170159151,14414,[LV21]Lords of Valinor
188970345,PitBlue,33727231,100803181,862627,1120668,1623539,1658595,8170621,449569,13022992,8620190,0,4033756191,1077393393,22926,[LV21]Lords of Valinor
188794709,ᶦᵗˢᵘRYU,33545861,108216104,998511,1318150,2549412,2529700,8632725,320380,15350367,8953105,0,3698710704,94094214,35714,[LV21]Lords of Valinor
189154415,ᵸᵒMDKMB,33489585,64103924,785334,2572471,865337,727479,4956452,469216,9590955,5425668,0,2180277834,2686649252,20132,[LV21]Lords of Valinor
182317160,MALAM 1 SURO,33349753,169220948,1939750,3134912,2312668,2727770,14363163,471296,23009809,14834459,0,4216028863,738465485,28659,[LV21]Lords of Valinor
190252265,Jamong,33112929,47902221,986556,240286,331111,224508,4124993,252199,5173097,4377192,0,5281464124,81003240,23565,[LV21]Lords of Valinor
182713036,쵸ﾒMØTÃSÊMツ쵸,32962839,25080698,662283,107410,239091,451161,2205843,35898,3039403,2241741,0,5144567943,123301386,20449,[LV21]Lords of Valinor
187029935,HolySpirit,32846533,130844299,1427540,1243047,1343710,1577860,11312459,423612,15900688,11736071,0,2699705942,1104079437,18571,[LV21]Lords of Valinor
188362493,亗MrDuck ツ,32814585,54077183,1162431,14223855,2043574,1147191,3984118,135766,21534504,4119884,0,2839273891,909611190,16856,[LV21]Lords of Valinor
185612447,Chaudary Zain,32666280,144415515,1440237,9266997,1590757,914083,12372583,599922,24744342,12972505,0,4550802050,1323892732,25330,[LV21]Lords of Valinor
188837916,Silent Kakashi,32667633,105876915,889638,839969,754922,750377,9809221,155268,12309757,9964489,0,1789397269,103761097,14021,[LV21]Lords of Valinor
188501467,direraven,32639442,101959682,744306,5169512,2366933,2785371,7330725,587159,18239700,7917884,0,4907079903,4551820,27220,[LV21]Lords of Valinor
188651684,Milo San,32535357,7567393,256838,5998,5637,18715,667806,40100,738256,707906,0,2973774593,359753808,11956,[LV21]Lords of Valinor
188736727,Alex9003,32502657,36551480,1660154,2964172,704741,765686,2519650,314496,7268745,2834146,0,4198532382,38138060,14313,[LV21]Lords of Valinor
188368264,funne,32382103,29062881,1265037,834275,642636,595616,2142091,190369,4404987,2332460,0,3773760975,61698120,16605,[LV21]Lords of Valinor
185037763,ᵛBEARDY,32277187,51437912,2227119,28222212,2319488,801981,2906415,444121,34694217,3350536,0,4921911553,554484409,19513,-
188451175,ᵸᵒTerra,32203925,59456104,870910,3422823,860914,534113,4795714,347806,9961370,5143520,0,4047685039,92432122,22424,[LV21]Lords of Valinor
187559873,ｱ尺ﾉ丂ᄃﾉﾚﾚﾑ,31983704,62577567,524842,786256,540194,444292,5234590,360843,7366175,5595433,0,2629725287,626443180,15368,[LV21]Lords of Valinor
188352541,ᴾᴿ Mèoッ,31925771,127518876,1258710,7188100,1700314,1303642,10538936,603835,21334827,11142771,0,6172559629,0,14376,[LV21]Lords of Valinor
186841127,Anossss,31785166,96562733,1396074,5831747,161764,119554,8329768,564848,15007681,8894616,0,4248664515,4253401,14602,[LV21]Lords of Valinor
188225231,ᴾᴿSko0p,31732195,32664714,356756,168570,89071,72567,3031465,92397,3454070,3123862,0,4545798280,0,27174,[LV21]Lords of Valinor
188833519,JulieLaTueuse쵸,31626253,26213054,621039,141152,346846,94148,2255258,128098,2965502,2383356,0,3564320030,37720000,19884,[LV21]Lords of Valinor
188242643,hoahaizz,31392967,116699839,931394,3648605,968129,568030,9517984,829095,15531843,10347079,0,3793147052,567041937,30017,[LV21]Lords of Valinor
189045190,Azura21,31318457,28813819,1079446,528436,682624,3020226,1479906,23146,5734338,1503052,0,2787495027,423984134,8105,[LV21]Lords of Valinor
190407807,동탄불주먹,31221510,27047417,1056665,1020079,330666,695585,2046373,146800,4239503,2193173,0,5328868075,433522789,15509,[LV21]Lords of Valinor
185724517,Feldgraŭ,31168175,146940777,1759421,439339,3849630,1436815,11099577,1120531,17945892,12220108,0,4251264186,178066760,33359,[LV21]Lords of Valinor
188598120,ᶻSharineko〤,31069208,82378447,830245,875997,1456433,803718,6199089,704231,10039468,6903320,0,2372670934,63185747,16947,[LV21]Lords of Valinor
188797972,21LuviVilu21,31004948,19399984,1222428,579952,518648,328487,1463837,114719,3005643,1578556,0,4387363081,34539709,15894,[LV21]Lords of Valinor
188847278,ᴸᵛQuang,30829731,151155063,1217495,1245616,1436737,1289374,13345039,471229,17787995,13816268,0,4112704507,1610824614,34100,[LV21]Lords of Valinor
184882401,Ферма а,30470747,92480601,1751855,22831138,3000621,3316968,6293708,285409,35727844,6579117,0,2673583185,3538154179,17492,[LV21]Lords of Valinor
181581608,Fledermauz DB,30380777,32274033,694585,248895,300074,511759,2919449,19129,3999306,2938578,0,3577184021,377676127,7751,[LV21]Lords of Valinor
188961098,Chocolalat,30132047,2573117,220977,51569,65233,15462,226397,5326,363987,231723,0,4195968087,21199999,3592,[LG21]Lords of Gondor
177013392,ᴸᵛ UCC15,30131910,39005363,2664930,1200338,936753,880990,2885533,225625,6129239,3111158,0,5362048660,192271545,16178,[LV21]Lords of Valinor
188293704,ᴸᵛDrMusaab,29781905,42059156,1576702,191214,427716,173783,3595411,225812,4613936,3821223,0,3819448418,84578452,14556,[LV21]Lords of Valinor
188789684,ᴿᵃtMadson,29635871,23099920,542169,1177460,162620,152532,1968376,112265,3573253,2080641,0,3940361649,72421016,40978,[LV21]Lords of Valinor
188335709,Rebel Rogue,29620048,74045507,1366902,1040029,700124,771386,6274509,330331,9116379,6604840,0,3461719024,34205137,33747,[LV21]Lords of Valinor
188316323,ᴸᵛ SAKURA,29588020,101688536,1378468,2386732,1137444,2024123,8639005,222488,14409792,8861493,0,4136993026,539454569,26569,[LV21]Lords of Valinor
185923730,JFDLCA,29447231,271071322,434687,5131053,3803977,6044357,23029831,398071,38407289,23427902,0,4747607246,386336005,36628,[LV21]Lords of Valinor
188364390,ᴸᵛLeonPoi,29202653,150569646,1317830,495443,399103,640818,13052284,829312,15416960,13881596,0,3794072637,108004980,36587,[LV21]Lords of Valinor
188262339,Kitty27,29161686,7513813,100178,54908,178359,33366,483795,108735,859163,592530,0,3860752081,23588840,10856,[LV21]Lords of Valinor
189001955,ᴸᵛTruNguyen,29104062,23592016,718506,844954,157659,366262,2007146,78560,3454581,2085706,0,4463047120,231678867,16509,[LV21]Lords of Valinor
188853241,Алёнаа,28973926,26518459,749181,246727,344883,856812,1740378,247416,3436216,1987794,0,4540355235,45525540,13026,[LV21]Lords of Valinor
185651937,ᴳᵃʸGrizzy,28913873,394704092,1530202,11881112,5833583,11664631,32492852,453683,62325861,32946535,0,3744084354,952357579,20305,-
188830020,ᴸᴳVersized,28670833,58802573,848699,636445,938250,417681,4795904,358451,7146731,5154355,0,3792306518,46055668,10672,[LV21]Lords of Valinor
188944242,Đạt Feet,28661134,20875568,758416,769072,733958,1500022,1135993,94691,4233736,1230684,0,4619311582,16457231,9169,[LV21]Lords of Valinor
188543996,ᴸᴳﾒNØHOPEツ,28632947,22466962,750300,321061,76882,175524,1923229,115730,2612426,2038959,0,3389074234,31608954,11739,[LV21]Lords of Valinor
186295211,ᶠˡVENDETTA,28538370,115576250,2742984,4081984,1084740,528626,9229579,909004,15833933,10138583,0,3885646386,1050356942,20077,[LV21]Lords of Valinor
186709522,ᴸᵛ SHERY,28441773,62185658,1562880,609853,401512,544566,5212806,347717,7116454,5560523,0,3409511725,99489407,9543,[LV21]Lords of Valinor
188819438,ᴸᴳLuca,28439041,46045724,573803,296542,433426,250296,4088058,161890,5230212,4249948,0,4237092261,286280200,24195,[LG21]Lords of Gondor
188876886,ᴸᵛTheanh,28387764,134005320,1326532,17866823,306133,579340,11591861,579186,30923343,12171047,0,5577999424,107966937,34839,[LV21]Lords of Valinor
185282573,ᴸᵛ3621 BANK,28364577,62632106,771884,668111,1267167,649115,4855577,440596,7880566,5296173,0,1373861367,2053285969,8663,[LV21]Lords of Valinor
188788713,Sam smith,28117323,33664469,760222,594797,331614,179458,2873137,171654,4150660,3044791,0,3901741159,33958258,12616,[LV21]Lords of Valinor
182720562,ᶜᴹᵈSkyy,28092367,19752884,2388318,291902,77615,310791,1289299,270156,2239763,1559455,0,3999667646,685652689,12498,-
186043643,卂几Ҝ卂,27875921,58302421,1181956,888325,301712,375673,4956172,322846,6844728,5279018,0,3299636108,501165307,30375,[LV21]Lords of Valinor
188547640,Kitty8152,27748116,1630693,12032,78078,153637,150776,70470,0,452961,70470,0,6311931374,2547000,7636,[LG21]Lords of Gondor
185538462,UMAYKIZ,27482779,82590998,1211798,2427602,767351,902894,7066272,314824,11478943,7381096,0,4064135471,8566632,6445,[LV21]Lords of Valinor
188880546,Graf000007,27362176,4086246,1602923,195112,206722,115320,276770,20240,814164,297010,0,3493079293,0,4045,[LG21]Lords of Gondor
188852900,Scorpionking乂,27338070,81836217,2564465,698557,536746,1654576,6965261,217605,10072745,7182866,0,2227418166,58256706,32081,[LV21]Lords of Valinor
188294260,CЦEПИOH,26992293,10421111,1855157,581297,556310,288078,772954,15519,2214158,788473,0,2731696545,173206292,7525,[LG21]Lords of Gondor
188453555,Puyols,26978667,54059029,1090161,414135,352520,193153,4645539,302158,5907505,4947697,0,6780516928,127173124,24185,[LV21]Lords of Valinor
188806334,Emrah 51,26971037,3751158,1312229,1012,10602,4008,371372,0,386994,371372,0,4126810750,0,4417,[LR21]Lords of Rohan
188192835,SвулканS,26874843,19967704,388225,2031363,306088,979874,1431780,35598,4784703,1467378,0,3364532541,52162299,9090,[LV21]Lords of Valinor
188285810,ᴵᴰJupanu,26767098,47189990,1043044,864684,1573717,521185,3714482,232003,6906071,3946485,0,4856153377,57408174,20063,[LV21]Lords of Valinor
188544046,G4mine,32447417,26635738,854807,262602,631545,296942,2070874,171181,3433144,2242055,0,4317317823,247760315,20193,-
188872694,DELİ ÜSTAD,26598724,5962066,716649,208561,290491,524323,257508,33350,1314233,290858,0,4317881021,39905983,2124,[LG21]Lords of Gondor
188818127,ᴿᶝ风华,26509310,2158531,1064759,62955,74067,33164,157987,14264,342437,172251,0,4153895634,64472747,3883,[LG21]Lords of Gondor
189040679,ㄴHORIZONㄱ,26495211,74776471,764075,947828,1035889,885967,6855262,20932,9745878,6876194,0,4541245002,188105599,14268,[LG21]Lords of Gondor
188364525,ᴵᴾEmrys II,26412458,3119874,218964,53070,30135,8285,294045,3770,389305,297815,0,2091717356,0,2715,-
188365363,diegokristy,26310049,43045929,464864,421018,640200,815724,3363703,239070,5479715,3602773,0,3732544253,246281206,15530,[LV21]Lords of Valinor
188836483,YenifferDeRivia,26288362,41563930,1633040,1784534,2318341,1691838,2852355,63972,8711040,2916327,0,3408936737,140738085,4884,-
188877484,ᴵᵀBLOOM,26240463,73412319,1615750,429658,286070,678042,6496736,253736,8144242,6750472,0,1847010287,111895750,28933,-
189141193,ᴸᵛJankels,26067907,54329109,819486,2368695,1924928,2323951,3777349,146811,10541734,3924160,0,3307581997,28726902,16304,[LV21]Lords of Valinor
186010544,Mehmet027,26030845,55990992,1540749,1745924,1605817,1988711,4394543,26495,9761490,4421038,0,3046946558,173638054,8793,[LV21]Lords of Valinor
188575943,BATUMSKİ08,25964226,123697233,2518476,8713459,9991171,6956425,7079066,167792,32907913,7246858,0,2810838820,529137921,20711,[LV21]Lords of Valinor
188939030,TBILISI,25922927,7839558,1253222,516250,1297487,330601,372081,4906,2521325,376987,0,3068035791,460258,11704,[LG21]Lords of Gondor
189939798,ʰᵒDestructor,25880114,19301020,52616,21684,68111,82633,1882993,0,2055421,1882993,0,2877824314,11281500,864,[LG21]Lords of Gondor
188836051,Cheops Pyramide,25852996,69243815,1096532,644865,285017,461502,6262820,203530,7857734,6466350,0,4493765192,751419894,37401,[LV21]Lords of Valinor
188835262,vinzsou,25694263,16597913,334531,46309,92071,38810,1495429,64749,1737368,1560178,0,2294871902,0,13058,[LV21]Lords of Valinor
188806124,ᴵᴾAltar,25682493,111614407,1481141,3177848,4192360,2583327,8685363,270359,18909257,8955722,0,2531022967,7742830,26734,[LG21]Lords of Gondor
188277784,ᴵᴾPecimura,25422395,28014853,96045,30115,106786,86982,2470635,137049,2831567,2607684,0,1993688634,30935666,8678,[LG21]Lords of Gondor
188891048,7BeLa,25348582,57642914,872000,370252,777201,2820258,4394591,39376,8401678,4433967,0,3249200119,137794496,5869,[LG21]Lords of Gondor
188855274,GOLTEB,25154926,128214224,1327294,1219432,175391,426239,11747670,421895,13990627,12169565,0,3400203514,35237187,41929,[LV21]Lords of Valinor
84905552,Schwazzier,25047538,10701276,506526,147563,86882,62010,838244,93376,1228075,931620,0,3203494114,60672597,8076,[LV21]Lords of Valinor
188912287,ᴸʳgCoelho,25204199,33125523,820622,1419717,814999,1014738,2483201,116031,5848686,2599232,0,2458139051,113818904,7096,[LV21]Lords of Valinor
188320476,ᴿᵃЛиса,25028649,41215266,1141689,367832,506674,543458,3500224,147614,5065802,3647838,0,4810774732,362428945,39836,[LV21]Lords of Valinor
146179581,lupepvp,24985962,11629369,602010,166315,115101,36086,969192,76482,1363176,1045674,0,5387059626,108915418,15159,[LV21]Lords of Valinor
184845080,ᴸᵛSCAR德,24850468,56342030,645601,214040,313729,200941,4971452,257674,5957836,5229126,0,3869636650,46674299,28279,[LV21]Lords of Valinor
189236516,ᴿᶝ年华,24549811,2290337,936926,56107,169818,48265,162204,6219,442613,168423,0,3774470458,48671853,2954,[LG21]Lords of Gondor
188319008,ᴸᵛКэп21,24483757,10075514,29597,216150,128394,92909,914970,12708,1365131,927678,0,2233408969,0,10987,[LG21]Lords of Gondor
185602720,ˢᵉAbdallah,24469055,37680310,200395,749910,727131,953454,2914261,155982,5500738,3070243,0,1712162091,127071312,9601,[LV21]Lords of Valinor
188324838,ХОНДА,24413953,7990779,1618420,319927,430706,215833,601619,9293,1577378,610912,0,2520068321,122738819,6016,[LR21]Lords of Rohan
188937309,Velikiy Govard,24272388,9823194,638326,125640,141509,280242,795672,21868,1364931,817540,0,2700060634,125678023,5255,[LG21]Lords of Gondor
181974650,IDEM City,23791400,2030305,1163258,142285,141908,58538,141798,3295,487824,145093,0,3776027518,86095121,2071,[LG21]Lords of Gondor
184872506,ᴾᴿF A J A R,23766513,81330450,1396757,2282220,2097345,3030279,6197714,129053,13736611,6326767,0,3250277163,28252952,13422,[LG21]Lords of Gondor
188840841,ᴸᵛNotZach,23679497,30134424,506922,591644,826092,444463,2319906,169350,4351455,2489256,0,1629679552,107725390,4540,[LV21]Lords of Valinor
185094982,Phi Dương F2P,23586495,38331232,1940175,2842133,5213473,4079345,964930,68459,13168340,1033389,0,2109637550,147926355,5359,[LV21]Lords of Valinor
188793523,FerAmaya,23492198,12157981,506442,129947,223590,105868,831368,147383,1438156,978751,0,3610488192,43532335,5288,[LV21]Lords of Valinor
188376202,ᴵᴾ云霄,23379709,6580450,1214571,147461,159504,83670,521541,34093,946269,555634,0,2594984100,17020000,4280,[LV21]Lords of Valinor
188994494,Snowplow,23296098,1094552,236306,8504,103749,19351,80795,0,212399,80795,0,2908708949,0,3459,[LR21]Lords of Rohan
188390528,ᶦᶠAkrosh,23277756,14179254,358164,80861,884019,546131,1021052,0,2532063,1021052,0,1408491622,139317710,2243,[21If]Immortal Falcons
188880486,Kỳ tiktok,23137885,8487802,1062340,68271,30446,79884,622510,93431,894542,715941,0,3983065720,0,3185,[LV21]Lords of Valinor
188899189,QuantSist,22936388,1720056,385409,11624,68715,76283,127517,0,284139,127517,0,2092232390,296458,5550,[LG21]Lords of Gondor
189057248,Cekko23,22885088,21896824,595985,139303,267141,394238,1785995,94889,2681566,1880884,0,3669942981,76002446,11333,[LV21]Lords of Valinor
144563085,ᴵᶜPARANOIA,22878266,4730553,1770534,15817,22531,23272,408292,25316,495228,433608,0,2831381744,1021382,4811,[LG21]Lords of Gondor
188937116,ᴵᶜTom,22847232,4798418,78668,26543,281358,25756,401873,5432,740962,407305,0,2254933220,6485919,12148,-
191454845,ᴸᵛTueAnh,22722439,21933733,664298,6082249,104981,279588,1691841,123528,8282187,1815369,0,5660468448,1141408023,12086,[LV21]Lords of Valinor
188661481,Kängurufarm,22685146,2847269,781585,208965,117034,10247,253042,0,589288,253042,0,2409834236,1128542199,4146,[LG21]Lords of Gondor
185134660,PetitDr,22413048,3101404,85261,63894,67172,12418,288305,1078,432867,289383,0,1499181335,17979430,10865,-
188851823,ᴸʳMent001,22347661,706360,45963,213744,185983,43829,11633,0,455189,11633,0,1994484946,0,2765,[LR21]Lords of Rohan
188234979,iGRECfarm,22319661,15844038,286311,273003,46153,43158,1490992,30729,1884035,1521721,0,2703807026,315563112,10672,-
188842111,JJ00,22212291,12699687,546042,13757,120082,40863,1080466,74433,1329601,1154899,0,2619609251,3999999,3663,[LV21]Lords of Valinor
186016235,卂丂卂千,22035068,5455072,172363,142922,151729,14030,395527,55582,759790,451109,0,1941152634,12932669,3846,[LV21]Lords of Valinor
188830522,ᴸʳTylnmrl,22009412,1670861,37663,32839,20609,4164,155652,2495,215759,158147,0,2304821561,16585000,4654,[LG21]Lords of Gondor
188639928,The亗SCARFACE,21937486,2476955,64606,145589,285116,162864,116131,3242,712942,119373,0,3240773140,44040000,4328,[LG21]Lords of Gondor
185905587,Ze Boshman,21929998,4802837,1158706,309125,97861,13805,369719,39644,830154,409363,0,2770839083,41584565,2619,-
188870613,xXVincinetteXx,21868756,8307709,1851059,867867,503902,29008,656394,22318,2079489,678712,0,4699104174,5876311,23600,-
188846843,BoboFranek,21704370,1436892,86860,96434,230127,133623,42286,0,502470,42286,0,1842439115,45731253,5585,[LG21]Lords of Gondor
188878743,Jetare,21619870,15241706,984262,914090,1762279,1205895,613645,28715,4524624,642360,0,3254183643,91210728,3047,[LV21]Lords of Valinor
187503097,Romulus1991,21614288,29883183,179996,189776,70341,268479,2472333,195365,3196294,2667698,0,3898685792,82802394,17636,[LV21]Lords of Valinor
188255601,Ant Man21,21587050,21740037,261646,303216,192688,238972,1939567,47123,2721566,1986690,0,3143089623,0,3958,[LG21]Lords of Gondor
188838640,Presidente CIAO,21514721,3248958,61803,13150,115426,83389,268192,0,480157,268192,0,1651072318,23800000,4542,[LG21]Lords of Gondor
184817793,meto 313,21377637,2940073,2001835,184629,125724,112750,75554,72258,570915,147812,0,3002353842,1827622,1800,[LR21]Lords of Rohan
188337674,ᴵᴸAxan,21370602,13852737,908861,382486,81728,81286,1314956,6904,1867360,1321860,0,2641846626,376836150,9608,[OP1]OP CLAN
188819819,fox77778,21232138,3782562,738594,75581,204618,428450,164441,0,873090,164441,0,3353830096,1037349,4713,[LG21]Lords of Gondor
188889549,СЦEПИОН,21044476,2997871,1241527,21675,25683,72660,248333,8410,376761,256743,0,1923428853,102567597,3695,[LR21]Lords of Rohan
186018265,yıldırımsefa,20981632,12642300,258459,159713,850626,471324,812371,45005,2339039,857376,0,3125733481,50620184,8858,[LR21]Lords of Rohan
188856715,ᴸᴳJackie,20865046,14328070,284873,80252,30041,24787,1293985,60647,1489712,1354632,0,1261351963,20000000,4101,[LV21]Lords of Valinor
189036655,Vitia back 1990,20831843,9551108,2056000,172660,105414,21917,821704,50052,1171747,871756,0,2721815025,9800000,8594,[LR21]Lords of Rohan
188443825,йкйцк,20721165,48743894,1313992,1943111,2457331,1223280,2839555,507597,8970874,3347152,0,2532968576,1971457076,21172,-
188876948,Ruberoid,20597589,1308095,30041,24678,63862,55794,95226,0,239560,95226,0,1490293560,3846529,4622,[21If]Immortal Falcons
184859052,ᴸᵛamadxd1,20492682,10085592,1080886,167940,454668,303192,683338,54826,1663964,738164,0,2226731301,315992716,7146,[LV21]Lords of Valinor
184819319,joe200,20426646,2022401,1197317,130789,249677,21520,45323,47879,495188,93202,0,1631673131,91263980,5852,[LG21]Lords of Gondor
188884453,dm152,20423050,261473,0,20838,55033,4660,12860,0,93391,12860,0,2705207692,0,4353,[LG21]Lords of Gondor
183360513,ᵀᴸмønoメ,20415868,26110591,478300,186118,247673,221163,2277659,95839,3028452,2373498,0,2125813241,85509847,6981,[LG21]Lords of Gondor
188884272,ZHIANZD,20398835,1216090,246973,127800,150740,29760,77001,0,385301,77001,0,2488342395,0,2033,[LR21]Lords of Rohan
187197359,Demir Bilek,20353129,9273471,779097,120768,235808,174193,781889,13102,1325760,794991,0,2242254696,30192868,11193,[LG21]Lords of Gondor
188847403,Vali188847403,20300468,1805843,502942,88125,113717,240436,59904,0,502182,59904,0,1174440329,0,641,[_NDM]New Jersey Nol
188790227,СУЛИМАH,20234807,2937806,1265520,69552,52214,89972,230812,7573,450123,238385,0,1837825253,102878721,3411,[LR21]Lords of Rohan
188325495,쵸 See La Meet 쵸,20218723,26136473,714725,1038428,1614240,1553702,1521512,63519,5791401,1585031,0,3512199870,0,7931,-
145631489,BABA SON,20156481,6791782,290848,136434,494296,267396,335994,67319,1301439,403313,0,2223955171,4400000,4968,[LV21]Lords of Valinor
188806434,ᴸᴳ Bimz,20141243,4958433,658635,38897,29786,6973,379801,53259,508716,433060,0,2988550701,29458520,9825,[LV21]Lords of Valinor
188836639,Ndiaye,20093834,5853377,660696,352077,491543,747064,181162,0,1771846,181162,0,2998462641,383503,1626,[LLA]Lost legion academia
188857113,GritNGravy,19938299,1953070,46395,39362,14347,20181,183578,0,257468,183578,0,2967815952,3200971,3742,[LG21]Lords of Gondor
188903920,JoshuaSeil,19930876,5700852,817155,57531,197583,100305,446542,21377,823338,467919,0,2965265764,301497,4132,[LV21]Lords of Valinor
188898779,kral jon snow,19901685,113087,6227,15339,20427,859,6573,0,43198,6573,0,2753058077,8327554,2900,[21If]Immortal Falcons
188539042,Chieu F2p,19813829,23762540,469315,857871,1727252,652023,1405847,173495,4816488,1579342,0,2140454407,185342934,11120,[LV21]Lords of Valinor
188261313,freezebee 21,19802041,2027071,234347,244875,375237,108803,79241,0,808156,79241,0,1773688702,5187959,14584,[LG21]Lords of Gondor
191530671,ᶦᶠtMadsonn,19742418,1846035,34099,69047,86817,200703,85578,0,442145,85578,0,2658293465,910375198,4613,[LR21]Lords of Rohan
188814205,SUBUTAİ 38,19718557,1466044,274608,292102,181430,22696,95398,0,591626,95398,0,1982986692,3080000,2311,[LG21]Lords of Gondor
186613612,Inigo Montoya1,19691128,4781554,1455414,349831,116242,28761,403220,16593,914647,419813,0,2656474267,103076547,8585,[LV21]Lords of Valinor
188430882,JapayuKingBILAT,19645855,13661282,558328,244614,718820,347450,1008612,34940,2354436,1043552,0,2888508022,142262581,15675,[LV21]Lords of Valinor
189075824,NooByZ,19621709,8523920,1530004,77034,121760,128921,748617,13157,1089489,761774,0,3365718003,99259891,19016,-
188232993,AKON311,19570367,17474104,658995,571073,531874,842388,1182997,54831,3183163,1237828,0,1770213436,850687088,12260,[LG21]Lords of Gondor
188853064,TerrorBlade98,19476459,4698786,941546,120572,115534,39441,414286,7149,696982,421435,0,3359384105,0,1360,[LG21]Lords of Gondor
140534782,ᴵᴾCoCaSNX,19345651,21797010,531203,1203243,267031,348395,1715668,123602,3657939,1839270,0,3530980381,2108538017,6924,[RC21]ROYAL CROWN
188838663,ERON,19151310,7419903,732610,190505,250716,72425,647213,5927,1166786,653140,0,2009368022,20081022,12080,[LG21]Lords of Gondor
188818238,PoTaPyh,19113761,17945708,847850,488230,854873,981299,1155520,32896,3512818,1188416,0,3095818179,301072527,13039,-
188776545,ᴳᵒᵈ Ingle,19105492,1048600,93501,85140,135892,24107,66336,0,311475,66336,0,1705600669,3404666,5149,[LR21]Lords of Rohan
188827507,Dug1man,18925248,106428,5346,18103,18794,0,6522,0,43419,6522,0,2578423752,0,2498,[LG21]Lords of Gondor
188869412,dân chơi đá,18877333,8228309,246570,288205,739830,1185717,194814,0,2408566,194814,0,2106256471,1154652,1641,-
188490339,Eudaimonia,18844189,5439682,227320,56910,36785,12770,472049,29158,607672,501207,0,3307512242,30962500,5714,[LV21]Lords of Valinor
188360951,SATORUGOJO1,18528933,9398145,472927,508838,996498,575503,431459,34339,2546637,465798,0,1608865935,317828071,6702,[LV21]Lords of Valinor
188367613,ᶦᶠKinkyTail,18484461,28516508,652235,1415633,750063,721224,2140908,121964,5149792,2262872,0,989829373,58186939,12396,[LV21]Lords of Valinor
188844580,RedHoodJT,18448445,3724748,210774,117223,615129,546669,28437,0,1307458,28437,0,1698007284,0,1470,[LR21]Lords of Rohan
150165925,ᴸᴳken arok,18411727,20174751,614040,4481149,278014,115931,1646083,89897,6611074,1735980,0,2493804788,26909895,11540,[LV21]Lords of Valinor
188836606,Black AngEL,18316975,8655975,1937740,908418,995278,553139,422312,2403,2881550,424715,0,2137121812,18536152,1820,[LG21]Lords of Gondor
188806199,Op khan,18231508,4774879,1311876,240925,827408,507637,83281,10426,1669677,93707,0,2935425640,4253716,3193,[LR21]Lords of Rohan
188336750,SKY EAGLE,18136313,7121747,985124,330019,49903,45477,677403,0,1102802,677403,0,1931799839,213802552,9588,-
189014302,magister,18034793,11593788,947900,205152,1188782,528161,695989,5133,2623217,701122,0,1327725746,15363819,7383,[LG21]Lords of Gondor
188884243,HiagoLira,17915629,1285899,1,5567,1871,82946,94926,0,185310,94926,0,1657006355,0,2370,[21If]Immortal Falcons
188865329,Việt hoang 07,17892195,607097,64769,419495,234049,900,5150,0,659594,5150,0,2214217502,1833721,888,[21M]Immortal Myrmidons
188787622,MalandrageX,17867504,20690,0,2434,1687,245,1585,0,5951,1585,0,2528938655,0,3284,[LG21]Lords of Gondor
188823442,VIP shooter,17690407,3305125,846887,132688,41914,75500,277768,5754,533624,283522,0,1633587153,41800001,5192,[LG21]Lords of Gondor
189231766,darkkiller666,17669854,3746982,286312,236683,195194,50737,294065,8283,784962,302348,0,2533244060,20289481,14046,[LG21]Lords of Gondor
188487100,Kir8,17630299,744292,46498,47082,45400,57564,41382,0,191428,41382,0,612457103,0,4410,[LG21]Lords of Gondor
190852683,BossAlien FARM,17611449,6771910,168409,19244,81805,135783,606132,0,842964,606132,0,4348410810,1694123182,2683,[LR21]Lords of Rohan
164927516,iven0007,17568388,10077159,800589,584997,950594,899393,404788,20676,2860448,425464,0,1113835219,29829009,6107,-
188904786,Shadow vahalla,17375485,951871,236630,6845,11062,4462,91053,0,113422,91053,0,2857435964,0,3017,[LG21]Lords of Gondor
187016834,卂几Ҝ卂1,17314517,5969476,107689,89142,174787,122716,511121,0,897766,511121,0,2793822777,1489060086,4814,[LR21]Lords of Rohan
196566747,Codrin4Valhalla,17272193,5523071,195320,259178,157063,124705,407835,28997,977778,436832,0,653910155,89594454,6246,[LV21]Lords of Valinor
188368666,Derik 災,17193465,17311218,78795,189202,156137,96806,1633226,12081,2087452,1645307,0,1504456225,57910439,4670,-
188879533,Qertt7,17191189,188791,322,8039,23990,816,10230,1682,44757,11912,0,4117127135,38000000,2174,[LG21]Lords of Gondor
188585266,メDragønメ,17046256,6200803,260935,13008,75292,24207,548489,23295,684291,571784,0,1565973095,73489482,19339,-
188503741,SİYAH KAZ,16994656,2745204,35926,148261,185391,246920,121345,7182,709099,128527,0,1557000457,38351774,6878,-
189068044,Hsotits7,16895776,13123610,995230,966771,1440390,1040579,499742,44487,3991969,544229,0,2147478444,16241240,3451,[LG21]Lords of Gondor
188928573,Thànhteo,16834657,1269484,231737,5214,47138,152454,56435,0,261241,56435,0,1518718910,0,3090,[21M]Immortal Myrmidons
188824641,Sabesaur312,16783039,178017,72,61605,21023,10955,7983,0,101566,7983,0,717328751,0,1962,[LR21]Lords of Rohan
188868206,Quocbao05032012,16718136,1765350,652703,140343,12908,5049,169127,0,327427,169127,0,1769538718,6000000,2040,-
189181702,222mb222,16651357,2096107,769471,199359,63662,40288,176776,0,480085,176776,0,3119036630,225401626,1740,[LR21]Lords of Rohan
188845980,Azadi,16599319,2414584,591878,280392,474111,105066,99002,0,958571,99002,0,1863881476,3366983,1072,[I-am]RoyalLoyalMembers
188833114,Quent2,16583407,22838922,342325,313030,76329,372177,1911753,100871,2774160,2012624,0,1474038292,21298007,10424,[LV21]Lords of Valinor
188432088,BandAid,16557567,6291099,303434,23738,88926,146960,503492,24287,787403,527779,0,3048770058,308659606,8332,[LG21]Lords of Gondor
188861925,blackbandito,16524050,3299236,432177,181283,407143,143151,130863,28373,890813,159236,0,1549158351,24105565,1993,[LG21]Lords of Gondor
189579148,стратег,16475452,2439007,1269763,90576,272116,146355,125592,1766,636405,127358,0,2309890690,1378833,2187,-
188894198,Tomioka senpai,16321278,379272,52185,4153,47557,61967,3546,0,117223,3546,0,2602700647,0,1811,[21If]Immortal Falcons
188513738,MooSáke,16290580,198927,96089,15385,14235,12870,11590,0,54080,11590,0,1806047091,0,1221,[RC21]ROYAL CROWN
188852196,DarkExecutioner,16177458,1452447,100617,60616,84044,164244,61526,0,370430,61526,0,1216662089,28060602,1834,[TFS:]The Forsaken Souls
188823187,AZERBAIJAN90,16127248,891992,1273713,78632,32607,42323,49764,7206,210532,56970,0,2188918647,3040,1275,[~AKT]BR AKATSUKI
188876717,DEWO YEAGER,16115813,4619081,1089416,433008,785790,289890,180134,0,1688822,180134,0,2491436810,0,1761,[21if]farm 21If
187880560,wcwc,16017764,230115722,1527635,19485000,18674475,23053443,9591814,36893,70841625,9628707,0,3214040764,596448438,13547,[21if]farm 21If
188376429,ᴵᶜmySoul,15863805,447638,94861,165290,199177,4054,1,0,368522,1,0,1317663453,7488905,8468,[LR21]Lords of Rohan
188436016,KiLLedYouhaha,15822093,6307690,234650,186713,224968,166558,470080,22669,1070988,492749,0,2635083190,115055118,9942,[LV21]Lords of Valinor
190329472,F1Quang,15797339,14222941,1403680,76015,288128,303523,1225945,7897,1901508,1233842,0,3962115590,2734670795,8481,[LR21]Lords of Rohan
188134384,ˢ carlossainz,15705284,6601011,1300774,21788,65922,52235,498539,63524,702008,562063,0,1190118090,25406959,4003,[LG21]Lords of Gondor
187078010,Dr4gonsFarmerツ,15490724,22163921,1316246,641729,1799365,1256244,1338903,1142,5037383,1340045,0,2602487365,1725005764,7889,[LG21]Lords of Gondor
188878343,Cheiron City,15452017,2006372,65708,76640,299335,127026,88427,0,591428,88427,0,1357992538,0,1664,[21if]farm 21If
188825941,S0SKA,15447745,1189854,237525,181770,115056,123932,42766,0,463524,42766,0,1573181792,17191302,2471,[21M]Immortal Myrmidons
188825002,Namiq Cebrayilo,15408130,3934535,1259596,213707,290110,151386,270603,0,925806,270603,0,2206117456,0,742,[LG21]Lords of Gondor
188809474,Edgar15,15275743,46285,13168,43659,11087,2650,478,0,57874,478,0,2116886110,0,1245,[21M]Immortal Myrmidons
188857667,Apoathou,15268447,1322660,1124764,128214,19733,13903,120194,0,282044,120194,0,230139173,156690,1086,[LG21]Lords of Gondor
188879219,Akglate,15231878,247677,40137,19567,121882,0,0,0,141449,0,0,2071709078,1758755,592,[LR21]Lords of Rohan
188281290,1GuiltyCrown1,15210497,19247655,1007323,1096697,1425467,992963,1183957,18298,4717382,1202255,0,3443545508,1967206382,17118,[LG21]Lords of Gondor
186035363,Klgi20,15065899,1079100,1084576,54111,135908,7883,18115,29189,245206,47304,0,1884673162,1200000,3130,[21If]Immortal Falcons
188877463,Se Tuath De,15023819,1904865,811661,93157,158781,182383,83914,0,518235,83914,0,2534148111,5600000,2425,[LG21]Lords of Gondor
188785649,priam,14966194,1750608,803133,48303,27617,11291,164055,0,251266,164055,0,1483786572,18007168,327,[tgqm1]amarl
188858878,lisabella,14963838,237752,277117,67710,112105,0,0,0,179815,0,0,579223911,0,1614,[21M]Immortal Myrmidons
188781490,Fra1d,14963604,1187031,100258,39857,116341,94712,56753,0,307663,56753,0,1220961083,5509155,3143,[LG21]Lords of Gondor
187560016,Kyubi Farm1,14904977,43242083,1156562,1634869,1976614,1528733,3245429,19633,8405278,3265062,0,1348799318,409430369,6745,[LG21]Lords of Gondor
188800436,LilPiglet,14885068,769658,220953,34240,152043,47076,27042,0,260401,27042,0,1373555406,0,1295,[LR21]Lords of Rohan
188365295,ᴿᵃTsumiki,14849316,2089406,0,8924,38778,19749,193107,0,260558,193107,0,1063300942,3762398,6032,-
189036275,TheBlackDragon,14827976,163506,24134,22964,32186,14353,3713,0,73216,3713,0,2043771597,0,1774,[LG21]Lords of Gondor
188963486,GÖZTEPELİ35,14745890,131575,0,26938,85,5222,10513,0,42758,10513,0,1956299993,230887100,3805,-
183848200,Ei Farm,14731064,38195393,1298931,2526718,1320489,1044558,2973860,56612,7922237,3030472,0,3111047090,519374881,13485,[LG21]Lords of Gondor
188802524,Yamato68,14724102,193221,131028,1699,7453,9839,13862,0,32853,13862,0,1224230305,13257436,2993,[LG21]Lords of Gondor
12113325,Elena23EV,14723891,1817847,131418,8455,10921,55191,154067,1644,230278,155711,0,1131873275,24431024,5761,[LG21]Lords of Gondor
188863496,dark8582,14711908,408222,113485,9062,63839,37988,12678,0,123567,12678,0,1902186881,0,709,[jk10]jk 3621
188986083,KyoHN,14615786,58505,16806,10125,15173,711,2329,0,28338,2329,0,2337944510,69,2861,[LG21]Lords of Gondor
188847086,Dimiboy,14481175,75311,0,179,37638,0,0,0,37817,0,0,1231507623,0,25,[Tick]Tick tack
188796842,Menda2137,14401215,321687,136804,21106,48638,8855,18477,0,97076,18477,0,1116877840,0,1470,[LR21]Lords of Rohan
188873290,FarmЛиса,14375837,5775194,596991,64191,23711,6956,553801,7455,656114,561256,0,1490093397,122800001,4165,[LG21]Lords of Gondor
188287771,ᅟᅠᅠᅠᅠᅟᅠᅠᅠᅠ ᅟᅠᅠ,14240665,55138144,428726,330732,673936,319444,5244635,0,6568747,5244635,0,5028580400,2212968833,28890,[LG21]Lords of Gondor
188806889,Gouverneur188806889,14222057,785370,316714,61610,182543,80923,8427,0,333503,8427,0,1092931811,0,1024,[21MS]Myrmidons Farm
188885945,whyreall,14191004,1427513,1410059,61686,45602,10688,128122,0,246098,128122,0,1497367838,862617,2035,-
188858305,Palestine313,14180310,3028033,1334422,129577,527939,188640,119168,0,965324,119168,0,1404385384,0,4,[Alg]Palestine313
188931757,ᴸʳANTHRAX,13979950,659165,84307,164935,187652,32931,11915,0,397433,11915,0,1427675721,0,2104,[LR21]Lords of Rohan
170835406,ᴵᶜ Has,13955620,1445859,679890,46009,32626,7559,101847,16135,204176,117982,0,687055286,298517,2940,-
188856535,HOIANA,13946452,1190153,693357,435295,160981,54643,43890,6183,700992,50073,0,1790659858,400000,1174,[21if]farm 21If
188832666,ChifOJ,13924553,2361104,125471,94442,41533,55215,203829,0,395019,203829,0,2572496994,0,540,[21IR] Corral
188896546,БорисBao,13857624,1182765,168254,14668,118405,170863,25957,0,329893,25957,0,1761224189,22966398,1423,[LR21]Lords of Rohan
188953179,SarahVinyard017,13756390,5795264,260817,103502,87804,304494,438098,0,933898,438098,0,1388844714,31860199,3832,[LG21]Lords of Gondor
191177358,RtthyrFarm,13775240,52258,8925,14892,0,0,4928,0,19820,4928,0,3584916345,1594265331,1151,[LG21]Lords of Gondor
188787790,You  andl,13554593,920284,416012,51124,134014,82128,31352,0,298618,31352,0,1361968333,4084888,1956,[LR21]Lords of Rohan
44936497,젝스킹,15991483,6996924,923387,39204,54846,41378,523118,74135,732681,597253,0,2183506756,0,9052,-
187795145,SOTER,13413232,8447735,539910,529189,65018,309343,652149,22650,1578349,674799,0,1281516203,112215799,15285,[LG21]Lords of Gondor
188837379,안정아남자,13335580,885792,199719,262430,137821,8581,52334,0,461166,52334,0,1881248126,0,1117,[LG21]Lords of Gondor
191069538,Shinnygamyy,13280650,3037148,499817,235031,755080,228183,56725,0,1275019,56725,0,1083252012,5089962,691,-
187257305,HolySpirits,13221458,4186335,271743,116035,83670,59317,375642,105,634769,375747,0,1164962213,477259605,5804,[21If]Immortal Falcons
188836866,zlucifer,13134321,2684582,271491,220751,328964,145856,139908,0,835479,139908,0,1701695970,0,1524,-
190539451,puyolF,13123168,972686,309560,2673,66571,105265,41795,0,216304,41795,0,4722376647,1818372170,2051,[LR21]Lords of Rohan
186073361,卂尺丂Farm,13095055,4138657,585035,39537,204145,32135,344752,7320,627889,352072,0,2286157342,489706596,1515,[LG21]Lords of Gondor
185484265,Tors228,13083005,7740094,636018,1305674,1878812,627539,120762,178,3932965,120940,0,1312958755,25325363,7376,-
188887466,Jensamtresen,12961460,2851467,834974,287219,392239,254799,99035,0,1033292,99035,0,880825536,10799999,842,[I-am]RoyalLoyalMembers
193596249,Korkusuz 51,12958052,239160,358859,12402,0,0,23668,0,36070,23668,0,1401609699,60357336,943,[LR21]Lords of Rohan
188817273,Munmon,12901737,1116310,211912,39551,42589,125343,52185,0,259668,52185,0,2476678488,0,125,-
188845348,ᴸʳLUNICTUS,12877100,104914,26926,6884,16888,8978,3385,0,36135,3385,0,1558632979,0,455,[LR21]Lords of Rohan
123456386,Igoryan,12935937,5049921,193112,1352415,222892,143876,374139,838,2094160,374977,0,1405992789,11392165,1351,[LG21]Lords of Gondor
188291209,ROCKS  D  XEBEC,12853105,3694092,969555,42334,42629,46712,328702,6325,466702,335027,0,1822462533,37349860,9225,[jk10]jk 3621
188292201,쵸Bear,12762411,3636617,863462,127956,652623,13205,183272,21012,998068,204284,0,1398516677,0,8400,-
188899884,hanaaaa230,12664621,3656113,993138,112016,538707,284659,141766,0,1077148,141766,0,1501933326,3785937,1110,[K~R~]3621 Utility Box
192581999,LilitЛиса,12534892,4099267,2586,4079,12074,27936,396256,0,440345,396256,0,2109473581,534525710,3616,[LG21]Lords of Gondor
188986347,Pimpammm,12386241,390745,21517,13926,70135,29655,12907,0,126623,12907,0,1444868924,9172286,4484,[OP1]OP CLAN
189266244,ᴵᴾRágnär,12376390,2424921,681640,338989,350984,104124,70352,26757,891206,97109,0,245500638,11642489,7444,-
188816893,WARRIOR FARM 10,12314581,242793,17769,22009,47558,10254,10226,0,90047,10226,0,1311205884,0,1891,[21If]Immortal Falcons
142371438,NokedliF11,12302691,3005981,754566,516818,830716,67154,61715,17771,1494174,79486,0,1496304971,2400001,10465,[21M]Immortal Myrmidons
178904209,MorFarm2,12182432,243458,0,0,0,3117,23099,0,26216,23099,0,1692919713,335244116,803,-
190430624,IMPERADOR FARM,12158267,449281,436505,3716,0,322,44725,0,48763,44725,0,4885216094,2527734725,1580,[LR21]Lords of Rohan
188829162,Mkジinsane,12152527,911799,856240,15867,56941,24326,65024,2360,164518,67384,0,1543783586,1400000,3486,[LR21]Lords of Rohan
187384799,C H A D 3 3 3,12136046,5025006,638494,336794,550030,58137,356220,3142,1304323,359362,0,957049908,0,4537,[LG21]Lords of Gondor
188880051,qftydhunvfezbjj,12100235,18338939,1337013,1249255,1030656,1111224,1086802,35743,4513680,1122545,0,1422326310,88951930,7822,-
188900034,Rajpoots,12020025,854381,223016,55556,81433,13291,62724,0,213004,62724,0,1882519435,0,3114,[LG21]Lords of Gondor
185259121,Lets go Os,12013614,913938,1168728,282,16846,7330,13445,35821,73724,49266,0,1378846196,4800000,1582,[LG21]Lords of Gondor
188217778,ᴵᴰKing Nemo,11974922,1852509,716667,684238,272077,322,117022,0,1073659,117022,0,1857331281,0,12936,-
188838338,boble 79,11916832,306757,46338,1697,52760,41937,3315,0,99709,3315,0,1278554670,0,2120,[21MA]Myrmidons Academy
188479340,ㅡᅟᅟF2P 8      ㅡ,11904771,9974813,173571,883535,766581,262971,721306,0,2634393,721306,0,2735115021,956471741,8848,[LG21]Lords of Gondor
188952266,ErDegui,11875134,7108681,230822,125436,58773,125367,620570,12944,943090,633514,0,1173596936,13045768,5398,[LG21]Lords of Gondor
188946350,BaabyyKiller,11764448,45777543,823248,1480408,3397133,2896319,2635750,37221,10446831,2672971,0,1760569996,20189360,9196,-
188819203,Cominogr,11730227,347521,71452,268238,123679,11074,222,0,403213,222,0,1687401687,0,850,[ANTB]ANnti Banned Club
187155907,Yuzhi,11704633,5032590,1641848,115533,189407,294655,290433,27386,917414,317819,0,2054866794,257605,2025,[LR21]Lords of Rohan
188887462,Dunks,11595270,1538565,760926,36818,198678,122594,64347,0,422437,64347,0,1107672787,0,1041,[LR21]Lords of Rohan
188900167,Charles grand 3,11494413,4207791,779277,591939,722430,168606,197012,0,1679987,197012,0,1794916324,8400000,917,[Tick]Tick tack
188801943,Brunk100,11490847,938220,200395,171290,279130,31043,22153,0,503616,22153,0,1330342807,2513093,2827,[21If]Immortal Falcons
188363322,쵸Belmont,11471499,726781,18931,225245,250029,43961,583,0,519818,583,0,1185584888,1410552,11058,-
188856725,Uranusuki,11450744,268914,32838,25630,66282,25841,2786,0,120539,2786,0,854661673,3859996,731,[LR21]Lords of Rohan
185877603,ㄴ Aurelio ㄱ,11433632,3426162,734268,194294,519109,17374,220713,3623,955113,224336,0,918025985,1758080,3483,[LG21]Lords of Gondor
188892262,Udi lopez,11379319,286475,30519,120358,27289,7419,17815,0,172881,17815,0,259364387,3001045,1839,[21If]Immortal Falcons
184327666,ツاحمدᴰᴮ,11376867,2678447,532046,681079,488185,101508,90179,12902,1373853,103081,0,1450539485,72130,2280,[LV21]Lords of Valinor
188818543,GodAnubis,11367584,3265470,842158,347813,333503,280538,140675,0,1102529,140675,0,1248669899,473118,754,[21IR] Corral
188885079,ᴵᶜnoobhuhu,11287294,4932153,869902,263679,640053,58918,316980,9692,1289322,326672,0,1694858992,26599999,5002,-
188840730,FurkiTolki,11239495,1839593,1140153,3217,12856,72657,143339,4461,236530,147800,0,1689737274,3600000,2041,[21M]Immortal Myrmidons
174523518,ㅡᅟᅟF2P 5      ㅡ,11204849,3700033,325966,825415,1309771,123637,42086,0,2300909,42086,0,2261099995,828382628,2422,[LG21]Lords of Gondor
188307234,ᴵᵀJessyS2,11159564,3418968,138406,130180,168640,9783,301652,0,610255,301652,0,1509177777,180913621,6306,-
188818957,alonsoisma,11138606,2300239,762386,25316,47973,75270,189815,0,338374,189815,0,1560358158,4826393,1423,[LR21]Lords of Rohan
189182502,ᴵᶜVatson67F,11095535,137197,213594,1669,4693,617,12501,0,19480,12501,0,3513404567,1724148322,1609,[LR21]Lords of Rohan
188840453,La pampara,11082553,4065536,1018214,200050,433845,478194,124506,0,1236595,124506,0,1509074954,0,320,[21if]farm 21If
189443468,Hubey,10948714,2171604,462536,189562,257421,35910,147521,0,630414,147521,0,918945909,0,1967,-
188320795,Fïshböy F1,10915417,1130852,410313,146172,398,5918,103727,1994,258209,105721,0,1533421824,649927741,1109,[LR21]Lords of Rohan
189007908,vua đại du,10847143,2010095,594035,32817,68882,36737,135324,18279,292039,153603,0,1664459657,27506603,6095,-
188309795,ᴵᶜ TAZIEX,10844048,8618161,951227,435439,559362,399095,559725,10936,1964557,570661,0,1632163083,0,8839,-
188817859,oktaev,10746001,401425,359467,33669,31021,2770,32157,0,99617,32157,0,1093514555,0,100,[DD21])Dragon of Death
188839518,Zaragoza,10687289,1181120,88062,120100,376712,100919,0,0,597731,0,0,1424532659,0,1140,[LR21]Lords of Rohan
188847841,Lj1208,10602108,314850,314434,984,0,1961,30681,0,33626,30681,0,1177309928,0,905,[21If]Immortal Falcons
189182788,Vatson67f3,10424550,260412,485136,2684,4031,13106,19939,0,39760,19939,0,3501663869,1133268751,1363,[LR21]Lords of Rohan
188889920,Carolk,10405243,642390,541227,49383,96269,35954,29616,0,211222,29616,0,1160793734,1349311,322,[fagr]alpha table
117517315,ᴵᶜBOTAN,10360428,13712356,945529,506093,1444925,965222,611992,37024,3565256,649016,0,1235813199,498018246,20006,-
189442766,Gubernur189442766,10360274,77204,41779,1313,9937,12737,612,0,24599,612,0,2540792859,1989430704,711,[21IR] Corral
188522411,Ваn,10346788,1095208,3365,36724,120447,26500,74097,0,257768,74097,0,727419882,1,2219,[21If]Immortal Falcons
195403312,môngcổ,10320907,1446809,783623,85946,65345,87040,95077,0,333408,95077,0,1263576129,0,1035,[LG21]Lords of Gondor
188295840,ッ Yakuza ッ 6,10205094,395204,0,3871,70818,40591,9043,0,124323,9043,0,992758872,82882904,4848,[21if]farm 21If
188899095,Minuz,10179700,1614469,364375,167345,306671,102167,55899,0,632082,55899,0,728611492,0,1697,[LR21]Lords of Rohan
188721766,ᴵᶜZver225,10146168,5600948,578427,272790,772945,368830,252518,0,1667083,252518,0,1282562432,205403656,7602,[LG21]Lords of Gondor
188906315,ᴵᶜИвaн,10143124,1248369,45240,148765,274837,58418,43527,0,525547,43527,0,943901017,16348226,12804,-
188881481,678907,10125660,4054167,576543,566707,812285,378314,80300,0,1837606,80300,0,1252007490,53227,1516,[LLA]Lost legion academia
188300029,Hoàng Saa,10112364,5137975,463048,87026,120041,279872,368510,3795,859244,372305,0,1287070134,9873378,8156,[LR21]Lords of Rohan
189285062,Linh farm 2,10104368,9739359,1413236,1086939,10938,8479,938116,4251,2048723,942367,0,5482011518,3128768761,1823,[LR21]Lords of Rohan
188840603,andyrendy,10073872,1722850,894100,10373,99042,247058,53446,0,409919,53446,0,1032365452,0,459,[Slon]Slonii
188857096,Di 1,10019335,909985,10470,103819,160058,85834,22577,0,372288,22577,0,934774982,1843151,2952,-
194265891,쵸MØTÃSÊMツ쵸 2,10010916,2255805,0,5126,24684,21098,212102,0,263010,212102,0,1460265974,125453620,1396,[LG21]Lords of Gondor
189869613,Алёнааа,9878154,3146615,691598,31047,82951,360086,153416,0,627500,153416,0,1475255043,503089664,1095,[GW21]GOATED WARRIORS
188898591,Dthomas,9838220,468487,81006,125157,122286,22516,10882,0,280841,10882,0,434478065,0,1343,[LR21]Lords of Rohan
188471943,NoCoboY,9816138,413116,95171,64153,54918,15880,22693,0,157644,22693,0,1081418218,0,3619,[LG21]Lords of Gondor
188846435,psilva3,9808812,1390439,255473,331056,379662,122656,7428,0,840802,7428,0,948433382,0,585,[21IR] Corral
189915380,BJXXX,9797066,4168395,1002299,38629,16464,369203,265093,0,689389,265093,0,1417171284,0,1636,[LR21]Lords of Rohan
191785327,ᴿᵃQueen,9625702,3017237,247312,228656,300820,10824,232657,0,772957,232657,0,2123392947,813781963,1187,[LR21]Lords of Rohan
186988267,Panda ᴸᴺ,9616784,2766515,1120377,7927,2980,11995,264463,3318,290683,267781,0,3082740466,512115698,1981,-
188962647,卂几Ҝ卂2,9578262,2082291,325396,3405,6149,30163,194866,0,234583,194866,0,1618176948,1219440595,2004,[LR21]Lords of Rohan
188790900,Dom Daddy,9537609,3388766,1222043,27914,83403,91562,276497,4258,483634,280755,0,1773010253,0,1446,[OP1]OP CLAN
188815675,KōbøLord,9517898,145859,16647,15805,9235,19277,4712,0,49029,4712,0,843374303,0,1696,[LR21]Lords of Rohan
186065635,MASONFTW WOOD,9501931,1910931,810165,6189,9403,5772,186780,0,208144,186780,0,1676823126,950725213,1283,[LR21]Lords of Rohan
188462426,Tysson,9463093,1483696,191746,163161,372581,171003,2189,0,708934,2189,0,647738981,310,4386,[21MA]Myrmidons Academy
