ID,Name,Power,Killpoints,Deads,T1 Kills,T2 Kills,T3 Kills,T4 Kills,T5 Kills,Total Kills,T45 Kills,Ranged,Rss Gathered,Rss Assistance,Helps,Alliance
179940560,ᴸᵛ ink,106863071,682092329,4362036,2922076,868211,971623,40544654,13521923,58828487,54066577,0,6165943729,1873979817,82269,[LV21]Lords of Valinor
186145908,ʳᵉʸEscanor,89005731,1531442156,3712561,4662483,915441,1734412,126563151,12805481,146680968,139368632,0,3557058935,4498233340,22667,[LV21]Lords of Valinor
188540500,TakeMe2Valhalla,84936500,1481310242,5287240,13604724,5658631,10686709,109781468,16335526,156067058,126116994,0,2834280658,7101247251,44886,[LV21]Lords of Valinor
180304933,LilLƴ,81459003,324311642,3362990,2782862,2764385,3236435,18036326,6245865,33065873,24282191,0,1171580143,5020554697,22468,[LV21]Lords of Valinor
188858506,Cúchulainn 쵸,76685749,266631120,1972640,936833,278745,498321,23381074,1504112,26599085,24885186,0,5123671488,552651627,38099,[LV21]Lords of Valinor
179655012,ᴸᵛDØØPER,74826391,561732955,2663421,2667918,973558,1257919,36152542,9634758,50686695,45787300,0,8519820700,1491282008,38680,[LV21]Lords of Valinor
178695066,SokoDrake,69444846,126212966,2755706,1295551,106206,148891,9230362,1642113,12423123,10872475,0,8013404155,115903540,17758,[LV21]Lords of Valinor
180560115,TripEhh,63612857,426887247,1462944,2776979,822023,695354,26535253,7827693,38657302,34362946,0,6720523776,1225250480,11326,[LV21]Lords of Valinor
184964288,ᴾᴿFïshböy,63018408,278949681,2109563,2057085,4656295,3958131,21230437,2054439,33956387,23284876,0,3515038542,632742525,39292,[LV21]Lords of Valinor
179977300,ᴸᵛTmulla,61096664,803546821,1802631,3860548,420787,1492407,45345975,17125188,68244905,62471163,0,6986046478,5600679937,17721,[LV21]Lords of Valinor
186009654,Dooby ᴼᴺᴱ,60838570,325377358,750830,2581671,360853,500752,29416947,1398342,34258565,30815289,0,7620069562,137216122,35957,[LV21]Lords of Valinor
188839265,A 10 Warthog,58390785,12765610,230642,42253,74269,128873,1010827,99243,1355465,1110070,0,3772771973,754780894,11292,[21M]Immortal Myrmidons
188341936,ᴸᵛ Vatson67,56398555,288815612,1699405,1362222,557828,606793,24713358,1893338,29133539,26606696,0,6626309293,384720155,42521,[LV21]Lords of Valinor
178814644,ᵁʷᵘØtòt,55188361,444858744,3140400,18550973,3385819,2356133,31505688,5494775,61293388,37000463,0,2295222519,2329433716,15920,[LV21]Lords of Valinor
188918989,ᴼᴸ Kaymo,55149923,125177460,1092879,2484352,1386449,2529103,10279320,449904,17129128,10729224,0,3808277288,1075163587,41698,[LV21]Lords of Valinor
182514982,ᴸoᵛeSalmon,52635313,440378925,3085731,17974387,656722,752616,30387676,6429169,56200570,36816845,0,5510962390,1060488180,53570,[LV21]Lords of Valinor
185836736,ᴸᵛMasonFTW,52069347,485003885,2396695,5724465,2218733,4779924,39893831,3068176,55685129,42962007,0,3381232031,2802859223,28981,[LV21]Lords of Valinor
180060983,ᴸᵛRumRamsey,51673224,388009988,2388036,115868081,5049133,999044,28349719,3362237,153628214,31711956,0,6151636204,417518493,94753,[LV21]Lords of Valinor
186985518,HornyAPOLLOS,50514764,245436807,1546413,3057425,1524425,3188918,20873624,1014228,29658620,21887852,0,2765703063,594948053,18717,[LV21]Lords of Valinor
184871937,ScazBigLion,48259048,1217022721,4527691,56591135,23364142,26120855,94350903,5549188,205976223,99900091,0,5925433539,13704268108,20886,[LV21]Lords of Valinor
181825355,ᴸoᵛePUMA,48099084,240290972,1420218,1482144,360220,537196,17255176,3228678,22863414,20483854,0,3290251532,3599759382,35658,[LV21]Lords of Valinor
142628224,Dae jang goon,48071743,179520430,2398902,2082564,718074,369855,14260849,1678993,19110335,15939842,0,4953120497,102794418,17125,[LV21]Lords of Valinor
181308342,ᴸᵛRockSolid,47838516,200046136,2758682,2730982,709675,1442730,13529307,2850830,21263524,16380137,0,3444681689,6082949920,41309,[LV21]Lords of Valinor
188920797,FreyaFullBosom,46079371,105138780,1839298,1860054,961746,1182547,8456553,677378,13138278,9133931,0,3652285531,1323334617,24502,[LV21]Lords of Valinor
176994964,Cpl Rage,45896650,115452738,476905,2377013,1506916,2122761,9023966,661640,15692296,9685606,0,1910845311,63265830,17166,[LV21]Lords of Valinor
185808036,Ze Bosh,45657049,324557669,903869,8598579,2626646,3862918,28938009,637645,44663797,29575654,0,5524831742,631820319,29935,-
179750493,GuiltyMahiru,45381384,185352516,1046346,2988644,770599,1221215,15885587,973643,21839688,16859230,0,1500105151,2025360302,40912,[LV21]Lords of Valinor
184826667,ᴸᵛAHERUS勇,44080546,525146146,1493172,12792273,5953573,11268784,45198363,681089,75894082,45879452,0,5992607512,1446853955,25133,[LV21]Lords of Valinor
182423962,シValkyrieCillaﾒ,42939227,120341311,1875411,5641345,823181,711090,9251166,1110533,17537315,10361699,0,5110094429,1265202822,15229,[LV21]Lords of Valinor
188241812,Gilgamesh2323,42766071,121055550,938540,24286930,210544,281714,10277818,593602,35650608,10871420,0,5154950390,62620586,25873,[LV21]Lords of Valinor
179813923,ㄴ Bless ㄱ,42537965,241537502,2188438,7770721,5954918,5164873,19241179,750112,38881803,19991291,0,2527552594,978016636,23578,[LV21]Lords of Valinor
187423027,ᴸᴳPandaFr3d,42508085,189731110,2048263,1957321,794040,914974,14674257,1867455,20208047,16541712,0,2849115211,6820681844,26354,[LV21]Lords of Valinor
181739549,kylinn,41829522,97526701,3321903,2389177,278410,278364,6880327,1328766,11155044,8209093,0,5128390117,10337862643,31310,[SFIS]Sky Fighters
187247613,Queen Padmé,41467972,215175254,3313856,4426292,2996263,4013920,16998645,1112767,29547887,18111412,0,7729333395,4688542203,87912,[LV21]Lords of Valinor
185690465,Dictator  Goat,41364116,357470758,2170212,6092140,2162244,1318953,32523873,1070665,43167875,33594538,0,6169380401,1005155698,35175,[LV21]Lords of Valinor
188483360,ᴼᴸTryxan,40856167,200408316,1209835,21229570,2837205,2706913,15624592,1170721,43569001,16795313,0,6153371861,2169436768,40574,[LV21]Lords of Valinor
188969478,ᴰᴹMePaul,40736065,97715103,990857,1956006,3290337,2582057,6816540,612480,15257420,7429020,0,3736013880,278578838,3657,[LV21]Lords of Valinor
188785515,Johnvin,40638514,174423228,1722597,874780,509812,1100372,15013974,934371,18433309,15948345,0,4977129271,93446315,57344,[LV21]Lords of Valinor
186199010,Daphneᴵᴿ,40549535,210955564,1801838,1835853,1275812,3351750,16169931,1646523,24279869,17816454,0,4201043407,1538857670,55983,[LV21]Lords of Valinor
188976136,ᴸᵛ MUSE,40077108,105848648,1240457,2095231,2355914,944966,8234111,729840,14360062,8963951,0,5201810919,365719425,48495,[LV21]Lords of Valinor
188485523,ᴸᵛIMPERADOR,39840243,198854196,1007660,600362,31074,81329,16162108,1836279,18711152,17998387,0,6329501230,281752989,37304,[LV21]Lords of Valinor
185282531,Annıɛ,38631309,45496988,2695521,469962,132883,175975,4001273,221030,5001123,4222303,0,3456998437,592793562,26285,[LV21]Lords of Valinor
179816952,Hell CAT GTR,38582562,59970288,2896557,79058810,1765741,1889101,2627306,339879,85680837,2967185,0,5512842178,1636698071,10956,[LV21]Lords of Valinor
188303104,HokieHighlander,38305136,84634083,1556655,393175,111135,71502,7064711,670003,8310526,7734714,0,1076306741,84975248,13809,[LV21]Lords of Valinor
186765655,KönigsKlãsse,38294210,233261031,1176829,2425318,1403168,1938998,19701224,1260070,26728778,20961294,0,3618896560,407789115,8673,[LV21]Lords of Valinor
185457048,Cman9918,38231477,133602129,1160939,3704156,1184975,873737,11641776,528932,17933576,12170708,0,1996001700,126071365,16769,-
178213242,ᶦˢLOCOOZ,38169500,140178485,3850546,2141345,957035,1554554,8372481,2394656,15420071,10767137,0,4410063529,1274602396,22170,[LV21]Lords of Valinor
188882878,Rtthyr,38137258,108559645,1037752,262928,107597,121724,9276273,752112,10520634,10028385,0,7495970776,93046400,19720,[LV21]Lords of Valinor
180368631,ᴸᵛWinfields,37940286,165583866,4678721,23224970,189123,611409,12174875,1818312,38018689,13993187,0,5269140435,1877834074,13904,[LV21]Lords of Valinor
187726069,ᵀᴿvSpryth,37823757,77885559,809475,1399758,170663,364308,6716619,432043,9083391,7148662,0,5519255230,15763287,24074,[LV21]Lords of Valinor
188651683,Sol Aliyaa,37652142,12784707,140221,119895,49805,35722,1148147,51838,1405407,1199985,0,3996814833,201676244,15692,[LV21]Lords of Valinor
188880730,ᴸᵛMarlone,37144187,148209496,1942492,485972,373109,200006,12467842,1094382,14621311,13562224,0,6007830315,136720000,45321,[LV21]Lords of Valinor
188569749,ᴵᴾEndoloris,37018743,135932617,1872172,1390988,2616276,1563397,10769220,823804,17163685,11593024,0,1822151378,163440000,5369,-
189072394,ᴵᴾLaura,37058460,51126391,1312098,15223045,383206,780510,3891089,264122,20541972,4155211,0,6340485997,362529904,27497,[LV21]Lords of Valinor
189060019,Tušiš,36903974,90723339,842859,792209,636796,1052564,7734347,386879,10602795,8121226,0,2986340129,572362793,20667,[LV21]Lords of Valinor
188789133,MiniMe,36555880,42476021,359853,260258,224998,177101,3821353,152602,4636312,3973955,0,5050408691,34179151,11947,[LV21]Lords of Valinor
188648613,Känguruᴵᴰ,36553614,25538784,340214,377701,272323,171077,2091875,165777,3078753,2257652,0,2953884233,286935074,13516,[LV21]Lords of Valinor
188276623,ᴸᵛArork,36331671,91915549,961128,7304379,1269333,1365737,7613004,316151,17868604,7929155,0,3865181833,360935366,16776,[LV21]Lords of Valinor
188805469,BossAlienᴾᴴ,36337961,69990201,1238059,250538,604492,927660,5961291,270378,8014359,6231669,0,5020720832,134750966,39904,[LV21]Lords of Valinor
189065897,W3llsFargo,35896442,36866964,662685,1191313,898257,213767,3194692,101510,5599539,3296202,0,3960371377,2754424297,19028,[LV21]Lords of Valinor
185048534,Han Sansan,35619277,150889156,910143,979301,344434,570272,13461016,655659,16010682,14116675,0,6176072002,357367305,32535,[LV21]Lords of Valinor
188333348,ᴷᴺLinh,35415533,70104133,935539,1902695,1645656,5139453,3916781,335333,12939918,4252114,0,4943073157,550111352,11085,[LV21]Lords of Valinor
182338045,亗ƧHiꟻT亗,35403265,150628524,1131937,2662150,1006449,1312309,10247812,2017792,17246512,12265604,0,5564942229,2545586970,32802,[LV21]Lords of Valinor
185986678,卂尺丂,35493778,91846834,1214629,681974,1395198,1304176,7560868,404733,11346949,7965601,0,3322058286,1193919485,15124,[LV21]Lords of Valinor
186444772,Dr4gonツ,34926606,289385091,3324962,5956177,3581878,4318595,25023732,675920,39556302,25699652,0,5343190068,4407255328,39688,[LV21]Lords of Valinor
185341770,ᶜᵘRalfish,34888870,60399425,2577295,843215,394122,498537,4521775,611532,6869181,5133307,0,2698889643,25760000,16057,[LV21]Lords of Valinor
188794709,ᶦᵗˢᵘRYU,34870642,109556794,998511,1318150,2549412,2529700,8724680,341437,15463379,9066117,0,3762465626,94094214,35924,[LV21]Lords of Valinor
181534760,ᴸᵛSongoku,34668603,83069917,1462391,951607,718037,1206878,7102593,279504,10258619,7382097,0,3925106423,755945265,16319,[LV21]Lords of Valinor
188969981,ᵸᵒWand0,34465664,65852934,1286067,2054730,706949,524275,5336241,428429,9050624,5764670,0,4299659159,306699275,22634,[LV21]Lords of Valinor
185089489,ᴼᴾZOROGRANJ,34432058,89977952,1885507,550571,355159,737615,7809122,405792,9858259,8214914,0,5703855206,2083599610,21234,[LG21]Lords of Gondor
189017405,ᵸᵒWizzy,34331067,39309436,1128087,812593,976175,1093762,2997282,142335,6022147,3139617,0,2774456400,170159151,14692,[LV21]Lords of Valinor
188336265,ᴸᵛiGREC,34038894,40103594,370445,535084,195209,299340,3462098,189391,4681122,3651489,0,2450337118,175934276,17486,[LV21]Lords of Valinor
190252265,Jamong,34008009,48035801,986726,240286,331209,224664,4135373,253647,5185179,4389020,0,5318367530,81003240,23640,[LV21]Lords of Valinor
188826595,Saf1974,33966507,125895255,1458385,1385035,561971,596074,9773095,1218953,13535128,10992048,0,5229770252,230946040,51259,[LV21]Lords of Valinor
188970345,PitBlue,33625765,103441103,903418,1127677,1623539,1658595,8380117,476647,13266575,8856764,0,4035371849,1077393393,23137,[LV21]Lords of Valinor
188362493,亗MrDuck ツ,33578854,57978367,1226707,14227295,2044148,1147653,4304378,170511,21893985,4474889,0,2841126697,909611190,17102,[LV21]Lords of Valinor
189154415,ᵸᵒMDKMB,33518481,64633908,791070,2593060,873151,733286,5003407,470089,9672993,5473496,0,2192567775,2686649384,20383,[LV21]Lords of Valinor
188501467,direraven,33439336,113277419,752809,5173869,2368802,2785598,8263017,686624,19277910,8949641,0,4923825921,4551820,27533,[LV21]Lords of Valinor
188837916,Silent Kakashi,33253162,105876915,889638,839969,754922,750377,9809221,155268,12309757,9964489,0,1802727274,103761097,14047,[LV21]Lords of Valinor
182713036,쵸ﾒMØTÃSÊMツ쵸,33055739,25758138,662283,107410,239091,451161,2273587,35898,3107147,2309485,0,5191803698,123301386,20725,[LV21]Lords of Valinor
188651684,Milo San,33014813,7567393,256838,5998,5637,18715,667806,40100,738256,707906,0,2997502795,359753808,12071,[LV21]Lords of Valinor
185612447,Chaudary Zain,32797464,146792912,1444870,9269291,1590830,914396,12570247,619867,24964631,13190114,0,4568356467,1323892732,25610,[LV21]Lords of Valinor
186841127,Anossss,32727480,96732783,1396074,5831747,161764,119554,8346773,564848,15024686,8911621,0,4278420065,4253401,14709,[LV21]Lords of Valinor
188736727,Alex9003,32672738,39909345,1661889,2965695,704903,767680,2742202,370683,7551163,3112885,0,4212303202,38138060,14361,[LV21]Lords of Valinor
187029935,HolySpirit,32594132,139214472,1508586,1270651,1347299,1593326,12091148,449048,16751472,12540196,0,2699705942,1104079437,18984,[LV21]Lords of Valinor
182317160,G  O  P  A R,32427540,181541897,2023644,4390697,2321165,2745552,15533244,485339,25475997,16018583,0,4274045567,754465485,28948,[LV21]Lords of Valinor
185037763,ᵛBEARDY,32277187,51437912,2227119,28222212,2319488,801981,2906415,444121,34694217,3350536,0,4921911553,554484409,19513,-
188451175,ᵸᵒTerra,32145694,60131594,870910,3422823,860914,534113,4833223,362826,10013899,5196049,0,4052479360,92432122,22463,[LV21]Lords of Valinor
187559873,ｱ尺ﾉ丂ᄃﾉﾚﾚﾑ,31983704,62577567,524842,786256,540194,444292,5234590,360843,7366175,5595433,0,2629725287,626443180,15368,-
188352541,ᴾᴿ Mèoッ,31939971,127518876,1258710,7188100,1700314,1303642,10538936,603835,21334827,11142771,0,6196434195,0,14405,[LV21]Lords of Valinor
188225231,ᴾᴿSko0p,31887290,33459441,362846,178306,89071,72567,3099403,98067,3537414,3197470,0,4568964965,0,27254,[LV21]Lords of Valinor
188242643,hoahaizz,31754191,125342482,960344,3664404,983434,590291,10198875,914641,16351645,11113516,0,3816579353,567041937,30472,[LV21]Lords of Valinor
188833519,JulieLaTueuse쵸,31718681,29358324,658444,141152,346846,94148,2531257,147362,3260765,2678619,0,3576345681,37720000,20072,[LV21]Lords of Valinor
189045190,Azura21,31378041,28966509,1079446,528436,682624,3020226,1491111,25178,5747575,1516289,0,2794880202,423984134,8179,[LV21]Lords of Valinor
190407807,동탄불주먹,31099749,29393118,1082915,1045271,330899,696549,2256677,158465,4487861,2415142,0,5354871796,433522789,15696,[LV21]Lords of Valinor
188368264,funne,30940146,33272269,1315248,897805,642680,597232,2395572,273135,4806424,2668707,0,3798253178,61698120,16821,[LV21]Lords of Valinor
185724517,Feldgraŭ,30899145,148059187,1759486,439339,3849630,1436815,11170614,1140933,18037331,12311547,0,4251305527,178066760,33535,[LV21]Lords of Valinor
188847278,ᴸᵛQuang,30830815,156416688,1233699,1297840,1436737,1289374,13827307,492654,18343912,14319961,0,4131584730,1618614837,34379,[LV21]Lords of Valinor
188598120,ᶻSharineko〤,30621846,93117053,982600,925849,1457411,810508,7174421,751541,11119730,7925962,0,2372885161,63185747,17465,[LV21]Lords of Valinor
184882401,Ферма а,30608494,92480601,1751855,22831138,3000621,3316968,6293708,285409,35727844,6579117,0,2683864785,3538154179,17500,[LV21]Lords of Valinor
188797972,21LuviVilu21,30579872,20912405,1289968,587315,524579,345021,1568808,133881,3159604,1702689,0,4422844100,34539709,16038,[LV21]Lords of Valinor
181581608,Fledermauz DB,30300813,37243233,694585,248895,300074,511759,3416369,19129,4496226,3435498,0,3616659454,377676127,7849,[LV21]Lords of Valinor
188961098,Chocolalat,30278072,2667617,220977,51569,65233,15462,226419,10040,368723,236459,0,4228765179,21199999,3649,[LV21]Lords of Valinor
188364390,ᴸᵛLeonPoi,30209555,158003555,1363790,518948,400864,665017,13736413,853692,16174934,14590105,0,3817795145,108004980,37013,[LV21]Lords of Valinor
188285810,ᴵᴰJupanu,30055205,52133016,1139226,875230,1573881,523582,4135952,267818,7376463,4403770,0,4862343433,57408174,20308,[LV21]Lords of Valinor
185923730,JFDLCA,30021575,284927140,474199,5150543,3803977,6044367,24032575,589293,39620755,24621868,0,4759808385,386336005,36973,[LV21]Lords of Valinor
177013392,ᴸᵛ UCC15,29928467,40187311,2690015,1200429,936753,881360,2997858,228485,6244885,3226343,0,5373157009,192271545,16247,[LV21]Lords of Valinor
188876886,ᴸᵛTheanh,29914348,145351918,1388404,17901111,323206,624011,12674274,594325,32116927,13268599,0,5586442968,107966937,35837,[LV21]Lords of Valinor
188789684,ᴿᵃtMadson,29708127,25288873,558556,1318578,162620,152532,2141667,133656,3909053,2275323,0,3962229466,92421016,41671,[LV21]Lords of Valinor
188316323,ᴸᵛ SAKURA,29666592,103904316,1378468,2386732,1137444,2024123,8778847,263356,14590502,9042203,0,4138563348,539454569,26746,[LV21]Lords of Valinor
188335709,Rebel Rogue,29646296,74476257,1366902,1040029,700124,771386,6310028,334109,9155676,6644137,0,3466850930,34205137,33796,[LV21]Lords of Valinor
188293704,ᴸᵛDrMusaab,29474377,45641826,1613595,191214,427716,173783,3854486,275408,4922607,4129894,0,3848071058,84578452,14693,[LV21]Lords of Valinor
188262339,Kitty27,29307980,8586612,109121,58400,178359,37776,575261,115725,965521,690986,0,3894644554,23588840,11139,[LV21]Lords of Valinor
189001955,ᴸᵛTruNguyen,29134158,34803561,725153,1039838,168924,415164,3020441,119634,4764001,3140075,0,4488451627,231678867,16994,[LV21]Lords of Valinor
188944242,Đạt Feet,29059630,23416085,783287,794019,734205,1502573,1353810,112024,4496631,1465834,0,4677803187,16457231,9356,[LV21]Lords of Valinor
185651937,ᴳᵃʸGrizzy,28913873,394704092,1530202,11881112,5833583,11664631,32492852,453683,62325861,32946535,0,3744084354,952357579,20305,-
188543996,ᴸᴳﾒNØHOPEツ,28577750,27652560,832839,367702,78081,197027,2405635,128920,3177365,2534555,0,3397470396,31608954,12109,[LV21]Lords of Valinor
186295211,ᶠˡVENDETTA,28561670,115576250,2742984,4081984,1084740,528626,9229579,909004,15833933,10138583,0,3885646386,1050356942,20084,[LV21]Lords of Valinor
186709522,ᴸᵛ SHERY,28441773,62185658,1562880,609853,401512,544566,5212806,347717,7116454,5560523,0,3409511725,99489407,9543,[LV21]Lords of Valinor
188830020,ᴸᴳVersized,28440381,71672121,891087,658409,938556,437662,5862888,464190,8361705,6327078,0,3820133733,46055668,11056,[LV21]Lords of Valinor
185282573,ᴸᵛ3621 BANK,28384177,62632106,771884,668111,1267167,649115,4855577,440596,7880566,5296173,0,1380539730,2253285969,8673,[LV21]Lords of Valinor
188819438,ᴸᴳLuca,28355247,46983742,616568,378993,894190,250296,4088058,161890,5773427,4249948,0,4243316661,626280200,24202,[LG21]Lords of Gondor
182720562,ᶜᴹᵈSkyy,28092367,19752884,2388318,291902,77615,310791,1289299,270156,2239763,1559455,0,3999667646,685652689,12498,-
188547640,Kitty8152,27870079,1630693,12032,78078,153637,150776,70470,0,452961,70470,0,6382583868,2547000,7693,[LG21]Lords of Gondor
188788713,Sam smith,27834339,36247697,772626,601729,331796,180165,3096282,189014,4398986,3285296,0,3917759832,33958258,12664,[LV21]Lords of Valinor
188880546,Graf000007,27636112,4086246,1602923,195112,206722,115320,276770,20240,814164,297010,0,3517200943,0,4087,[LG21]Lords of Gondor
186043643,卂几Ҝ卂,27591774,66412584,1325466,948183,319988,430578,5706384,339841,7744974,6046225,0,3307144775,501165307,31017,-
188806334,Emrah 51,27427392,3751158,1312229,1012,10602,4008,371372,0,386994,371372,0,4133003650,0,4422,[LR21]Lords of Rohan
188872694,DELİ ÜSTAD,27385834,5962066,716649,208561,290491,524323,257508,33350,1314233,290858,0,4349510245,39905983,2134,[LG21]Lords of Gondor
185538462,UMAYKIZ,27382331,83778027,1228227,2428097,767351,902894,7178353,318130,11594825,7496483,0,4064168124,8566632,6482,[LV21]Lords of Valinor
188853241,Алёнаа,27178610,28003663,751734,247949,344883,856812,1850580,266563,3566787,2117143,0,4578698547,45525540,13074,[LV21]Lords of Valinor
188294260,CЦEПИOH,27122074,10421111,1855157,581297,556310,288078,772954,15519,2214158,788473,0,2747070645,173206292,7538,[LG21]Lords of Gondor
188852900,Scorpionking乂,27070138,86546597,2576331,701687,536852,1689544,7398736,229351,10556170,7628087,0,2247532676,58256706,32682,[LV21]Lords of Valinor
188453555,Puyols,26907301,60917445,1151228,436986,356297,226446,5266335,327416,6613480,5593751,0,6852157263,127173124,24801,[LV21]Lords of Valinor
188192835,SвулканS,26898843,19967704,388225,2031363,306088,979874,1431780,35598,4784703,1467378,0,3364532541,52162299,9117,[LV21]Lords of Valinor
185602720,ˢᵉAbdallah,26733747,37680310,200395,749910,727131,953454,2914261,155982,5500738,3070243,0,1721001569,127071312,10003,[LV21]Lords of Valinor
188544046,G4mine,32447417,26635738,854807,262602,631545,296942,2070874,171181,3433144,2242055,0,4317317823,247760315,20193,-
188818127,ᴿᶝ风华,26544969,2158531,1064759,62955,74067,33164,157987,14264,342437,172251,0,4171304985,64472747,3912,[LG21]Lords of Gondor
189141193,ᴸᵛJankels,26532246,64514241,899417,2484769,1932099,2347605,4646643,214812,11625928,4861455,0,3320476893,28726902,16753,[LV21]Lords of Valinor
189040679,ㄴHORIZONㄱ,26495211,74776471,764075,947828,1035889,885967,6855262,20932,9745878,6876194,0,4541245002,188105599,14268,[LG21]Lords of Gondor
84905552,Schwazzier,26472183,10701276,506526,147563,86882,62010,838244,93376,1228075,931620,0,3221948944,60672597,8227,[LV21]Lords of Valinor
188939030,TBILISI,26441519,7839558,1253222,516250,1297487,330601,372081,4906,2521325,376987,0,3087477786,460258,11726,[LG21]Lords of Gondor
188364525,ᴵᴾEmrys II,26412458,3119874,218964,53070,30135,8285,294045,3770,389305,297815,0,2091717356,0,2715,-
188575943,BATUMSKİ08,26307804,124654920,2518476,8729094,9991171,6956425,7155716,177195,33009601,7332911,0,2820885482,529137921,20882,[LV21]Lords of Valinor
188877484,ᴵᵀBLOOM,26240463,73412319,1615750,429658,286070,678042,6496736,253736,8144242,6750472,0,1847010287,111895750,28933,-
189939798,ʰᵒDestructor,26132912,19301020,52616,21684,68111,82633,1882993,0,2055421,1882993,0,2903073926,11281500,871,[LG21]Lords of Gondor
188836483,YenifferDeRivia,25985998,41837660,1714676,1784534,2318341,1691838,2868362,69655,8732730,2938017,0,3408936737,140738085,4885,[LR21]Lords of Rohan
188365363,diegokristy,25917339,51716215,476980,429498,640200,815724,3975172,366765,6227359,4341937,0,3732548700,246281206,15813,[LV21]Lords of Valinor
186010544,Mehmet027,25697001,62931748,1625859,1870063,1718352,2118048,4927050,68917,10702430,4995967,0,3067883495,173638054,9242,[LV21]Lords of Valinor
188806124,ᴵᴾAltar,25682493,111614407,1481141,3177848,4192360,2583327,8685363,270359,18909257,8955722,0,2531022967,7742830,26734,[LG21]Lords of Gondor
188277784,ᴵᴾPecimura,25452323,28014853,96045,30115,106786,86982,2470635,137049,2831567,2607684,0,1998734967,30935666,8680,[LG21]Lords of Gondor
188835262,vinzsou,25393612,20990559,412411,54559,97814,69115,1894618,78069,2194175,1972687,0,2306024048,0,13370,[LV21]Lords of Valinor
188891048,7BeLa,25348582,57642914,872000,370252,777201,2820258,4394591,39376,8401678,4433967,0,3249200119,137794496,5869,[LG21]Lords of Gondor
188855274,GOLTEB,25327545,130249344,1327294,1219432,175391,426239,11912788,441092,14174942,12353880,0,3402030514,35237187,42048,[LV21]Lords of Valinor
188912287,ᴸʳgCoelho,25305267,37205295,820622,1467378,848164,1089303,2821252,132288,6358385,2953540,0,2465387638,113818904,7323,[LV21]Lords of Valinor
188836051,Cheops Pyramide,25061548,78091823,1222442,665596,285383,464232,6982969,285066,8683246,7268035,0,4516670725,751419894,38465,[LV21]Lords of Valinor
146179581,lupepvp,24969997,13562246,618028,207971,115291,37945,1095257,109286,1565750,1204543,0,5421423045,108915418,15601,[LV21]Lords of Valinor
188320476,ᴿᵃЛиса,24963532,44225734,1180179,367833,506674,549870,3678646,207644,5310667,3886290,0,4829162751,362428945,40111,[LV21]Lords of Valinor
189236516,ᴿᶝ年华,24588839,2290337,936926,56107,169818,48265,162204,6219,442613,168423,0,3796520111,48671853,2969,[LG21]Lords of Gondor
188319008,ᴸᵛКэп21,24483757,10075514,29597,216150,128394,92909,914970,12708,1365131,927678,0,2233408969,0,10987,[LG21]Lords of Gondor
188324838,ХОНДА,24413953,7990779,1618420,319927,430706,215833,601619,9293,1577378,610912,0,2520068321,122738819,6016,[LR21]Lords of Rohan
188937309,Velikiy Govard,24299588,9823194,638326,125640,141509,280242,795672,21868,1364931,817540,0,2747451433,125678023,5279,[LG21]Lords of Gondor
188840841,ᴸᵛNotZach,23918966,32939204,548532,661641,826162,444933,2565980,185751,4684467,2751731,0,1666178158,107725390,4643,[LV21]Lords of Valinor
181974650,IDEM City,23791400,2030305,1163258,142285,141908,58538,141798,3295,487824,145093,0,3776027518,86095121,2071,[LG21]Lords of Gondor
184872506,ᴾᴿF A J A R,23766513,81330450,1396757,2282220,2097345,3030279,6197714,129053,13736611,6326767,0,3250277163,28252952,13422,[LG21]Lords of Gondor
184845080,ᴸᵛSCAR德,23678591,58418755,674804,215275,313814,201078,5110600,291888,6132655,5402488,0,3898154530,46674299,28620,[LV21]Lords of Valinor
185094982,Phi Dương F2P,23648151,38331232,1940175,2842133,5213473,4079345,964930,68459,13168340,1033389,0,2118736840,147926355,5493,[LV21]Lords of Valinor
188793523,FerAmaya,23597951,14144029,506442,137105,231910,107247,957884,182248,1616394,1140132,0,3610496763,43532335,5378,[LV21]Lords of Valinor
188376202,ᴵᴾ云霄,23406909,6580450,1214571,147461,159504,83670,521541,34093,946269,555634,0,2594984100,17020000,4282,[LV21]Lords of Valinor
188994494,Snowplow,23349742,1094552,236306,8504,103749,19351,80795,0,212399,80795,0,2929498949,0,3468,[LR21]Lords of Rohan
188390528,ᶦᶠAkrosh,23306956,14179254,358164,80861,884019,546131,1021052,0,2532063,1021052,0,1408491622,139317710,2243,[21If]Immortal Falcons
191454845,ᴸᵛTueAnh,23276075,23312388,683409,6097691,110426,294887,1803919,132663,8439586,1936582,0,5691341063,1141408023,12375,[LV21]Lords of Valinor
188880486,Kỳ tiktok,23247855,9134722,1062496,68271,30446,79884,647748,113158,939507,760906,0,4047919467,0,3252,[LV21]Lords of Valinor
188899189,QuantSist,23197500,1720056,385409,11624,68715,76283,127517,0,284139,127517,0,2106785390,296458,5563,[LG21]Lords of Gondor
188851823,ᴸʳMent001,23073747,706360,45963,213744,185983,43829,11633,0,455189,11633,0,2029638946,0,2780,[LR21]Lords of Rohan
189057248,Cekko23,22888812,25143406,621793,180774,267446,395040,2050364,124428,3018052,2174792,0,3703142100,76002446,11421,[LV21]Lords of Valinor
144563085,ᴵᶜPARANOIA,22878266,4730553,1770534,15817,22531,23272,408292,25316,495228,433608,0,2831381744,1021382,4811,[LG21]Lords of Gondor
188937116,ᴵᶜTom,22847232,4798418,78668,26543,281358,25756,401873,5432,740962,407305,0,2254933220,6485919,12148,-
188661481,Kängurufarm,22685146,2847269,781585,208965,117034,10247,253042,0,589288,253042,0,2409834236,1128542199,4146,[LG21]Lords of Gondor
188842111,JJ00,22535635,12699687,546042,13757,120082,40863,1080466,74433,1329601,1154899,0,2619609251,3999999,3677,[LV21]Lords of Valinor
188830522,ᴸʳTylnmrl,22362863,1670861,37663,32839,20609,4164,155652,2495,215759,158147,0,2321185914,16585000,4664,[LG21]Lords of Gondor
188234979,iGRECfarm,22319661,15844038,286311,273003,46153,43158,1490992,30729,1884035,1521721,0,2703807026,315563112,10672,-
186016235,卂丂卂千,22099768,5571622,172363,142922,151729,14030,405110,56618,770409,461728,0,1972455860,12932669,3880,[LV21]Lords of Valinor
188639928,The亗SCARFACE,22094453,2476955,64606,145589,285116,162864,116131,3242,712942,119373,0,3254171265,44040000,4353,[LG21]Lords of Gondor
188878743,Jetare,22067395,15241706,984262,914090,1762279,1205895,613645,28715,4524624,642360,0,3281778141,91210728,3093,[LV21]Lords of Valinor
185905587,Ze Boshman,21929998,4802837,1158706,309125,97861,13805,369719,39644,830154,409363,0,2770839083,41584565,2619,-
188870613,xXVincinetteXx,21868756,8307709,1851059,867867,503902,29008,656394,22318,2079489,678712,0,4699104174,5876311,23600,-
188846843,BoboFranek,21704370,1436892,86860,96434,230127,133623,42286,0,502470,42286,0,1842439115,45731253,5585,[LG21]Lords of Gondor
184817793,meto 313,21645329,2940073,2001835,184629,125724,112750,75554,72258,570915,147812,0,3020220642,1827622,1807,[LR21]Lords of Rohan
188838640,Presidente CIAO,21588467,3248958,61803,13150,115426,83389,268192,0,480157,268192,0,1666188180,23800000,4571,[LG21]Lords of Gondor
188255601,Ant Man21,21587050,21740037,261646,303216,192688,238972,1939567,47123,2721566,1986690,0,3143089623,0,3958,[LG21]Lords of Gondor
188664465,ᴸᵛEren 勇,22074129,49965974,1623051,606890,681174,827892,4278040,119514,6513510,4397554,0,1902975921,650343921,22154,-
188337674,ᴵᴸAxan,21374002,13852737,908861,382486,81728,81286,1314956,6904,1867360,1321860,0,2647755447,376836150,9610,[OP1]OP CLAN
188819819,fox77778,21312758,3782562,738594,75581,204618,428450,164441,0,873090,164441,0,3368398876,1037349,4748,[LG21]Lords of Gondor
186018265,yıldırımsefa,21255660,12642300,258459,159713,850626,471324,812371,45005,2339039,857376,0,3143688481,50620184,8903,[LV21]Lords of Valinor
189036655,Vitia back 1990,21144601,9551108,2056000,172660,105414,21917,821704,50052,1171747,871756,0,2739601695,9800000,8607,[LR21]Lords of Rohan
188889549,СЦEПИОН,21044476,2997871,1241527,21675,25683,72660,248333,8410,376761,256743,0,1929432752,102567597,3695,[LR21]Lords of Rohan
188856715,ᴸᴳJackie,21031912,15197220,284873,80252,30041,24787,1332528,84833,1552441,1417361,0,1277149246,20000000,4150,[LV21]Lords of Valinor
187503097,Romulus1991,20870638,35322045,243649,236337,79945,281812,2962594,218085,3778773,3180679,0,3939977902,82802396,17969,[LV21]Lords of Valinor
188876948,Ruberoid,20736558,1308095,30041,24678,63862,55794,95226,0,239560,95226,0,1492296960,3846529,4625,[21If]Immortal Falcons
188443825,йкйцк,20721165,48743894,1313992,1943111,2457331,1223280,2839555,507597,8970874,3347152,0,2532968576,1971457076,21172,-
188790227,СУЛИМАH,20689024,2937806,1265520,69552,52214,89972,230812,7573,450123,238385,0,1855508039,102878721,3417,[LR21]Lords of Rohan
188884453,dm152,20625825,261473,0,20838,55033,4660,12860,0,93391,12860,0,2743863393,0,4369,[LG21]Lords of Gondor
187197359,Demir Bilek,20593071,9273471,779097,120768,235808,174193,781889,13102,1325760,794991,0,2280598658,30192868,11215,[LG21]Lords of Gondor
184819319,joe200,20426646,2022401,1197317,130789,249677,21520,45323,47879,495188,93202,0,1631673131,91263980,5852,[LG21]Lords of Gondor
183360513,ᵀᴸмønoメ,20415868,26110591,478300,186118,247673,221163,2277659,95839,3028452,2373498,0,2125813241,85509847,6981,[LG21]Lords of Gondor
188884272,ZHIANZD,20398835,1216090,246973,127800,150740,29760,77001,0,385301,77001,0,2488342395,0,2033,[LR21]Lords of Rohan
188853064,TerrorBlade98,20357330,4698786,941546,120572,115534,39441,414286,7149,696982,421435,0,3391869243,0,1372,[LG21]Lords of Gondor
188903920,JoshuaSeil,20355554,6169856,820331,57540,197750,100917,483086,26416,865709,509502,0,2970338273,301497,4243,[LV21]Lords of Valinor
188847403,Vali188847403,20354818,1805843,502942,88125,113717,240436,59904,0,502182,59904,0,1174440329,0,641,[_NDM]New Jersey Nol
145631489,BABA SON,20327984,7880142,290848,136434,494296,267396,373532,102968,1374626,476500,0,2287772801,4400000,5147,[LV21]Lords of Valinor
188836639,Ndiaye,20306416,5853377,660696,352077,491543,747064,181162,0,1771846,181162,0,3024292651,383503,1633,[LLA]Lost legion academia
188325495,쵸 See La Meet 쵸,20218723,26136473,714725,1038428,1614240,1553702,1521512,63519,5791401,1585031,0,3512199870,0,7931,-
188806434,ᴸᴳ Bimz,20195843,5080363,658635,38897,29786,6973,390944,53784,520384,444728,0,3038576801,29458520,9921,[LV21]Lords of Valinor
191530671,ᶦᶠtMadsonn,19971791,1846035,34099,69047,86817,200703,85578,0,442145,85578,0,2675931529,910375198,4623,[LR21]Lords of Rohan
188857113,GritNGravy,19961099,1953070,46395,39362,14347,20181,183578,0,257468,183578,0,2972539795,3200971,3746,[LG21]Lords of Gondor
188644411,IQ777,19924496,10297771,72917,271035,682547,244380,661655,64220,1923837,725875,0,1174120561,127703632,20887,-
188898779,kral jon snow,19901685,113087,6227,15339,20427,859,6573,0,43198,6573,0,2753058077,8327554,2900,[21If]Immortal Falcons
188261313,freezebee 21,19877881,2027071,234347,244875,375237,108803,79241,0,808156,79241,0,1773688702,5187959,14598,[LG21]Lords of Gondor
188814205,SUBUTAİ 38,19776974,1466044,274608,292102,181430,22696,95398,0,591626,95398,0,2012636067,3080000,2317,[LG21]Lords of Gondor
186613612,Inigo Montoya1,19723272,4819124,1455414,349831,116242,28761,406977,16593,918404,423570,0,2704436963,103076547,8703,[LV21]Lords of Valinor
189075824,NooByZ,19621709,8523920,1530004,77034,121760,128921,748617,13157,1089489,761774,0,3365718003,99259891,19016,-
188232993,AKON311,19570367,17474104,658995,571073,531874,842388,1182997,54831,3183163,1237828,0,1770213436,850687088,12260,[LG21]Lords of Gondor
188430882,JapayuKingBILAT,19551295,16224241,589575,264537,718955,348631,1254670,39610,2626403,1294280,0,2904258022,142262581,15978,[LV21]Lords of Valinor
140534782,ᴵᴾCoCaSNX,19345651,21797010,531203,1203243,267031,348395,1715668,123602,3657939,1839270,0,3530980381,2108538017,6924,[RC21]ROYAL CROWN
188776545,ᴳᵒᵈ Ingle,19286962,1048600,93501,85140,135892,24107,66336,0,311475,66336,0,1714419959,3404666,5152,[LR21]Lords of Rohan
188539042,Chieu F2p,19260778,33524795,572222,886405,1728535,661706,2271668,226347,5774661,2498015,0,2152922267,185342934,11659,[LV21]Lords of Valinor
184859052,ᴸᵛamadxd1,19197520,11140391,1696065,175899,454668,303269,783220,57530,1774586,840750,0,2251061229,315992716,7290,[LV21]Lords of Valinor
188838663,ERON,19175110,7419903,732610,190505,250716,72425,647213,5927,1166786,653140,0,2017632047,20081022,12083,[LG21]Lords of Gondor
188818238,PoTaPyh,19113900,17945708,847850,488230,854873,981299,1155520,32896,3512818,1188416,0,3095818334,301072527,13050,[LV21]Lords of Valinor
188827507,Dug1man,19104457,106428,5346,18103,18794,0,6522,0,43419,6522,0,2607340752,0,2502,[LG21]Lords of Gondor
188367613,ᶦᶠKinkyTail,18907753,31466541,685293,1501619,757662,736951,2401197,134556,5531985,2535753,0,1019609814,58186939,13237,[LV21]Lords of Valinor
188869412,dân chơi đá,18877333,8228309,246570,288205,739830,1185717,194814,0,2408566,194814,0,2106256471,1154652,1641,-
188490339,Eudaimonia,18872575,5934482,227320,56910,36785,12770,501291,39277,647033,540568,0,3355136568,30962500,5900,[LV21]Lords of Valinor
164927516,iven0007,18940366,10570899,800589,584997,950594,899393,447468,24023,2906475,471491,0,1132415952,29829009,6386,[LV21]Lords of Valinor
150165925,ᴸᴳken arok,18649511,22815355,626373,4481846,278206,119051,1902411,93113,6874627,1995524,0,2501529806,26909895,12034,[LV21]Lords of Valinor
188844580,RedHoodJT,18590381,3724748,210774,117223,615129,546669,28437,0,1307458,28437,0,1723769705,0,1485,[LR21]Lords of Rohan
188806199,Op khan,18577256,4774879,1311876,240925,827408,507637,83281,10426,1669677,93707,0,2989868721,4253716,3252,[LR21]Lords of Rohan
188360951,SATORUGOJO1,18439403,9538625,472927,508838,996498,575503,443101,35542,2559482,478643,0,1617479709,317828071,6746,[LV21]Lords of Valinor
188836606,Black AngEL,18388085,8655975,1937740,908418,995278,553139,422312,2403,2881550,424715,0,2141610562,18536152,1822,[LG21]Lords of Gondor
188336750,SKY EAGLE,18136313,7121747,985124,330019,49903,45477,677403,0,1102802,677403,0,1931799839,213802552,9588,-
189014302,magister,18060393,11593788,947900,205152,1188782,528161,695989,5133,2623217,701122,0,1327725746,15363819,7384,[LG21]Lords of Gondor
188823442,VIP shooter,17982680,3305125,846887,132688,41914,75500,277768,5754,533624,283522,0,1656521933,41800001,5267,[LG21]Lords of Gondor
188884243,HiagoLira,17957821,1285899,1,5567,1871,82946,94926,0,185310,94926,0,1666634390,0,2372,[21If]Immortal Falcons
188787622,MalandrageX,17894752,20690,0,2434,1687,245,1585,0,5951,1585,0,2541853655,0,3292,[LG21]Lords of Gondor
188865329,Việt hoang 07,17892195,607097,64769,419495,234049,900,5150,0,659594,5150,0,2214217502,1833721,888,[21M]Immortal Myrmidons
189231766,darkkiller666,17669854,3746982,286312,236683,195194,50737,294065,8283,784962,302348,0,2533244060,20289481,14046,[LG21]Lords of Gondor
188487100,Kir8,17669699,744292,46498,47082,45400,57564,41382,0,191428,41382,0,612457103,0,4413,[LG21]Lords of Gondor
190852683,BossAlien FARM,17618699,6771910,168409,19244,81805,135783,606132,0,842964,606132,0,4361562822,1694123182,2709,[LR21]Lords of Rohan
187016834,卂几Ҝ卂1,17485369,5969476,107689,89142,174787,122716,511121,0,897766,511121,0,2808116054,1649060086,4842,-
188904786,Shadow vahalla,17427885,951871,236630,6845,11062,4462,91053,0,113422,91053,0,2876572214,0,3024,[LG21]Lords of Gondor
189068044,Hsotits7,17386545,13123610,995230,966771,1440390,1040579,499742,44487,3991969,544229,0,2189491384,16241240,3490,[LG21]Lords of Gondor
188879533,Qertt7,17252552,188791,322,8039,23990,816,10230,1682,44757,11912,0,4178987117,38000000,2195,[LG21]Lords of Gondor
188368666,Derik 災,17193465,17311218,78795,189202,156137,96806,1633226,12081,2087452,1645307,0,1504456225,57910439,4670,-
196566747,Codrin4Valhalla,17183404,7931308,238487,278350,157181,127114,631250,37016,1230911,668266,0,653910155,89594454,6476,[LV21]Lords of Valinor
188868206,Quocbao05032012,17065087,1765350,652703,140343,12908,5049,169127,0,327427,169127,0,1791268086,6000000,2051,[LR21]Lords of Rohan
188432088,BandAid,17053324,6291099,303434,23738,88926,146960,503492,24287,787403,527779,0,3081530058,308659606,8340,[LG21]Lords of Gondor
188585266,メDragønメ,17046256,6200803,260935,13008,75292,24207,548489,23295,684291,571784,0,1565973095,73489482,19339,-
188876717,DEWO YEAGER,17059895,4877341,1101397,433008,785790,354455,180134,0,1753387,180134,0,2540565704,0,1778,[21if]farm 21If
188503741,SİYAH KAZ,16994656,2745204,35926,148261,185391,246920,121345,7182,709099,128527,0,1557000457,38351774,6878,-
188928573,Thànhteo,16834657,1269484,231737,5214,47138,152454,56435,0,261241,56435,0,1518718910,0,3090,[21M]Immortal Myrmidons
188824641,Sabesaur312,16783039,178017,72,61605,21023,10955,7983,0,101566,7983,0,717328751,0,1962,[LR21]Lords of Rohan
189181702,222mb222,16749931,2096107,769471,199359,63662,40288,176776,0,480085,176776,0,3151870414,225401626,1752,[LR21]Lords of Rohan
188845980,Azadi,16673275,2414584,591878,280392,474111,105066,99002,0,958571,99002,0,1863882325,3366983,1072,[I-am]RoyalLoyalMembers
188861925,blackbandito,16559250,3299236,432177,181283,407143,143151,130863,28373,890813,159236,0,1581842751,24105565,2007,[LG21]Lords of Gondor
188894198,Tomioka senpai,16376978,379272,52185,4153,47557,61967,3546,0,117223,3546,0,2619080647,0,1814,[21If]Immortal Falcons
190329472,F1Quang,16355703,14222941,1403680,76015,288128,303523,1225945,7897,1901508,1233842,0,4015720164,2942670794,8506,[LV21]Lords of Valinor
188513738,MooSáke,16325799,198927,96089,15385,14235,12870,11590,0,54080,11590,0,1810318491,0,1221,[RC21]ROYAL CROWN
188436016,KiLLedYouhaha,16232785,7835320,255634,186713,224968,166588,620167,24001,1222437,644168,0,2660898521,135055118,10056,[LV21]Lords of Valinor
188852196,DarkExecutioner,16177458,1452447,100617,60616,84044,164244,61526,0,370430,61526,0,1216662089,28060602,1834,[TFS:]The Forsaken Souls
188833114,Quent2,16087848,28402168,426151,334512,76938,382240,2357331,153956,3304977,2511287,0,1493723322,21298007,10794,[LV21]Lords of Valinor
187880560,wcwc,16017764,230115722,1527635,19485000,18674475,23053443,9591814,36893,70841625,9628707,0,3214040764,596448438,13547,[21if]farm 21If
188376429,ᴵᶜmySoul,15863805,447638,94861,165290,199177,4054,1,0,368522,1,0,1317663453,7488905,8468,[LR21]Lords of Rohan
188134384,ˢ carlossainz,15730884,6601011,1300774,21788,65922,52235,498539,63524,702008,562063,0,1190118090,25406959,4006,[LG21]Lords of Gondor
188825002,Namiq Cebrayilo,15645200,3934535,1259596,213707,290110,151386,270603,0,925806,270603,0,2249695442,0,773,[LG21]Lords of Gondor
188857667,Apoathou,15530533,1322660,1124764,128214,19733,13903,120194,0,282044,120194,0,230139173,156690,1091,[LG21]Lords of Gondor
186035363,Klgi20,15502890,1079100,1084576,54111,135908,7883,18115,29189,245206,47304,0,1914793462,1200000,3139,[21If]Immortal Falcons
188878343,Cheiron City,15499297,2006372,65708,76640,299335,127026,88427,0,591428,88427,0,1369437548,0,1667,[21if]farm 21If
187078010,Dr4gonsFarmerツ,15490724,22163921,1316246,641729,1799365,1256244,1338903,1142,5037383,1340045,0,2602487365,1725005764,7893,[21If]Immortal Falcons
188825941,S0SKA,15447745,1189854,237525,181770,115056,123932,42766,0,463524,42766,0,1573181792,17191302,2471,[21M]Immortal Myrmidons
188809474,Edgar15,15275743,46285,13168,43659,11087,2650,478,0,57874,478,0,2116886110,0,1245,[21M]Immortal Myrmidons
188879219,Akglate,15231878,247677,40137,19567,121882,0,0,0,141449,0,0,2071709078,1758755,592,[LR21]Lords of Rohan
187560016,Kyubi Farm1,15158347,43242083,1156562,1634869,1976614,1528733,3245429,19633,8405278,3265062,0,1354099339,409430369,6747,[LG21]Lords of Gondor
188877463,Se Tuath De,15126061,1904865,811661,93157,158781,182383,83914,0,518235,83914,0,2561221311,5600000,2433,[LG21]Lords of Gondor
188785649,priam,15008494,1750608,803133,48303,27617,11291,164055,0,251266,164055,0,1492317822,18007168,328,[tgqm1]amarl
188858878,lisabella,15001538,237752,277117,67710,112105,0,0,0,179815,0,0,579853911,0,1617,[21M]Immortal Myrmidons
188781490,Fra1d,14963604,1187031,100258,39857,116341,94712,56753,0,307663,56753,0,1220961083,5509155,3143,[LG21]Lords of Gondor
188800436,LilPiglet,14944668,769658,220953,34240,152043,47076,27042,0,260401,27042,0,1373555406,0,1295,[LR21]Lords of Rohan
189036275,TheBlackDragon,14929228,163506,24134,22964,32186,14353,3713,0,73216,3713,0,2053431597,0,1778,[LG21]Lords of Gondor
188365295,ᴿᵃTsumiki,14849316,2089406,0,8924,38778,19749,193107,0,260558,193107,0,1063300942,3762398,6032,-
12113325,Elena23EV,14829477,1817847,131418,8455,10921,55191,154067,1644,230278,155711,0,1138089760,24431024,5766,[LG21]Lords of Gondor
188986083,KyoHN,14770298,58505,16806,10125,15173,711,2329,0,28338,2329,0,2349901910,69,2863,[LG21]Lords of Gondor
188963486,GÖZTEPELİ35,14745890,131575,0,26938,85,5222,10513,0,42758,10513,0,1956299993,230887100,3805,-
183848200,Ei Farm,14731064,38195393,1298931,2526718,1320489,1044558,2973860,56612,7922237,3030472,0,3111047090,519374881,13485,[LG21]Lords of Gondor
188802524,Yamato68,14724102,193221,131028,1699,7453,9839,13862,0,32853,13862,0,1224230305,13257436,2993,[LG21]Lords of Gondor
188863496,dark8582,14729808,408222,113485,9062,63839,37988,12678,0,123567,12678,0,1907331881,0,711,[jk10]jk 3621
188847086,Dimiboy,14522783,75311,0,179,37638,0,0,0,37817,0,0,1250096823,0,28,[Tick]Tick tack
188796842,Menda2137,14426815,321687,136804,21106,48638,8855,18477,0,97076,18477,0,1116877840,0,1470,[LR21]Lords of Rohan
188873290,FarmЛиса,14413865,5775194,596991,64191,23711,6956,553801,7455,656114,561256,0,1505640462,122800001,4172,[LG21]Lords of Gondor
188806889,Gouverneur188806889,14331490,785370,316714,61610,182543,80923,8427,0,333503,8427,0,1097913878,0,1024,[21MS]Myrmidons Farm
188858305,Palestine313,14280634,3028033,1334422,129577,527939,188640,119168,0,965324,119168,0,1414266214,0,4,[Alg]Palestine313
188885945,whyreall,14191004,1427513,1410059,61686,45602,10688,128122,0,246098,128122,0,1497367838,862617,2035,-
188287771,ᅟᅠᅠᅠᅠᅟᅠᅠᅠᅠ ᅟᅠᅠ,14141951,55673152,491916,382510,936262,319444,5244635,0,6882851,5244635,0,5046523420,2464968833,28930,[LG21]Lords of Gondor
188856535,HOIANA,14054766,1190153,693357,435295,160981,54643,43890,6183,700992,50073,0,1813518289,400000,1184,[21if]farm 21If
188931757,ᴸʳANTHRAX,14007150,659165,84307,164935,187652,32931,11915,0,397433,11915,0,1443661971,0,2111,[LR21]Lords of Rohan
188832666,ChifOJ,13993938,2361104,125471,94442,41533,55215,203829,0,395019,203829,0,2611429443,0,544,[21IR] Corral
191177358,RtthyrFarm,13968514,52258,8925,14892,0,0,4928,0,19820,4928,0,3640496481,1594265331,1162,[LG21]Lords of Gondor
170835406,ᴵᶜ Has,13955620,1445859,679890,46009,32626,7559,101847,16135,204176,117982,0,687055286,298517,2940,-
188896546,БорисBao,13857624,1182765,168254,14668,118405,170863,25957,0,329893,25957,0,1761224189,22966398,1423,[LR21]Lords of Rohan
188953179,SarahVinyard017,13756390,5795264,260817,103502,87804,304494,438098,0,933898,438098,0,1388844714,31860199,3832,[LG21]Lords of Gondor
188787790,You  andl,13592993,920284,416012,51124,134014,82128,31352,0,298618,31352,0,1387994461,4084888,1963,[LR21]Lords of Rohan
44936497,젝스킹,15991483,6996924,923387,39204,54846,41378,523118,74135,732681,597253,0,2183506756,0,9052,-
188837379,안정아남자,13483678,885792,199719,262430,137821,8581,52334,0,461166,52334,0,1896368126,0,1124,[LG21]Lords of Gondor
187795145,SOTER,13447632,8447735,539910,529189,65018,309343,652149,22650,1578349,674799,0,1286481653,112215799,15309,[LG21]Lords of Gondor
186073361,卂尺丂Farm,13435636,4138657,585035,39537,204145,32135,344752,7320,627889,352072,0,2286157342,489706596,1515,[LG21]Lords of Gondor
190539451,puyolF,13329021,972686,309560,2673,66571,105265,41795,0,216304,41795,0,4786852197,1818372170,2077,[LR21]Lords of Rohan
191069538,Shinnygamyy,13280650,3037148,499817,235031,755080,228183,56725,0,1275019,56725,0,1083252012,5089962,691,-
187257305,HolySpirits,13221458,4186335,271743,116035,83670,59317,375642,105,634769,375747,0,1164962213,477259605,5804,[21If]Immortal Falcons
188899884,hanaaaa230,13173699,3656113,993138,112016,538707,284659,141766,0,1077148,141766,0,1533427163,3785937,1114,[K~R~]3621 Utility Box
188836866,zlucifer,13134321,2684582,271491,220751,328964,145856,139908,0,835479,139908,0,1701695970,0,1524,-
185484265,Tors228,13083005,7740094,636018,1305674,1878812,627539,120762,178,3932965,120940,0,1312958755,25325363,7376,-
123456386,Igoryan,12976637,5049921,193112,1352415,222892,143876,374139,838,2094160,374977,0,1439667107,11392165,1369,[LG21]Lords of Gondor
188887466,Jensamtresen,12961460,2851467,834974,287219,392239,254799,99035,0,1033292,99035,0,880825536,10799999,842,[I-am]RoyalLoyalMembers
193596249,Korkusuz 51,12958052,239160,358859,12402,0,0,23668,0,36070,23668,0,1401609699,60357336,943,[LR21]Lords of Rohan
188817273,Munmon,12901737,1116310,211912,39551,42589,125343,52185,0,259668,52185,0,2476678488,0,125,-
188845348,ᴸʳLUNICTUS,12877100,104914,26926,6884,16888,8978,3385,0,36135,3385,0,1558632979,0,455,[LR21]Lords of Rohan
188292201,쵸Bear,12762411,3636617,863462,127956,652623,13205,183272,21012,998068,204284,0,1398516677,0,8400,-
192581999,LilitЛиса,12559046,4099267,2586,4079,12074,27936,396256,0,440345,396256,0,2120441881,534525710,3619,[LG21]Lords of Gondor
188816893,WARRIOR FARM 10,12389618,242793,17769,22009,47558,10254,10226,0,90047,10226,0,1316715234,0,1894,[21If]Immortal Falcons
188986347,Pimpammm,12386241,390745,21517,13926,70135,29655,12907,0,126623,12907,0,1444868924,9172286,4484,[OP1]OP CLAN
189266244,ᴵᴾRágnär,12376390,2424921,681640,338989,350984,104124,70352,26757,891206,97109,0,245500638,11642489,7444,-
142371438,NokedliF11,12328082,3005981,754566,516818,830716,67154,61715,17771,1494174,79486,0,1498984833,2400001,10466,[21M]Immortal Myrmidons
190430624,IMPERADOR FARM,12262416,449281,436505,3716,0,322,44725,0,48763,44725,0,4962605957,2527734725,1605,[LR21]Lords of Rohan
187384799,C H A D 3 3 3,12154750,5025006,638494,336794,550030,58137,356220,3142,1304323,359362,0,963590883,0,4549,[LG21]Lords of Gondor
188829162,Mkジinsane,12152527,911799,856240,15867,56941,24326,65024,2360,164518,67384,0,1543783586,1400000,3486,[LR21]Lords of Rohan
188880051,qftydhunvfezbjj,12100235,18338939,1337013,1249255,1030656,1111224,1086802,35743,4513680,1122545,0,1422326310,88951930,7822,-
188900034,Rajpoots,12042565,854381,223016,55556,81433,13291,62724,0,213004,62724,0,1893809035,0,3118,[LG21]Lords of Gondor
185259121,Lets go Os,12039664,913938,1168728,282,16846,7330,13445,35821,73724,49266,0,1378846196,4800000,1585,[LG21]Lords of Gondor
174523518,ㅡᅟᅟF2P 5      ㅡ,12018288,4068578,375472,858694,1490716,123637,42086,0,2515133,42086,0,2268612745,968382628,2427,[LG21]Lords of Gondor
188838338,boble 79,12008818,306757,46338,1697,52760,41937,3315,0,99709,3315,0,1289289870,0,2122,[21MA]Myrmidons Academy
188479340,ㅡᅟᅟF2P 8      ㅡ,11986452,9974813,173571,883535,766581,262971,721306,0,2634393,721306,0,2749359321,1052471741,8852,[LG21]Lords of Gondor
188217778,ᴵᴰKing Nemo,11974922,1852509,716667,684238,272077,322,117022,0,1073659,117022,0,1857331281,0,12936,-
187155907,Yuzhi,11896463,5032590,1641848,115533,189407,294655,290433,27386,917414,317819,0,2070975176,257605,2033,[LR21]Lords of Rohan
188952266,ErDegui,11875134,7108681,230822,125436,58773,125367,620570,12944,943090,633514,0,1173596936,13045768,5398,[LG21]Lords of Gondor
188819203,Cominogr,11768627,347521,71452,268238,123679,11074,222,0,403213,222,0,1704332937,0,850,[ANTB]ANnti Banned Club
188946350,BaabyyKiller,11764448,45777543,823248,1480408,3397133,2896319,2635750,37221,10446831,2672971,0,1760569996,20189360,9196,-
188818957,alonsoisma,11645765,2300239,762386,25316,47973,75270,189815,0,338374,189815,0,1582891810,4826393,1433,[LR21]Lords of Rohan
188856725,Uranusuki,11709789,268914,32838,25630,66282,25841,2786,0,120539,2786,0,872906912,3859996,756,[LR21]Lords of Rohan
188887462,Dunks,11595270,1538565,760926,36818,198678,122594,64347,0,422437,64347,0,1107672787,0,1041,[LR21]Lords of Rohan
188900167,Charles grand 3,11578178,4207791,779277,591939,722430,168606,197012,0,1679987,197012,0,1807463824,8400000,918,[Tick]Tick tack
188818543,GodAnubis,11588874,3265470,842158,347813,333503,280538,140675,0,1102529,140675,0,1258710524,473118,756,[21IR] Corral
188363322,쵸Belmont,11471499,726781,18931,225245,250029,43961,583,0,519818,583,0,1185584888,1410552,11058,-
184327666,ツاحمدᴰᴮ,11442307,3030757,532767,681079,488185,101508,109018,21098,1400888,130116,0,1461565573,72130,2407,[LV21]Lords of Valinor
185877603,ㄴ Aurelio ㄱ,11433632,3426162,734268,194294,519109,17374,220713,3623,955113,224336,0,918025985,1758080,3485,[LG21]Lords of Gondor
188892262,Udi lopez,11411565,286475,30519,120358,27289,7419,17815,0,172881,17815,0,259364387,3001045,1851,[LR21]Lords of Rohan
188840730,FurkiTolki,11305408,1839593,1140153,3217,12856,72657,143339,4461,236530,147800,0,1704752274,3600000,2050,[21M]Immortal Myrmidons
188885079,ᴵᶜnoobhuhu,11287294,4932153,869902,263679,640053,58918,316980,9692,1289322,326672,0,1694858992,26599999,5002,-
188320795,Fïshböy F1,11261315,1130852,410313,146172,398,5918,103727,1994,258209,105721,0,1555765485,820170438,1122,[LR21]Lords of Rohan
188840453,La pampara,11196019,4065536,1018214,200050,433845,478194,124506,0,1236595,124506,0,1512594666,0,324,[21if]farm 21If
188307234,ᴵᵀJessyS2,11159564,3418968,138406,130180,168640,9783,301652,0,610255,301652,0,1509177777,180913621,6306,-
189182502,ᴵᶜVatson67F,11105735,137197,213594,1669,4693,617,12501,0,19480,12501,0,3546038569,1724148322,1615,[LR21]Lords of Rohan
189443468,Hubey,10948714,2171604,462536,189562,257421,35910,147521,0,630414,147521,0,918945909,0,1967,-
189182788,Vatson67f3,10874937,260412,485136,2684,4031,13106,19939,0,39760,19939,0,3538425026,1133268751,1372,[LR21]Lords of Rohan
189007908,vua đại du,10847143,2010095,594035,32817,68882,36737,135324,18279,292039,153603,0,1664459657,27506603,6095,-
188309795,ᴵᶜ TAZIEX,10844048,8618161,951227,435439,559362,399095,559725,10936,1964557,570661,0,1632163083,0,8839,-
189227933,Z  Hot Rain  Z,10762707,6460378,866429,52143,3457,47844,612586,6290,722320,618876,0,1457174944,13707113,1796,-
188817859,oktaev,10746001,401425,359467,33669,31021,2770,32157,0,99617,32157,0,1102334555,0,100,[DD21])Dragon of Death
188839518,Zaragoza,10719496,1181120,88062,120100,376712,100919,0,0,597731,0,0,1428650758,0,1169,[LR21]Lords of Rohan
117517315,ᴵᶜBOTAN,10684766,13712356,945529,506093,1444925,965222,611992,37024,3565256,649016,0,1235813199,498018246,20006,-
188847841,Lj1208,10602108,314850,314434,984,0,1961,30681,0,33626,30681,0,1177309928,0,905,[21If]Immortal Falcons
195403312,môngcổ,10455988,1446809,783623,85946,65345,87040,95077,0,333408,95077,0,1281630202,0,1061,[LG21]Lords of Gondor
188889920,Carolk,10405243,642390,541227,49383,96269,35954,29616,0,211222,29616,0,1160793734,1349311,322,[fagr]alpha table
189442766,Gubernur189442766,10398674,77204,41779,1313,9937,12737,612,0,24599,612,0,2579873384,1989430704,716,[21IR] Corral
188522411,Ваn,10346788,1095208,3365,36724,120447,26500,74097,0,257768,74097,0,727419882,1,2219,[21If]Immortal Falcons
188881481,678907,10247555,4054167,576543,566707,812285,378314,80300,0,1837606,80300,0,1278677490,53227,1522,[LLA]Lost legion academia
189285062,Linh farm 2,10236848,9739359,1413236,1086939,10938,8479,938116,4251,2048723,942367,0,5513626597,3128768761,1829,[LR21]Lords of Rohan
188295840,ッ Yakuza ッ 6,10205094,395204,0,3871,70818,40591,9043,0,124323,9043,0,992758872,82882904,4853,[21if]farm 21If
188899095,Minuz,10200319,1614469,364375,167345,306671,102167,55899,0,632082,55899,0,729556492,0,1705,[LR21]Lords of Rohan
188300029,Hoàng Saa,10190315,5137975,463048,87026,120041,279872,368510,3795,859244,372305,0,1311039543,9873378,8173,[LR21]Lords of Rohan
188906315,ᴵᶜИвaн,10170251,1248369,45240,148765,274837,58418,43527,0,525547,43527,0,943901017,16348226,12804,-
188721766,ᴵᶜZver225,10146168,5600948,578427,272790,772945,368830,252518,0,1667083,252518,0,1282562432,205403656,7602,[LG21]Lords of Gondor
188840603,andyrendy,10073872,1722850,894100,10373,99042,247058,53446,0,409919,53446,0,1032365452,0,459,[Slon]Slonii
194265891,쵸MØTÃSÊMツ쵸 2,10071453,2326155,0,5126,24684,21098,219137,0,270045,219137,0,1488340874,125453620,1403,[LG21]Lords of Gondor
188857096,Di 1,10019335,909985,10470,103819,160058,85834,22577,0,372288,22577,0,934774982,1843151,2952,-
189869613,Алёнааа,9878154,3146615,691598,31047,82951,360086,153416,0,627500,153416,0,1475255043,503089664,1095,[GW21]GOATED WARRIORS
188846435,psilva3,9888463,1390439,255473,331056,379662,122656,7428,0,840802,7428,0,960602690,0,589,[21IR] Corral
188898591,Dthomas,9838220,468487,81006,125157,122286,22516,10882,0,280841,10882,0,434478065,0,1343,[LR21]Lords of Rohan
188471943,NoCoboY,9816138,413116,95171,64153,54918,15880,22693,0,157644,22693,0,1081418218,0,3619,[LG21]Lords of Gondor
191785327,ᴿᵃQueen,9625702,3017237,247312,228656,300820,10824,232657,0,772957,232657,0,2123392947,813781963,1187,[LR21]Lords of Rohan
186988267,Panda ᴸᴺ,9616784,2766515,1120377,7927,2980,11995,264463,3318,290683,267781,0,3082740466,512115698,1981,-
186065635,MASONFTW WOOD,9581993,1910931,810165,6189,9403,5772,186780,0,208144,186780,0,1692955326,950725213,1288,[LR21]Lords of Rohan
188962647,卂几Ҝ卂2,9578262,2082291,325396,3405,6149,30163,194866,0,234583,194866,0,1618176948,1219440595,2004,[LR21]Lords of Rohan
188790900,Dom Daddy,9553678,3388766,1222043,27914,83403,91562,276497,4258,483634,280755,0,1773010253,0,1447,[OP1]OP CLAN
188815675,KōbøLord,9517898,145859,16647,15805,9235,19277,4712,0,49029,4712,0,843374303,0,1696,[LR21]Lords of Rohan
189238085,Christian33,9470954,471496,125768,75854,103315,62424,0,0,241593,0,0,716179466,0,1590,[21LK]legionary knight
188462426,Tysson,9463093,1483696,191746,163161,372581,171003,2189,0,708934,2189,0,647738981,310,4386,[21MA]Myrmidons Academy
188844276,tori,9424138,213019,54967,3007,1985,1182,20372,0,26546,20372,0,486406302,0,915,[21If]Immortal Falcons
188308863,Rock Farm ll,9385339,10088421,459789,450027,1066779,575927,546551,4782,2644066,551333,0,737133728,45352280,6170,-
188560833,Gorgona,9371349,1635913,58059,135968,120817,4039,135093,0,395917,135093,0,379010693,1749999,1348,[LR21]Lords of Rohan
105186699,Musti 13,9364627,647045,252843,43047,75095,24684,38951,0,181777,38951,0,1101186393,2316986,969,[21M]Immortal Myrmidons
