ID,Name,Power,Killpoints,Deads,T1 Kills,T2 Kills,T3 Kills,T4 Kills,T5 Kills,Total Kills,T45 Kills,Ranged,Rss Gathered,Rss Assistance,Helps,Alliance
179940560,ᴸᵛ k,100458981,621529916,4332796,2270111,868211,971623,35378028,13083635,52571608,48461663,0,6048713433,1873979817,80945,[LV21]Lords of Valinor
186145908,ʳᵉʸEscanor,88588551,1508164574,3712561,4272170,915441,1734412,124701999,12576081,144200103,137278080,0,3523998076,4398233340,22329,[LV21]Lords of Valinor
188540500,TakeMe2Valhalla,85744660,1450691759,5160258,12511616,5652155,10639829,106979181,16226700,152009481,123205881,0,2834278325,7061247251,44626,[LV21]Lords of Valinor
180304933,LilLƴ,81472794,305959091,3361470,2381705,2764385,3236435,16705080,5997872,31085477,22702952,0,1161239177,4870554697,22029,[LV21]Lords of Valinor
188858506,Cúchulainn 쵸,74853069,238598557,1945923,640335,273416,425482,20998411,1311881,23649525,22310292,0,4980297042,512651627,37137,[LV21]Lords of Valinor
179655012,ᴸᵛDØØPER,73648239,533009058,2482872,2452504,973544,1254625,33737199,9409049,47826921,43146248,0,8404952651,1451282008,37876,[LV21]Lords of Valinor
178695066,SokoDrake,69292216,110764976,2739209,966390,105667,147411,7890524,1543274,10653266,9433798,0,7795608412,115903540,17429,[LV21]Lords of Valinor
180560115,TripEhh,63016538,382282505,1420469,2306786,813884,294450,23200346,7350606,33966072,30550952,0,6644516627,1225250480,11305,[LV21]Lords of Valinor
184964288,ᴾᴿFïshböy,62419899,266041371,2100314,2057085,4656295,3958131,20447778,1800353,32919642,22248131,0,3451472959,632742525,38370,[LV21]Lords of Valinor
179977300,ᴸᵛTmulla,59723666,739376163,1793011,3840565,417684,1492228,40347097,16416640,62514214,56763737,0,6968070360,5600679937,17636,[LV21]Lords of Valinor
186009654,Dooby ᴼᴺᴱ,59269892,274159750,699771,2071412,347817,487446,24933651,1088177,28928503,26021828,0,7461133932,137216122,35143,[LV21]Lords of Valinor
188839265,A 10 Warthog,57342037,12330470,230642,42253,74269,128873,999555,83122,1328072,1082677,0,3672809517,724780894,10851,[LV21]Lords of Valinor
188341936,ᴸᵛ Vatson67,55923942,252819598,1694949,1326311,557828,595665,21732056,1586773,25798633,23318829,0,6450232076,384720155,41892,[LV21]Lords of Valinor
188918989,ᴼᴸ Kaymo,54456687,125177460,1092879,2484352,1386449,2529103,10279320,449904,17129128,10729224,0,3777060658,1075163587,41544,[LV21]Lords of Valinor
178814644,ᵁʷᵘØtòt,53740295,444858744,3140400,18550973,3385819,2356133,31505688,5494775,61293388,37000463,0,2295222519,2329433716,15829,[LV21]Lords of Valinor
186985518,HornyAPOLLOS,51269492,222862345,1404927,2886798,1515750,3176209,18723195,965835,27267787,19689030,0,2760514801,594947984,18043,[LV21]Lords of Valinor
182514982,ᴸoᵛeSalmon,51052988,376082423,2976384,17730788,655039,737772,24941470,5943020,50008089,30884490,0,5474784573,1000488180,52376,[LV21]Lords of Valinor
185836736,ᴸᵛMasonFTW,50172635,469451313,2378870,5724465,2214818,4769431,38471820,3004043,54184577,41475863,0,3356207047,2802859223,28657,[LV21]Lords of Valinor
180060983,ᴸᵛRumRamsey,47988495,360166945,2220332,95115478,5048028,991336,26519039,3094603,130768484,29613642,0,6032250116,417518493,93070,[LV21]Lords of Valinor
142628224,Dae jang goon,47111223,162550305,2387504,1946869,718048,367829,12883812,1520770,17437328,14404582,0,4879943636,102794418,16807,[LV21]Lords of Valinor
181825355,ᴸoᵛePUMA,46956480,210885489,1303955,1382047,359419,531778,14983055,2896629,20152928,17879684,0,3290245647,3599759382,35084,[LV21]Lords of Valinor
184871937,ScazBigLion,46905444,1216565991,4527691,56591135,23364142,26120855,94321262,5541172,205938566,99862434,0,5923543674,13704268108,20829,[LV21]Lords of Valinor
181308342,ᴸᵛRockSolid,46602121,185319533,2675952,2673547,709463,1391557,12347545,2716211,19838323,15063756,0,3441554687,5862949920,40276,[LV21]Lords of Valinor
185808036,Ze Bosh,45657049,324557669,903869,8598579,2626646,3862918,28938009,637645,44663797,29575654,0,5524831742,631820319,29935,[LV21]Lords of Valinor
176994964,Cpl Rage,45650487,113995148,476746,2377013,1506916,2122761,8912157,644665,15563512,9556822,0,1897067015,63265830,17081,[LV21]Lords of Valinor
188920797,FreyaFullBosom,45020918,85435663,1751730,1735115,953550,1150730,6826144,515859,11181398,7342003,0,3535299372,1323334617,23999,[LV21]Lords of Valinor
179750493,GuiltyMahiru,44668446,154270223,976622,2885917,770432,1180564,13125334,808829,18771076,13934163,0,1474958072,1965360302,39881,[LV21]Lords of Valinor
184826667,ᴸᵛAHERUS勇,43111418,513672701,1416939,12789309,5927578,11125761,44119962,677851,74640461,44797813,0,5832346801,1396853955,24886,[LV21]Lords of Valinor
182423962,シValkyrieCillaﾒ,42376793,115810413,1858806,5641345,822285,707431,8897411,1061687,17130159,9959098,0,5088010692,1265202822,15046,[LV21]Lords of Valinor
179813923,ㄴ Bless ㄱ,42219154,236773429,2185386,7761519,5947505,5144214,18830978,721974,38406190,19552952,0,2444871681,978016636,23380,[LV21]Lords of Valinor
188241812,Gilgamesh2323,42210157,86712357,775600,2466419,200187,260810,7815198,331174,11073788,8146372,0,5043432831,62620586,24512,[LV21]Lords of Valinor
181739549,kylinn,41829522,97526701,3321903,2389177,278410,278364,6880327,1328766,11155044,8209093,0,5128390117,10337862643,31310,[SFIS]Sky Fighters
185690465,Dictator  Goat,41583543,350310517,2053726,6070059,2159337,1277583,31857908,1054421,42419308,32912329,0,6043344067,1005155698,34881,[LV21]Lords of Valinor
188976136,ᴸᵛ MUSE,40896332,94903470,1184156,2079562,2348513,921788,7293420,658459,13301742,7951879,0,5136148271,365719425,47574,[LV21]Lords of Valinor
188969478,ᴰᴹMePaul,40387884,87978111,983206,1953068,3290337,2573561,6140862,465198,14423026,6606060,0,3644817692,278578838,3505,[LV21]Lords of Valinor
187247613,Sith Padmé,39926962,198724801,3145883,4400829,2992217,3977513,15716939,939038,28026536,16655977,0,7575796848,4488542203,85986,[LV21]Lords of Valinor
188785515,Johnvin,39793457,165080239,1692593,737645,467737,1071559,14229110,870995,17377046,15100105,0,4929669743,93446315,56577,[LV21]Lords of Valinor
188483360,ᴼᴸTryxan,39556047,200408316,1209835,21229570,2837205,2706913,15624592,1170721,43569001,16795313,0,6009668253,2169436768,40257,[LV21]Lords of Valinor
187423027,ᴸᴳPandaFr3d,39377441,183512048,2048263,1957321,791324,914974,14172642,1807581,19643842,15980223,0,2821382574,6820681844,26170,[LV21]Lords of Valinor
188485523,ᴸᵛIMPERADOR,38960386,183319220,1007660,550634,31074,81329,14992345,1644909,17300291,16637254,0,6174047515,201752989,36340,[LV21]Lords of Valinor
188882878,Rtthyr,38748882,91535900,842990,232093,106385,116963,7877092,601897,8934430,8478989,0,7323365211,93046400,19137,[LV21]Lords of Valinor
185282531,Jëster,38239377,45496988,2695521,469962,132883,175975,4001273,221030,5001123,4222303,0,3451908286,592793562,26217,[LV21]Lords of Valinor
185457048,Cman9918,38168505,133602129,1160939,3704156,1184975,873737,11641776,528932,17933576,12170708,0,1996001700,126071365,16767,[LV21]Lords of Valinor
186199010,Daphneᴵᴿ,37612497,196680975,1700526,1778105,1269505,3330126,15018258,1514163,22910157,16532421,0,4151943868,1498857670,54879,[LV21]Lords of Valinor
178213242,ᶦˢLOCOOZ,37601382,135001752,3850546,2103734,957035,1554554,8021136,2311868,14948327,10333004,0,4363502685,1274602396,21810,[LV21]Lords of Valinor
180368631,ᴸᵛWinfields,37421183,163785006,4670313,23224272,189123,611409,12012919,1809354,37847077,13822273,0,5176831543,1877834074,13579,[LV21]Lords of Valinor
188651683,Sol Aliyaa,37405740,12362838,140221,119003,49805,35722,1144392,32631,1381553,1177023,0,3923203029,201676244,15462,[LV21]Lords of Valinor
188880730,ᴸᵛMarlone,37333047,140315361,1911316,485948,371025,197873,11777629,1045417,13877892,12823046,0,5885842172,136720000,44638,[LV21]Lords of Valinor
187726069,ᵀᴿvSpryth,37045476,65857461,731133,1327439,163988,333442,5630975,381024,7836868,6011999,0,5417921033,15763287,22997,[LV21]Lords of Valinor
188569749,ᴵᴾEndoloris,37018743,135932617,1872172,1390988,2616276,1563397,10769220,823804,17163685,11593024,0,1822151378,163440000,5369,-
179816952,Hell CAT GTR,37008627,53502584,2888707,58438790,1765741,1889101,2393482,339606,64826720,2733088,0,5440662983,1636698071,10706,[LV21]Lords of Valinor
188648613,Känguruᴵᴰ,36433078,25517194,340067,377701,272323,171077,2089716,165777,3076594,2255493,0,2949769575,286935074,13499,[LV21]Lords of Valinor
189072394,ᴵᴾLaura,36309599,43788335,1312098,7341019,351297,767107,3351673,251619,12062715,3603292,0,6260204028,362529904,27171,[LV21]Lords of Valinor
182338045,亗ƧHiꟻT亗,35787343,134754048,1095353,2640524,1006449,1310254,8852061,1922571,15731859,10774632,0,5506426398,2515586970,32275,[LV21]Lords of Valinor
185048534,Han Sansan,35772780,126431196,811523,790111,342096,539228,11333049,505079,13509563,11838128,0,6021601885,357367305,31431,[LV21]Lords of Valinor
188805469,BossAlienᴾᴴ,35628777,69854831,1222890,250538,604492,927660,5948864,269823,8001377,6218687,0,4960626041,134750966,39263,[LV21]Lords of Valinor
186444772,Dr4gonツ,35614384,259504510,3040215,5670862,3502249,3856115,22497300,548419,36074945,23045719,0,5324256195,4177255259,38472,[LV21]Lords of Valinor
189065897,W3llsFargo,35607597,36866964,662685,1191313,898257,213767,3194692,101510,5599539,3296202,0,3864063372,2754424297,18911,[LV21]Lords of Valinor
188789133,MiniMe,35580762,36518247,340034,258586,224998,167551,3334145,100244,4085524,3434389,0,4904480583,34179151,11630,[LV21]Lords of Valinor
188276623,ᴸᵛArork,35540458,83629672,930236,7261071,1265703,1364258,7010460,204221,17105713,7214681,0,3746188997,360935366,16411,[LV21]Lords of Valinor
189060019,Tušiš,35260239,79800875,775218,722106,635078,1036387,6900931,261572,9556074,7162503,0,2930345541,552362594,20132,[LV21]Lords of Valinor
185341770,ᶜᵘRalfish,35146566,53566795,2488511,825738,380145,497142,3989001,538139,6230165,4527140,0,2670290902,25760000,15723,[LV21]Lords of Valinor
188303104,HokieHighlander,34914622,65847837,1304314,343718,109840,53066,5487819,523448,6517891,6011267,0,1052361096,84975248,13281,[LV21]Lords of Valinor
185089489,ᴼᴾZOROGRANJ,34332185,89977952,1885507,550571,355159,737615,7809122,405792,9858259,8214914,0,5703855206,2083599610,21232,[LG21]Lords of Gondor
188969981,ᵸᵒWand0,34328656,65261424,1286067,2054730,706949,524275,5320812,406568,9013334,5727380,0,4292634395,306699275,22598,[LV21]Lords of Valinor
188333348,ᴷᴺLinh,34322540,68182309,935539,1886379,1645656,5139453,3781263,307164,12759915,4088427,0,4853027320,550111352,11002,[LV21]Lords of Valinor
185986678,卂尺丂,33971238,85165499,1209220,680685,1395198,1286689,7045359,331931,10739862,7377290,0,3322049383,1193919485,14804,[LV21]Lords of Valinor
189017405,ᵸᵒWizzy,33793718,36148724,1128087,812593,975948,1093260,2734807,115660,5732268,2850467,0,2733458445,170159151,14276,[LV21]Lords of Valinor
188336265,ᴸᵛiGREC,33732615,34239030,354919,533661,195122,279696,3003565,129381,4141425,3132946,0,2450337076,175934276,17218,[LV21]Lords of Valinor
188794709,ᶦᵗˢᵘRYU,33681789,105999414,993557,1318150,2549412,2529700,8464960,293428,15155650,8758388,0,3614465237,94094214,35541,[LV21]Lords of Valinor
188826595,Saf1974,33653725,102963466,1386956,1175181,555245,574540,8287934,822022,11414922,9109956,0,5107500548,230946040,48979,[LV21]Lords of Valinor
188970345,PitBlue,33482213,100278191,862627,1120668,1623539,1658595,8118802,449229,12970833,8568031,0,3997584500,1077393393,22843,[LV21]Lords of Valinor
181534760,ᴸᵛSongoku,33457759,78588918,1418818,947363,718037,1206878,6729084,242251,9843613,6971335,0,3859521004,755945265,15836,[LV21]Lords of Valinor
182317160,G  O  P  A  Rr,33213928,165778188,1939750,3134912,2312668,2727770,14028711,466384,22670445,14495095,0,4109749282,738465485,28145,[LV21]Lords of Valinor
189154415,ᵸᵒMDKMB,33181470,63642604,785334,2572471,865337,727479,4913768,467492,9546547,5381260,0,2124563264,2596649243,19907,[LV21]Lords of Valinor
188651684,Milo San,32805610,7514313,256838,5998,5637,18715,662498,40100,732948,702598,0,2954802276,359753808,11872,[LV21]Lords of Valinor
187029935,HolySpirit,32798466,129895339,1420613,1243047,1343710,1577860,11251933,406427,15822977,11658360,0,2699626296,1104079437,18449,[LV21]Lords of Valinor
190252265,Jamong,32748825,47889411,986556,240286,331111,224508,4124126,251992,5172023,4376118,0,5209721948,81003240,23448,[LV21]Lords of Valinor
182713036,쵸ﾒMØTÃSÊMツ쵸,32676989,23047028,662283,107410,239091,451161,2002476,35898,2836036,2038374,0,5047415601,123301386,20279,[LV21]Lords of Valinor
188837916,Silent Kakashi,32570077,105876915,889638,839969,754922,750377,9809221,155268,12309757,9964489,0,1763136511,103761097,13992,[LV21]Lords of Valinor
188362493,亗MrDuck ツ,32330686,53343903,1162431,14212609,2043574,1147191,3945647,118450,21467471,4064097,0,2815936144,909611190,16710,[LV21]Lords of Valinor
185037763,ᵛBEARDY,32277187,51437912,2227119,28222212,2319488,801981,2906415,444121,34694217,3350536,0,4921911553,554484409,19513,[LV21]Lords of Valinor
188368264,funne,32230459,27814931,1265037,834275,642636,595616,2088506,154764,4315797,2243270,0,3746586411,61698120,16514,[LV21]Lords of Valinor
188501467,direraven,32137257,96864842,744306,5169512,2366933,2785371,6996177,499691,17817684,7495868,0,4832058983,4551820,26892,[LV21]Lords of Valinor
187559873,ｱ尺ﾉ丂ᄃﾉﾚﾚﾑ,31983704,62577567,524842,786256,540194,444292,5234590,360843,7366175,5595433,0,2629725287,626443180,15365,[LV21]Lords of Valinor
188544046,G4mine,31914909,26635738,854807,262602,631545,296942,2070874,171181,3433144,2242055,0,4317317823,247760315,20191,[LV21]Lords of Valinor
188352541,ᴾᴿ Mèoッ,31837806,127518876,1258710,7188100,1700314,1303642,10538936,603835,21334827,11142771,0,6150683882,0,14364,[LV21]Lords of Valinor
188833519,JulieLaTueuse쵸,31774547,25785504,607364,141152,346846,94148,2230027,119336,2931509,2349363,0,3551349811,37720000,19780,[LV21]Lords of Valinor
188736727,Alex9003,31591814,36109730,1660154,2964172,704741,765686,2475475,314496,7224570,2789971,0,4179111048,38138060,14258,[LV21]Lords of Valinor
188335709,Rebel Rogue,31766772,72509497,813602,1040029,700124,771386,6222402,279584,9013525,6501986,0,3440753536,34205137,33645,[LR21]Lords of Rohan
186841127,Anossss,31231915,92740074,1396074,5659752,161764,119554,8036040,522299,14499409,8558339,0,4210456065,4253401,14490,[LV21]Lords of Valinor
186765655,KönigsKlãsse,31187324,184979757,925593,2059399,1361404,1848800,15263943,1090522,21624068,16354465,0,3547614721,407789115,7996,[LV21]Lords of Valinor
185724517,Feldgraŭ,31157256,146940777,1759421,439339,3849630,1436815,11099577,1120531,17945892,12220108,0,4251264117,178066760,33298,[LV21]Lords of Valinor
188225231,ᴾᴿSko0p,31122388,32524184,356756,168570,89071,72567,3026488,87859,3444555,3114347,0,4545798280,0,27091,[LV21]Lords of Valinor
189045190,Azura21,31097936,28813819,1079446,528436,682624,3020226,1479906,23146,5734338,1503052,0,2787495027,423984134,8058,[LV21]Lords of Valinor
188797972,21LuviVilu21,30943876,18450134,1165545,579952,518648,328487,1368852,114719,2910658,1483571,0,4316533660,34539709,15775,[LV21]Lords of Valinor
188451175,ᵸᵒTerra,30896305,57254744,870910,3422823,860914,534113,4674494,298348,9790692,4972842,0,4024917588,92432122,22322,[LV21]Lords of Valinor
185612447,Chaudary Zain,30869227,137098427,1425755,9266607,1590757,914083,11740490,550118,24062055,12290608,0,4461057919,1323892732,25053,[LV21]Lords of Valinor
188242643,hoahaizz,30866557,109255418,913017,3622201,968129,568030,8912504,759878,14830742,9672382,0,3721566901,567041937,29498,[LV21]Lords of Valinor
190407807,동탄불주먹,30844427,24031654,1056652,567614,330666,695585,1789260,129093,3512218,1918353,0,5303478583,433522789,15234,[LV21]Lords of Valinor
188598120,ᶻSharineko〤,30333480,75070934,830245,858293,1456432,803718,5638112,619521,9376076,6257633,0,2367616193,51185747,16413,[LV21]Lords of Valinor
188847278,ᴸᵛQuang,30217347,140550013,1217495,1213518,1436737,1289374,12315180,456227,16711036,12771407,0,4076823550,1610824614,33462,[LV21]Lords of Valinor
188836483,YenifferDeRivia,29941107,38806650,1193983,1783484,2318341,1691838,2651180,26706,8471549,2677886,0,3401426975,140738085,4877,[LR21]Lords of Rohan
188961098,Chocolalat,29882861,2573117,220977,51569,65233,15462,226397,5326,363987,231723,0,4147700200,21199999,3578,[LG21]Lords of Gondor
184882401,Ферма а,29770945,92139201,1738941,22831138,3000621,3316968,6260490,284948,35694165,6545438,0,2669728364,3538154179,17459,[LV21]Lords of Valinor
181581608,Fledermauz DB,29439605,32237433,694585,248895,300074,511759,2915789,19129,3995646,2934918,0,3577184021,377676127,7712,[LV21]Lords of Valinor
177013392,ᴸᵛ UCC15,29413011,39005363,2664930,1200338,936753,880990,2885533,225625,6129239,3111158,0,5316478367,192271545,16121,[LV21]Lords of Valinor
185923730,JFDLCA,29380354,269931842,434687,5131053,3803977,6044357,22922445,394790,38296622,23317235,0,4712053420,386336005,36476,[LV21]Lords of Valinor
188293704,ᴸᵛDrMusaab,29342529,41876446,1576480,191211,427716,173783,3584690,222037,4599437,3806727,0,3747175082,84578452,14436,[LV21]Lords of Valinor
188262339,Kitty27,29223172,7094473,100178,54908,178359,33366,448507,105412,820552,553919,0,3770655406,23588840,10568,[LV21]Lords of Valinor
188789684,ᴿᵃtMadson,29052463,22711880,542169,1177460,162620,152532,1936728,108687,3538027,2045415,0,3894148181,72421016,40241,[LV21]Lords of Valinor
188316323,ᴸᵛ SAKURA,29037816,99894209,1378468,2351048,1068606,1856632,8546136,219945,14042367,8766081,0,4114889197,539454569,26442,[LV21]Lords of Valinor
185651937,ᴳᵃʸGrizzy,28827761,394704092,1530202,11881112,5833583,11664631,32492852,453683,62325861,32946535,0,3744084354,952357579,20305,[LV21]Lords of Valinor
188944242,Đạt Feet,28740491,19696538,704717,769072,733958,1500022,1061754,72859,4137665,1134613,0,4547627707,16457231,9042,[LV21]Lords of Valinor
188543996,ᴸᴳﾒNØHOPEツ,28594439,21964812,733576,321061,76882,175524,1880294,112090,2565851,1992384,0,3385326125,31608954,11594,[LV21]Lords of Valinor
188830020,ᴸᴳVersized,28511091,53599723,842032,600749,938250,417681,4387649,302793,6647122,4690442,0,3703752182,46055668,10355,[LV21]Lords of Valinor
186295211,ᶠˡVENDETTA,28451770,115576250,2742984,4081984,1084740,528626,9229579,909004,15833933,10138583,0,3885646386,1050356942,20057,[LV21]Lords of Valinor
188876886,ᴸᵛTheanh,28451320,125451578,1326532,603514,306133,579340,11469023,385551,13343561,11854574,0,5540317816,107966937,34157,[LV21]Lords of Valinor
188819438,ᴸᴳLuca,28410513,46044144,573803,296542,432636,250296,4088058,161890,5229422,4249948,0,4219666986,286280200,24189,[LG21]Lords of Gondor
185282573,ᴸᵛ3621 BANK,28344977,62632106,771884,668111,1267167,649115,4855577,440596,7880566,5296173,0,1360685180,923285969,8657,[LV21]Lords of Valinor
188364390,ᴸᵛLeonPoi,28310256,145003836,1317830,495443,399103,640818,12590033,782147,14907544,13372180,0,3744641747,108004980,36234,[LV21]Lords of Valinor
188853241,Алёнаа,28248957,26330549,749181,246727,344883,856812,1734149,241135,3423706,1975284,0,4479339253,45525540,12897,[LV21]Lords of Valinor
189001955,ᴸᵛTruNguyen,28221495,22782486,718506,844954,157659,366262,1932239,75537,3376651,2007776,0,4407241187,231678867,16275,[LV21]Lords of Valinor
182720562,ᶜᴹᵈSkyy,28092367,19752884,2388318,291902,77615,310791,1289299,270156,2239763,1559455,0,3999667646,685652689,12498,-
186709522,ᴸᵛ SHERY,28006430,62181428,1562880,609853,401512,544566,5212383,347717,7116031,5560100,0,3407463504,99489407,9533,[LV21]Lords of Valinor
188785575,ᴵᶜ Cairo xx,27765720,22263445,718609,343839,319881,399109,1877180,59334,2999343,1936514,0,3313749039,8507066,17115,[LG21]Lords of Gondor
188788713,Sam smith,27763575,31724009,760222,583097,331614,179458,2761619,130507,3986295,2892126,0,3883909710,33958258,12527,[LV21]Lords of Valinor
185538462,UMAYKIZ,27739375,78549596,1210994,2427602,751593,861735,6743921,283737,11068588,7027658,0,4058555649,8566632,6391,[LV21]Lords of Valinor
186043643,卂几Ҝ卂,27587454,56675591,1181956,888325,301712,375673,4839965,299608,6705283,5139573,0,3283345084,501165307,29646,[LV21]Lords of Valinor
188880546,Graf000007,27169255,3908846,1602923,195112,206722,115320,259030,20240,796424,279270,0,3433421987,0,3975,[LG21]Lords of Gondor
188547640,Kitty8152,27070207,1630693,12032,78078,153637,150776,70470,0,452961,70470,0,6204240790,2547000,7564,[LG21]Lords of Gondor
188806334,Emrah 51,26971037,3751158,1312229,1012,10602,4008,371372,0,386994,371372,0,4126810750,0,4417,[LR21]Lords of Rohan
188294260,CЦEПИOH,26956093,10421111,1855157,581297,556310,288078,772954,15519,2214158,788473,0,2716905400,173206292,7519,[LG21]Lords of Gondor
188453555,Puyols,26729502,53754329,1090161,414135,352520,193153,4625835,296775,5882418,4922610,0,6677260032,127173124,23925,[LV21]Lords of Valinor
188852900,Scorpionking乂,26647566,80321983,2549261,698186,536746,1654576,6857715,195670,9942893,7053385,0,2204058460,58256706,31880,[LV21]Lords of Valinor
188285810,ᴵᴰJupanu,26604033,46572577,1043044,864619,1573717,521185,3674114,221317,6854952,3895431,0,4746213304,57408174,19983,[LV21]Lords of Valinor
189040679,ㄴHORIZONㄱ,26472811,74776471,764075,947828,1035889,885967,6855262,20932,9745878,6876194,0,4541244942,188105599,14262,[LG21]Lords of Gondor
188364525,ᴵᴾEmrys II,26412458,3119874,218964,53070,30135,8285,294045,3770,389305,297815,0,2091717356,0,2715,-
188872694,DELİ ÜSTAD,26411521,5962066,716649,208561,290491,524323,257508,33350,1314233,290858,0,4223337210,39905983,2105,[LG21]Lords of Gondor
188319889,亗ChancellorT,26292095,19038322,395290,392020,290920,381817,1561679,61701,2688137,1623380,0,2876805661,1085215,13309,[LG21]Lords of Gondor
188877484,ᴵᵀBLOOM,26240463,73412319,1615750,429658,286070,678042,6496736,253736,8144242,6750472,0,1847010287,111895750,28933,[LV21]Lords of Valinor
188575943,BATUMSKİ08,26202977,122122893,2518476,8713459,9991171,6956425,6933532,161842,32756429,7095374,0,2778366881,529137921,20590,[LV21]Lords of Valinor
188581465,ᴸᵛSpSmeagle,26107902,55758671,2639905,1264396,1093916,361345,4822736,182261,7724654,5004997,0,4086975508,150346971,19906,-
188192835,SвулканS,25852731,19947464,388225,2031363,306088,979874,1431780,34586,4783691,1466366,0,3359464979,52162299,9033,[LV21]Lords of Valinor
189939798,ʰᵒDestructor,25816814,18469100,52616,21684,68111,82633,1799801,0,1972229,1799801,0,2826014587,11281500,853,[LG21]Lords of Gondor
188793086,GANDAlF EL GRIS,25816572,6393451,180602,29227,83125,35629,549478,29203,726662,578681,0,2742675239,132716687,7283,[LG21]Lords of Gondor
189141193,ᴸᵛJankels,25804579,51952389,819486,2368695,1924928,2323951,3609879,111710,10339163,3721589,0,3300444942,28726902,16120,[LV21]Lords of Valinor
188806124,ᴵᴾAltar,25682493,111614407,1481141,3177848,4192360,2583327,8685363,270359,18909257,8955722,0,2531022967,7742830,26734,[LG21]Lords of Gondor
188818127,ᴿᶝ风华,25661152,2158531,1064759,62955,74067,33164,157987,14264,342437,172251,0,4118073298,64472747,3840,[LG21]Lords of Gondor
188835262,vinzsou,25620836,16189363,318641,46309,92071,38810,1462884,60594,1700668,1523478,0,2293899163,0,12881,[LV21]Lords of Valinor
188939030,TBILISI,25591587,7839538,1253222,516150,1297487,330601,372081,4906,2521225,376987,0,3021007069,460258,11665,[LG21]Lords of Gondor
188365363,diegokristy,25355621,42552399,464864,421018,640200,815724,3314350,239070,5430362,3553420,0,3724189269,246281206,15396,[LV21]Lords of Valinor
188891048,7BeLa,25337382,57642914,872000,370252,777201,2820258,4394591,39376,8401678,4433967,0,3249200119,137794496,5868,[LG21]Lords of Gondor
186010544,Mehmet027,25296002,55990992,1540749,1745924,1605817,1988711,4394543,26495,9761490,4421038,0,2984797363,173638054,8723,[LV21]Lords of Valinor
188836051,Cheops Pyramide,25264526,68818604,1096272,644864,285017,461502,6225023,201168,7817574,6426191,0,4406209680,731419894,36157,[LV21]Lords of Valinor
188855274,GOLTEB,24916401,127681814,1327294,1219432,175391,426239,11709727,414246,13945035,12123973,0,3365565012,35237187,41729,[LV21]Lords of Valinor
188912287,ᴸʳgCoelho,24819606,32311953,820622,1419717,814999,1014738,2402176,115865,5767495,2518041,0,2434130932,113818904,6798,[LV21]Lords of Valinor
188320476,ᴿᵃЛиса,24824713,33100068,1141689,367524,506339,542999,2691225,146482,4254569,2837707,0,4746989845,362428945,39479,[LV21]Lords of Valinor
146179581,lupepvp,24775833,11445255,602010,166315,115101,34970,951227,76482,1344095,1027709,0,5288415760,108915418,14820,[LV21]Lords of Valinor
188319008,ᴸᵛКэп21,24483757,10075514,29597,216150,128394,92909,914970,12708,1365131,927678,0,2233408969,0,10985,[LG21]Lords of Gondor
188324838,ХОНДА,24355553,7990779,1618420,319927,430706,215833,601619,9293,1577378,610912,0,2514329809,122738819,6012,[LR21]Lords of Rohan
84905552,Schwazzier,24301588,10437886,506526,147563,86882,62010,820623,89017,1206095,909640,0,3184466277,60672597,7936,[LV21]Lords of Valinor
185602720,ˢᵉAbdallah,24143173,37384800,200395,749910,727131,953454,2885936,155369,5471800,3041305,0,1707106341,127071312,9544,[LV21]Lords of Valinor
189236516,ᴿᶝ年华,24109829,2290337,936926,56107,169818,48265,162204,6219,442613,168423,0,3724969933,48671853,2919,[LG21]Lords of Gondor
188937309,Velikiy Govard,24108154,5370314,638326,125640,141509,280242,350384,21868,919643,372252,0,2628520745,85678023,5205,[LG21]Lords of Gondor
184845080,ᴸᵛSCAR德,23957897,55014834,645401,187812,313729,200941,4908393,223106,5833981,5131499,0,3799988575,46674299,28019,[LV21]Lords of Valinor
181974650,IDEM City,23791400,2030305,1163258,142285,141908,58538,141798,3295,487824,145093,0,3776027518,86095121,2071,[LG21]Lords of Gondor
184872506,ᴾᴿF A J A R,23766513,81330450,1396757,2282220,2097345,3030279,6197714,129053,13736611,6326767,0,3250277163,28252952,13422,[LG21]Lords of Gondor
188840841,ᴸᵛNotZach,23562821,30110904,506333,591643,826092,444463,2318528,168863,4349589,2487391,0,1585804394,107725390,4473,[LV21]Lords of Valinor
185094982,Phi Dương F2P,23460470,38295492,1940175,2842133,5213473,4079345,961356,68459,13164766,1029815,0,2109637550,147926355,5326,[LV21]Lords of Valinor
188793523,FerAmaya,23421438,10565841,506442,129947,223590,105868,702162,132379,1293946,834541,0,3610487668,43532335,5214,[LV21]Lords of Valinor
188376202,ᴵᴾ云霄,23328859,6413730,1214571,147461,159504,83670,504869,34093,929597,538962,0,2593018500,17020000,4256,[LV21]Lords of Valinor
188390528,ᶦᶠAkrosh,23277756,14179254,358164,80861,884019,546131,1021052,0,2532063,1021052,0,1408491622,139317710,2243,[21If]Immortal Falcons
188994494,Snowplow,23039881,1094552,236306,8504,103749,19351,80795,0,212399,80795,0,2864005149,0,3445,[LR21]Lords of Rohan
188880486,Kỳ tiktok,22872027,8487802,1062340,68271,30446,79884,622510,93431,894542,715941,0,3858478467,0,3137,[LV21]Lords of Valinor
188937116,ᴵᶜTom,22847232,4798418,78668,26543,281358,25756,401873,5432,740962,407305,0,2254933220,6485919,12148,-
144563085,ᴵᶜPARANOIA,22767880,4730553,1770534,15817,22531,23272,408292,25316,495228,433608,0,2824407119,1021382,4808,[LG21]Lords of Gondor
188661481,Kängurufarm,22685146,2847269,781585,208965,117034,10247,253042,0,589288,253042,0,2409834236,1128542199,4146,[LG21]Lords of Gondor
189057248,Cekko23,22606269,21449744,595985,139303,267141,394238,1750907,90079,2641668,1840986,0,3573470848,76002446,11222,[LV21]Lords of Valinor
185134660,PetitDr,22413048,3101404,85261,63894,67172,12418,288305,1078,432867,289383,0,1499181335,17979430,10865,[21if]farm 21If
188899189,QuantSist,22399233,1720056,385409,11624,68715,76283,127517,0,284139,127517,0,2033742552,296458,5503,[LG21]Lords of Gondor
188234979,iGRECfarm,22298461,15844038,286311,273003,46153,43158,1490992,30729,1884035,1521721,0,2703807026,315563112,10672,-
191454845,ᴸᵛTueAnh,22292930,18203627,664298,42867,104981,279588,1558316,64179,2049931,1622495,0,5542258017,997408023,11637,[LV21]Lords of Valinor
188842111,JJ00,21966271,12581657,546042,13757,120082,40863,1073927,71801,1320430,1145728,0,2619609251,3999999,3635,[LV21]Lords of Valinor
186016235,卂丂卂千,21953168,5455072,172363,142922,151729,14030,395527,55582,759790,451109,0,1886396184,12932669,3810,[LV21]Lords of Valinor
185905587,Ze Boshman,21929998,4802837,1158706,309125,97861,13805,369719,39644,830154,409363,0,2770839083,41584565,2619,-
188870613,xXVincinetteXx,21868756,8307709,1851059,867867,503902,29008,656394,22318,2079489,678712,0,4699104174,5876311,23600,-
188851823,ᴸʳMent001,21803327,706360,45963,213744,185983,43829,11633,0,455189,11633,0,1936404274,0,2730,[LR21]Lords of Rohan
188639928,The亗SCARFACE,21715574,2476955,64606,145589,285116,162864,116131,3242,712942,119373,0,3208454826,44040000,4298,[LG21]Lords of Gondor
188846843,BoboFranek,21704370,1436892,86860,96434,230127,133623,42286,0,502470,42286,0,1842439115,45731253,5585,[LG21]Lords of Gondor
188255601,Ant Man21,21587050,21740037,261646,303216,192688,238972,1939567,47123,2721566,1986690,0,3143089623,0,3958,[LG21]Lords of Gondor
188830522,ᴸʳTylnmrl,21561536,1670861,37663,32839,20609,4164,155652,2495,215759,158147,0,2261045846,16585000,4636,[LG21]Lords of Gondor
188337674,ᴵᴸAxan,21286602,13852737,908861,382486,81728,81286,1314956,6904,1867360,1321860,0,2624026974,376836150,9603,[OP1]OP CLAN
188838640,Presidente CIAO,21244280,3248958,61803,13150,115426,83389,268192,0,480157,268192,0,1622043294,23800000,4496,[LG21]Lords of Gondor
188878743,Jetare,21185286,14851016,984262,914090,1762279,1205895,590546,20730,4493540,611276,0,3184884809,91210728,2959,[LV21]Lords of Valinor
186018265,yıldırımsefa,20926612,12642300,258459,159713,850626,471324,812371,45005,2339039,857376,0,3091634481,50620184,8851,-
188889549,СЦEПИОН,20926077,2997871,1241527,21675,25683,72660,248333,8410,376761,256743,0,1923428853,102567597,3693,[LR21]Lords of Rohan
188819819,fox77778,20818966,3782562,738594,75581,204618,428450,164441,0,873090,164441,0,3296530892,1037349,4683,[LG21]Lords of Gondor
188443825,йкйцк,20721165,48743894,1313992,1943111,2457331,1223280,2839555,507597,8970874,3347152,0,2532968576,1971457076,21172,-
189036655,Vitia back 1990,20716043,9551108,2056000,172660,105414,21917,821704,50052,1171747,871756,0,2655020950,9800000,8570,[LR21]Lords of Rohan
188856715,ᴸᴳJackie,20603435,13979580,284873,80252,30041,24787,1261314,59558,1455952,1320872,0,1247560953,20000000,4046,[LV21]Lords of Valinor
183360513,ᵀᴸмønoメ,20415868,26110591,478300,186118,247673,221163,2277659,95839,3028452,2373498,0,2125813241,85509847,6981,[LG21]Lords of Gondor
188884272,ZHIANZD,20398835,1216090,246973,127800,150740,29760,77001,0,385301,77001,0,2488342395,0,2033,[LR21]Lords of Rohan
187503097,Romulus1991,20369166,28109683,179996,189776,70341,268479,2329919,177897,3036412,2507816,0,3786187063,82802391,17036,[LV21]Lords of Valinor
184819319,joe200,20330410,2022401,1197317,130789,249677,21520,45323,47879,495188,93202,0,1624485065,91263980,5850,[LG21]Lords of Gondor
188876948,Ruberoid,20373203,1308095,30041,24678,63862,55794,95226,0,239560,95226,0,1477892955,3846529,4603,[21If]Immortal Falcons
184859052,ᴸᵛamadxd1,20253982,10023642,1080886,167940,454668,303192,677143,54826,1657769,731969,0,2189325174,315992716,7071,[LV21]Lords of Valinor
188847403,Vali188847403,20238668,1805843,502942,88125,113717,240436,59904,0,502182,59904,0,1173495329,0,641,[_NDM]New Jersey Nol
188790227,СУЛИМАH,20234807,2937806,1265520,69552,52214,89972,230812,7573,450123,238385,0,1837825253,102878721,3411,[LR21]Lords of Rohan
188325495,쵸 See La Meet 쵸,20218723,26136473,714725,1038428,1614240,1553702,1521512,63519,5791401,1585031,0,3512199870,0,7931,-
184817793,meto 313,20095875,2940073,2001835,184629,125724,112750,75554,72258,570915,147812,0,2955129042,1827622,1793,-
188903920,JoshuaSeil,20046748,5346112,817155,57530,197583,100305,414492,19665,789575,434157,0,2922936537,301497,4001,[LV21]Lords of Valinor
188884453,dm152,20019773,261473,0,20838,55033,4660,12860,0,93391,12860,0,2658547845,0,4320,[LG21]Lords of Gondor
188806434,ᴸᴳ Bimz,19979589,4858833,658635,38897,29786,6973,372389,51985,500030,424374,0,2935676850,29458520,9721,[LV21]Lords of Valinor
188836639,Ndiaye,19945831,5853377,660696,352077,491543,747064,181162,0,1771846,181162,0,2959717641,383503,1613,[LLA]Lost legion academia
145631489,BABA SON,19935725,6127632,290848,136434,494296,267396,291067,56575,1245768,347642,0,2113248931,4400000,4783,[LV21]Lords of Valinor
188898779,kral jon snow,19738727,113087,6227,15339,20427,859,6573,0,43198,6573,0,2753058077,8327554,2899,[21If]Immortal Falcons
189075824,NooByZ,19621709,8523920,1530004,77034,121760,128921,748617,13157,1089489,761774,0,3365718003,99259891,19016,-
188232993,AKON311,19570367,17474104,658995,571073,531874,842388,1182997,54831,3183163,1237828,0,1770213436,850687088,12260,[LG21]Lords of Gondor
188857113,GritNGravy,19543467,1953070,46395,39362,14347,20181,183578,0,257468,183578,0,2925567186,3200971,3718,[LG21]Lords of Gondor
188261313,freezebee 21,19516779,2027071,234347,244875,375237,108803,79241,0,808156,79241,0,1742483834,5187959,14525,[LG21]Lords of Gondor
188539042,Chieu F2p,19268916,23473940,464904,857870,1727252,652023,1381019,171479,4789643,1552498,0,2098245881,35342934,10951,[LV21]Lords of Valinor
191530671,ᶦᶠtMadsonn,19348843,1846035,34099,69047,86817,200703,85578,0,442145,85578,0,2608642598,910375198,4576,[LR21]Lords of Rohan
188430882,JapayuKingBILAT,19281873,13532222,558247,244614,718820,347450,998014,33786,2342684,1031800,0,2830815727,142262581,15359,[LV21]Lords of Valinor
188814205,SUBUTAİ 38,19140392,1466044,274608,292102,181430,22696,95398,0,591626,95398,0,1940973569,3080000,2303,[LG21]Lords of Gondor
186613612,Inigo Montoya1,19133609,4781554,1455414,349831,116242,28761,403220,16593,914647,419813,0,2612000172,103076547,8532,[LV21]Lords of Valinor
188818238,PoTaPyh,19086561,17945708,847850,488230,854873,981299,1155520,32896,3512818,1188416,0,3095818179,301072527,13039,-
188853064,TerrorBlade98,19059226,4698786,941546,120572,115534,39441,414286,7149,696982,421435,0,3319228955,0,1345,[LG21]Lords of Gondor
188282297,MinasTirith秋,19050064,67391767,1935936,4739757,348069,495597,5982319,197105,11762847,6179424,0,2949663138,2562027272,30485,-
188838663,ERON,19015674,7419903,732610,190505,250716,72425,647213,5927,1166786,653140,0,1988254222,20081022,12055,[LG21]Lords of Gondor
188845810,BARBALIAS,18899874,5080729,1177937,167048,291925,201260,352189,6827,1019249,359016,0,1731230822,0,5851,-
188869412,dân chơi đá,18877333,8228309,246570,288205,739830,1185717,194814,0,2408566,194814,0,2106256471,1154652,1641,-
188776545,ᴳᵒᵈ Ingle,18866408,1048600,93501,85140,135892,24107,66336,0,311475,66336,0,1692402599,3404666,5127,-
188827507,Dug1man,18631223,106428,5346,18103,18794,0,6522,0,43419,6522,0,2505415016,0,2477,[LG21]Lords of Gondor
188360951,SATORUGOJO1,18446133,9398145,472927,508838,996498,575503,431459,34339,2546637,465798,0,1605356212,317828071,6666,[LV21]Lords of Valinor
188844580,RedHoodJT,18331097,3724748,210774,117223,615129,546669,28437,0,1307458,28437,0,1655559143,0,1450,[LR21]Lords of Rohan
188836606,Black AngEL,18316975,8655975,1937740,908418,995278,553139,422312,2403,2881550,424715,0,2137121812,18536152,1820,[LG21]Lords of Gondor
187197359,Demir Bilek,18270116,9273471,779097,120768,235808,174193,781889,13102,1325760,794991,0,2184069688,30192868,11127,[LG21]Lords of Gondor
188336750,SKY EAGLE,18136313,7121747,985124,330019,49903,45477,677403,0,1102802,677403,0,1931799839,213802552,9588,-
150165925,ᴸᴳken arok,18112787,15145083,613943,496105,278014,115931,1260073,71269,2221392,1331342,0,2424283913,26909895,10847,[LV21]Lords of Valinor
189014302,magister,18034793,11593788,947900,205152,1188782,528161,695989,5133,2623217,701122,0,1327725746,15363819,7383,[LG21]Lords of Gondor
188490339,Eudaimonia,17969126,5238222,227320,56910,36785,12770,453803,28208,588476,482011,0,3193188490,30962500,5607,[LG21]Lords of Gondor
188865329,Việt hoang 07,17892195,607097,64769,419495,234049,900,5150,0,659594,5150,0,2214217502,1833721,888,[21M]Immortal Myrmidons
188884243,HiagoLira,17810241,1285899,1,5567,1871,82946,94926,0,185310,94926,0,1631673219,0,2362,[21If]Immortal Falcons
188787622,MalandrageX,17723799,20690,0,2434,1687,245,1585,0,5951,1585,0,2511718655,0,3274,[LG21]Lords of Gondor
189231766,darkkiller666,17669854,3746982,286312,236683,195194,50737,294065,8283,784962,302348,0,2533244060,20289481,14046,[LG21]Lords of Gondor
188367613,ᶦᶠKinkyTail,17590691,27839187,652235,411575,750063,721224,2106577,115304,4104743,2221881,0,944430976,42186939,11502,[LV21]Lords of Valinor
188806199,Op khan,17479583,4774879,1311876,240925,827408,507637,83281,10426,1669677,93707,0,2841051589,4253716,3117,-
190852683,BossAlien FARM,17376835,6771910,168409,19244,81805,135783,606132,0,842964,606132,0,4232016327,1694123182,2625,[LR21]Lords of Rohan
196566747,Codrin4Valhalla,17160569,5012221,195307,259178,157063,124705,391706,11519,944171,403225,0,653908880,89594454,6114,[LV21]Lords of Valinor
188904786,Shadow vahalla,17241335,951871,236630,6845,11062,4462,91053,0,113422,91053,0,2829637214,0,3007,[LG21]Lords of Gondor
188368666,Derik 災,17193465,17311218,78795,189202,156137,96806,1633226,12081,2087452,1645307,0,1504456225,57910439,4670,-
188487100,Kir8,17188463,744292,46498,47082,45400,57564,41382,0,191428,41382,0,604975853,0,4405,[LG21]Lords of Gondor
188879533,Qertt7,17071095,188791,322,8039,23990,816,10230,1682,44757,11912,0,4070065405,38000000,2141,[LG21]Lords of Gondor
187016834,ƐƘÁ,17051858,5969476,107689,89142,174787,122716,511121,0,897766,511121,0,2727572277,1489060086,4791,[LR21]Lords of Rohan
188585266,メDragønメ,17046256,6200803,260935,13008,75292,24207,548489,23295,684291,571784,0,1565973095,73489482,19339,-
188503741,SİYAH KAZ,16994656,2745204,35926,148261,185391,246920,121345,7182,709099,128527,0,1557000457,38351774,6878,-
188823442,VIP shooter,16944425,3305125,846887,132688,41914,75500,277768,5754,533624,283522,0,1617663134,41800001,5163,[LG21]Lords of Gondor
164927516,iven0007,16859727,10077159,800589,584997,950594,899393,404788,20676,2860448,425464,0,1100228493,29829009,5948,[LG21]Lords of Gondor
188824641,Sabesaur312,16783039,178017,72,61605,21023,10955,7983,0,101566,7983,0,717328751,0,1962,[LR21]Lords of Rohan
189068044,Hsotits7,16755216,13123610,995230,966771,1440390,1040579,499742,44487,3991969,544229,0,2094618821,16241240,3413,[LG21]Lords of Gondor
188833114,Quent2,16736466,22793082,342325,313030,76329,372177,1907169,100871,2769576,2008040,0,1439126709,21298007,10234,[LV21]Lords of Valinor
188928573,Thànhteo,16525013,1269484,231737,5214,47138,152454,56435,0,261241,56435,0,1518718910,0,3090,[21M]Immortal Myrmidons
189181702,222mb222,16485410,2096107,769471,199359,63662,40288,176776,0,480085,176776,0,3048318050,225401626,1730,[LR21]Lords of Rohan
188845980,Azadi,16476890,2414584,591878,280392,474111,105066,99002,0,958571,99002,0,1858211476,3366983,1070,[I-am]RoyalLoyalMembers
189579148,стратег,16475452,2439007,1269763,90576,272116,146355,125592,1766,636405,127358,0,2309890690,1378833,2187,-
188868206,Quocbao05032012,16424445,1765350,652703,140343,12908,5049,169127,0,327427,169127,0,1704583437,6000000,2016,[LR21]Lords of Rohan
188432088,BandAid,16328042,6291099,303434,23738,88926,146960,503492,24287,787403,527779,0,2977364036,308659606,8298,[LG21]Lords of Gondor
188861925,blackbandito,16261213,3299236,432177,181283,407143,143151,130863,28373,890813,159236,0,1448521790,24105565,1966,[LG21]Lords of Gondor
188513738,MooSáke,16217270,198927,96089,15385,14235,12870,11590,0,54080,11590,0,1785178292,0,1221,[RC21]ROYAL CROWN
188852196,DarkExecutioner,16132302,1452447,100617,60616,84044,164244,61526,0,370430,61526,0,1216662089,28060602,1834,[TFS:]The Forsaken Souls
188823187,AZERBAIJAN90,16127248,891992,1273713,78632,32607,42323,49764,7206,210532,56970,0,2188918647,3040,1275,[~AKT]BR AKATSUKI
188894198,Tomioka senpai,16098594,379272,52185,4153,47557,61967,3546,0,117223,3546,0,2565258697,0,1804,[21If]Immortal Falcons
187880560,wcwc,16017764,230115722,1527635,19485000,18674475,23053443,9591814,36893,70841625,9628707,0,3214040764,596448438,13547,[21if]farm 21If
188376429,ᴵᶜmySoul,15812605,447638,94861,165290,199177,4054,1,0,368522,1,0,1311135078,7488905,8464,[LR21]Lords of Rohan
188436016,KiLLedYouhaha,15664372,6285720,234400,186713,224968,166558,469155,22033,1069427,491188,0,2576011801,79055118,9719,[LV21]Lords of Valinor
187078010,Dr4gonsFarmerツ,15450978,22163921,1316246,641729,1799365,1256244,1338903,1142,5037383,1340045,0,2602487365,1725005764,7885,-
188825941,S0SKA,15447745,1189854,237525,181770,115056,123932,42766,0,463524,42766,0,1573181792,17191302,2471,[21M]Immortal Myrmidons
188134384,ˢ carlossainz,15355071,6601011,1300774,21788,65922,52235,498539,63524,702008,562063,0,1190118090,25406959,3999,[LG21]Lords of Gondor
188809474,Edgar15,15275743,46285,13168,43659,11087,2650,478,0,57874,478,0,2116886110,0,1245,[21M]Immortal Myrmidons
188879219,Akglate,15231878,247677,40137,19567,121882,0,0,0,141449,0,0,2071709078,1758755,592,[LR21]Lords of Rohan
188878343,Cheiron City,15291513,2006372,65708,76640,299335,127026,88427,0,591428,88427,0,1338777538,0,1657,[21if]farm 21If
188857667,Apoathou,14986899,1322660,1124764,128214,19733,13903,120194,0,282044,120194,0,230139173,156690,1081,[LG21]Lords of Gondor
188781490,Fra1d,14963604,1187031,100258,39857,116341,94712,56753,0,307663,56753,0,1220961083,5509155,3143,[LG21]Lords of Gondor
187560016,Kyubi Farm1,14903377,43242083,1156562,1634869,1976614,1528733,3245429,19633,8405278,3265062,0,1348799318,409430369,6743,[LG21]Lords of Gondor
190329472,F1Quang,14897227,14222941,1403680,76015,288128,303523,1225945,7897,1901508,1233842,0,3896935792,2734670795,8472,[LR21]Lords of Rohan
188825002,Namiq Cebrayilo,14895258,3934535,1259596,213707,290110,151386,270603,0,925806,270603,0,2135411772,0,724,[21MA]Myrmidons Academy
188800436,LilPiglet,14851534,769658,220953,34240,152043,47076,27042,0,260401,27042,0,1362486306,0,1291,-
188365295,ᴿᵃTsumiki,14849316,2089406,0,8924,38778,19749,193107,0,260558,193107,0,1063300942,3762398,6032,-
188858878,lisabella,14828181,237752,277117,67710,112105,0,0,0,179815,0,0,569020405,0,1605,[21M]Immortal Myrmidons
186035363,Klgi20,14804216,1079100,1084576,54111,135908,7883,18115,29189,245206,47304,0,1839584785,1200000,3123,[21If]Immortal Falcons
150775231,Lind21,14802402,7690885,484858,498285,954081,721214,266273,6774,2446627,273047,0,1823420717,3048989,2494,-
188785649,priam,14782603,1750608,803133,48303,27617,11291,164055,0,251266,164055,0,1461932922,18007168,327,[tgqm1]amarl
188877463,Se Tuath De,14774978,1904865,811661,93157,158781,182383,83914,0,518235,83914,0,2506923354,5600000,2399,[LG21]Lords of Gondor
189036275,TheBlackDragon,14751862,163506,24134,22964,32186,14353,3713,0,73216,3713,0,2029281597,0,1764,[LG21]Lords of Gondor
188963486,GÖZTEPELİ35,14745890,131575,0,26938,85,5222,10513,0,42758,10513,0,1956299993,230887100,3805,-
188281290,1GuiltyCrown1,14694409,19247655,1007323,1096697,1425467,992963,1183957,18298,4717382,1202255,0,3378739737,1967206382,17061,[LG21]Lords of Gondor
183848200,Ei Farm,14658739,38195393,1298931,2526718,1320489,1044558,2973860,56612,7922237,3030472,0,3111047090,519374881,13482,[LG21]Lords of Gondor
186073361,卂尺丂Farm,14634812,3668107,345837,39537,204145,32135,312337,0,588154,312337,0,2285339693,489706596,1512,-
188863496,dark8582,14593735,408222,113485,9062,63839,37988,12678,0,123567,12678,0,1868881030,0,706,[jk10]jk 3621
188802524,Mickodem,14570692,193221,131028,1699,7453,9839,13862,0,32853,13862,0,1197961668,13257436,2976,[LG21]Lords of Gondor
188986083,KyoHN,14340059,58505,16806,10125,15173,711,2329,0,28338,2329,0,2316108710,69,2854,[LG21]Lords of Gondor
12113325,Elena23EV,14338551,1297747,131418,8455,10921,55191,102057,1644,178268,103701,0,1094051478,24431024,5698,[LG21]Lords of Gondor
188796842,Menda2137,14258351,321687,136804,21106,48638,8855,18477,0,97076,18477,0,1116877840,0,1467,[LR21]Lords of Rohan
188873290,FarmЛиса,14229063,2607974,596991,64191,23711,6956,237079,7455,339392,244534,0,1429483724,122800001,4125,[LG21]Lords of Gondor
188885945,whyreall,14191004,1427513,1410059,61686,45602,10688,128122,0,246098,128122,0,1497367838,862617,2035,-
188287771,ᅟᅠᅠᅠᅠᅟᅠᅠᅠᅠ ᅟᅠᅠ,14163065,55138144,428726,330732,673936,319444,5244635,0,6568747,5244635,0,4987770444,2156968833,28845,[LG21]Lords of Gondor
188858305,Palestine313,14100810,3028033,1334422,129577,527939,188640,119168,0,965324,119168,0,1376973165,0,4,[Alg]Palestine313
188847086,Dimiboy,14022454,75311,0,179,37638,0,0,0,37817,0,0,1199618073,0,23,[Tick]Tick tack
188806889,Gouverneur188806889,13944353,785370,316714,61610,182543,80923,8427,0,333503,8427,0,1084023412,0,1024,[21MS]Myrmidons Farm
170835406,ᴵᶜ Has,13928147,1445859,679890,46009,32626,7559,101847,16135,204176,117982,0,687055286,298517,2939,[21If]Immortal Falcons
188896546,БорисBao,13857624,1182765,168254,14668,118405,170863,25957,0,329893,25957,0,1761224189,22966398,1423,[LR21]Lords of Rohan
188856535,HOIANA,13815215,1190153,693357,435295,160981,54643,43890,6183,700992,50073,0,1750207558,400000,1162,[21if]farm 21If
188953179,SarahVinyard017,13756390,5795264,260817,103502,87804,304494,438098,0,933898,438098,0,1388844714,31860199,3832,[LG21]Lords of Gondor
188832666,ChifOJ,13603633,2361104,125471,94442,41533,55215,203829,0,395019,203829,0,2501081257,0,531,[21IR] Corral
44936497,젝스킹,15991483,6996924,923387,39204,54846,41378,523118,74135,732681,597253,0,2183506756,0,9052,-
188931757,ᴸʳANTHRAX,13501640,659165,84307,164935,187652,32931,11915,0,397433,11915,0,1385146784,0,2094,-
191177358,RtthyrFarm,13346949,52258,8925,14892,0,0,4928,0,19820,4928,0,3482852070,1594265331,1130,[LG21]Lords of Gondor
187795145,SOTER,13336432,8447735,539910,529189,65018,309343,652149,22650,1578349,674799,0,1281516203,112215799,15232,[LG21]Lords of Gondor
188787790,You  andl,13307123,920284,416012,51124,134014,82128,31352,0,298618,31352,0,1309649567,4084888,1932,[LR21]Lords of Rohan
191069538,Shinnygamyy,13259416,3037148,499817,235031,755080,228183,56725,0,1275019,56725,0,1083252012,5089962,691,-
187257305,HolySpirits,13200658,4186335,271743,116035,83670,59317,375642,105,634769,375747,0,1158659063,477259605,5803,[21If]Immortal Falcons
188836866,zlucifer,13134321,2684582,271491,220751,328964,145856,139908,0,835479,139908,0,1701695970,0,1524,-
188837379,안정아남자,13087903,885792,199719,262430,137821,8581,52334,0,461166,52334,0,1827352414,0,1095,[LG21]Lords of Gondor
185484265,Tors228,13083005,7740094,636018,1305674,1878812,627539,120762,178,3932965,120940,0,1312958755,25325363,7376,-
188981583,Calep2012,13028091,5854580,972385,252824,915423,175225,313923,6652,1664047,320575,0,1371560025,704256,4512,[K~R~]3621 Utility Box
193596249,Korkusuz 51,12958052,239160,358859,12402,0,0,23668,0,36070,23668,0,1401609699,60357336,943,[LR21]Lords of Rohan
188817273,Munmon,12901737,1116310,211912,39551,42589,125343,52185,0,259668,52185,0,2476678488,0,125,-
188291209,ROCKS  D  XEBEC,12853105,3694092,969555,42334,42629,46712,328702,6325,466702,335027,0,1822462533,37349860,9225,[jk10]jk 3621
188845348,ᴸʳLUNICTUS,12837874,104914,26926,6884,16888,8978,3385,0,36135,3385,0,1548657979,0,453,[LR21]Lords of Rohan
190539451,puyolF,12775399,972686,309560,2673,66571,105265,41795,0,216304,41795,0,4617580243,1818372170,2030,[LR21]Lords of Rohan
188292201,쵸Bear,12762411,3636617,863462,127956,652623,13205,183272,21012,998068,204284,0,1398516677,0,8400,-
188887466,Jensamtresen,12529683,2851467,834974,287219,392239,254799,99035,0,1033292,99035,0,872502186,10799999,840,[I-am]RoyalLoyalMembers
188899884,hanaaaa230,12498522,3656113,993138,112016,538707,284659,141766,0,1077148,141766,0,1465318878,3785937,1102,[K~R~]3621 Utility Box
189266244,ᴵᴾRágnär,12376390,2424921,681640,338989,350984,104124,70352,26757,891206,97109,0,245500638,11642489,7444,-
123456386,Igoryan,12365347,4604101,193112,1352415,222892,143876,329557,838,2049578,330395,0,1316951452,11392165,1293,[LG21]Lords of Gondor
192581999,LilitЛиса,12314905,1758597,2586,4079,12074,27936,162189,0,206278,162189,0,2064527806,516525710,3570,[LG21]Lords of Gondor
142371438,NokedliF11,12302691,3005981,754566,516818,830716,67154,61715,17771,1494174,79486,0,1496304971,2400001,10465,[21M]Immortal Myrmidons
188816893,WARRIOR FARM 10,12243174,242793,17769,22009,47558,10254,10226,0,90047,10226,0,1306471434,0,1890,[21If]Immortal Falcons
178904209,MorFarm2,12182432,243458,0,0,0,3117,23099,0,26216,23099,0,1692919713,335244116,803,-
188829162,Mkジinsane,12152527,911799,856240,15867,56941,24326,65024,2360,164518,67384,0,1543783586,1400000,3486,[LR21]Lords of Rohan
188880051,qftydhunvfezbjj,12100235,18338939,1337013,1249255,1030656,1111224,1086802,35743,4513680,1122545,0,1422326310,88951930,7822,-
188217778,ᴵᴰKing Nemo,11974922,1852509,716667,684238,272077,322,117022,0,1073659,117022,0,1857331281,0,12936,-
190430624,IMPERADOR FARM,11972443,449281,436505,3716,0,322,44725,0,48763,44725,0,4676873340,2527734725,1546,[LR21]Lords of Rohan
185259121,Lets go Os,11935014,913938,1168728,282,16846,7330,13445,35821,73724,49266,0,1375527451,4800000,1574,[LG21]Lords of Gondor
188900034,Rajpoots,11888266,854381,223016,55556,81433,13291,62724,0,213004,62724,0,1858377835,0,3100,[LG21]Lords of Gondor
188479340,ㅡᅟᅟF2P 8      ㅡ,11874571,9974813,173571,883535,766581,262971,721306,0,2634393,721306,0,2705117571,956471741,8844,[LG21]Lords of Gondor
188952266,ErDegui,11804335,7108681,230822,125436,58773,125367,620570,12944,943090,633514,0,1173596936,13045768,5397,[LG21]Lords of Gondor
188946350,BaabyyKiller,11764448,45777543,823248,1480408,3397133,2896319,2635750,37221,10446831,2672971,0,1760569996,20189360,9196,-
188838338,boble 79,11748752,306757,46338,1697,52760,41937,3315,0,99709,3315,0,1268137620,0,2118,[21MA]Myrmidons Academy
187384799,C H A D 3 3 3,11746674,5025006,638494,336794,550030,58137,356220,3142,1304323,359362,0,942780690,0,4530,[LG21]Lords of Gondor
188819203,Cominogr,11672627,347521,71452,268238,123679,11074,222,0,403213,222,0,1658686287,0,850,[ANTB]ANnti Banned Club
60584385,silverlion9,11596083,7926707,936250,516238,906635,1186930,126153,47,2736003,126200,0,1472425909,5041847,1012,-
188887462,Dunks,11568470,1538565,760926,36818,198678,122594,64347,0,422437,64347,0,1107672787,0,1039,[LR21]Lords of Rohan
187155907,Yuzhi,11548834,5032590,1641848,115533,189407,294655,290433,27386,917414,317819,0,2019584760,257605,2006,[LR21]Lords of Rohan
188801943,Brunk100,11490847,938220,200395,171290,279130,31043,22153,0,503616,22153,0,1330342807,2513093,2827,[21If]Immortal Falcons
185877603,ㄴ Aurelio ㄱ,11408032,3426162,734268,194294,519109,17374,220713,3623,955113,224336,0,891518433,1758080,3477,[LG21]Lords of Gondor
188363322,쵸Belmont,11394210,726781,18931,225245,250029,43961,583,0,519818,583,0,1181365988,1410552,11058,-
188900167,Charles grand 3,11380178,4207791,779277,591939,722430,168606,197012,0,1679987,197012,0,1757247574,8400000,914,[Tick]Tick tack
188892262,Udi lopez,11336767,286475,30519,120358,27289,7419,17815,0,172881,17815,0,256378975,3001045,1834,[21If]Immortal Falcons
188885079,ᴵᶜnoobhuhu,11287294,4932153,869902,263679,640053,58918,316980,9692,1289322,326672,0,1694858992,26599999,5002,-
188856725,Uranusuki,11225081,268914,32838,25630,66282,25841,2786,0,120539,2786,0,798645721,3859996,714,[LR21]Lords of Rohan
188840453,La pampara,11196234,3222569,940369,143239,363307,305562,124506,0,936614,124506,0,1436306720,0,297,[21if]farm 21If
174523518,ㅡᅟᅟF2P 5      ㅡ,11170338,3700033,325966,825415,1309771,123637,42086,0,2300909,42086,0,2231549845,808382628,2414,[LG21]Lords of Gondor
188307234,ᴵᵀJessyS2,11159564,3418968,138406,130180,168640,9783,301652,0,610255,301652,0,1509177777,180913621,6306,-
188818543,GodAnubis,11155684,3265470,842158,347813,333503,280538,140675,0,1102529,140675,0,1209973331,473118,747,[21IR] Corral
188840730,FurkiTolki,11073126,1839593,1140153,3217,12856,72657,143339,4461,236530,147800,0,1669208724,3600000,2022,[21M]Immortal Myrmidons
188840892,AlbertO,11026319,415004,15277,47370,78237,8794,21388,0,155789,21388,0,1666596987,0,1894,[21If]Immortal Falcons
189182502,ᴵᶜVatson67F,10977661,137197,213594,1669,4693,617,12501,0,19480,12501,0,3450914694,1724148322,1598,[LR21]Lords of Rohan
188818957,alonsoisma,10962120,2300239,762386,25316,47973,75270,189815,0,338374,189815,0,1507674047,4826393,1390,[LR21]Lords of Rohan
189443468,Hubey,10948714,2171604,462536,189562,257421,35910,147521,0,630414,147521,0,918945909,0,1967,-
184327666,ツاحمدᴰᴮ,10907716,2577997,532046,681079,488185,101508,80134,12902,1363808,93036,0,1427494279,72130,2210,[LV21]Lords of Valinor
189007908,vua đại du,10847143,2010095,594035,32817,68882,36737,135324,18279,292039,153603,0,1664459657,27506603,6095,-
188309795,ᴵᶜ TAZIEX,10844048,8618161,951227,435439,559362,399095,559725,10936,1964557,570661,0,1632163083,0,8839,-
188320795,Fïshböy F1,10749091,1130852,410313,146172,398,5918,103727,1994,258209,105721,0,1490249994,649927741,1092,[LR21]Lords of Rohan
188839518,Zaragoza,10617566,1181120,88062,120100,376712,100919,0,0,597731,0,0,1406378159,0,1106,[LR21]Lords of Rohan
188817859,oktaev,10615195,401425,359467,33669,31021,2770,32157,0,99617,32157,0,1072557734,0,100,[DD21])Dragon of Death
188847841,Lj1208,10594812,314850,314434,984,0,1961,30681,0,33626,30681,0,1172899928,0,904,[21If]Immortal Falcons
188889920,Carolk,10385443,642390,541227,49383,96269,35954,29616,0,211222,29616,0,1154274410,1349311,322,[fagr]alpha table
117517315,ᴵᶜBOTAN,10360428,13712356,945529,506093,1444925,965222,611992,37024,3565256,649016,0,1235813199,498018246,20006,-
188522411,Ваn,10341550,1095208,3365,36724,120447,26500,74097,0,257768,74097,0,727419882,1,2218,[21If]Immortal Falcons
189182788,Vatson67f3,10332376,260412,485136,2684,4031,13106,19939,0,39760,19939,0,3432595527,1133268751,1347,[LR21]Lords of Rohan
189442766,Gubernur189442766,10278674,77204,41779,1313,9937,12737,612,0,24599,612,0,2460894356,1989430704,704,[21IR] Corral
188295840,ッ Yakuza ッ 6,10205094,395204,0,3871,70818,40591,9043,0,124323,9043,0,992758872,82882904,4847,[21if]farm 21If
188906315,ᴵᶜИвaн,10115924,1248369,45240,148765,274837,58418,43527,0,525547,43527,0,943901017,16348226,12804,-
188840603,andyrendy,10073872,1722850,894100,10373,99042,247058,53446,0,409919,53446,0,1032365452,0,459,[Slon]Slonii
195403312,môngcổ,10051155,1446809,783623,85946,65345,87040,95077,0,333408,95077,0,1256472656,0,1035,-
188899095,Minuz,10033181,1614469,364375,167345,306671,102167,55899,0,632082,55899,0,721786492,0,1686,[LR21]Lords of Rohan
188857096,Di 1,10019335,909985,10470,103819,160058,85834,22577,0,372288,22577,0,934774982,1843151,2952,-
188300029,Hoàng Saa,9964510,5137975,463048,87026,120041,279872,368510,3795,859244,372305,0,1258874993,9873378,8148,[LR21]Lords of Rohan
189285062,Linh farm 2,9945965,9739359,1413236,1086939,10938,8479,938116,4251,2048723,942367,0,5404909693,3128768761,1813,[LR21]Lords of Rohan
188881481,678907,9932135,4054167,576543,566707,812285,378314,80300,0,1837606,80300,0,1213920461,53227,1508,[LLA]Lost legion academia
189869613,Алёнааа,9843753,3146615,691598,31047,82951,360086,153416,0,627500,153416,0,1469270043,503089664,1094,[GW21]GOATED WARRIORS
188898591,Dthomas,9838220,468487,81006,125157,122286,22516,10882,0,280841,10882,0,434478065,0,1343,[LR21]Lords of Rohan
188471943,NoCoboY,9790738,413116,95171,64153,54918,15880,22693,0,157644,22693,0,1074224406,0,3617,[LG21]Lords of Gondor
194265891,쵸MØTÃSÊMツ쵸 2,9654581,2043755,0,5126,24684,21098,190897,0,241805,190897,0,1384626776,125453620,1364,[LG21]Lords of Gondor
188846435,psilva3,9647600,1390439,255473,331056,379662,122656,7428,0,840802,7428,0,934758457,0,582,[21IR] Corral
191785327,ᴿᵃQueen,9625702,3017237,247312,228656,300820,10824,232657,0,772957,232657,0,2123392947,813781963,1187,[LR21]Lords of Rohan
186988267,Panda ᴸᴺ,9616784,2766515,1120377,7927,2980,11995,264463,3318,290683,267781,0,3082740466,512115698,1981,-
189915380,BJXXX,9615775,4168395,1002299,38629,16464,369203,265093,0,689389,265093,0,1396788342,0,1621,[LR21]Lords of Rohan
