ID,Name,Power,Killpoints,Deads,T1 Kills,T2 Kills,T3 Kills,T4 Kills,T5 Kills,Total Kills,T45 Kills,Ranged,Rss Gathered,Rss Assistance,Helps,Alliance
179940560,ᴸᵛ ink,108959951,731059693,4538291,2922308,868214,978151,44478834,14001893,63249400,58480727,0,6278723225,1873979817,83189,[LR21]Lords of Rohan
186145908,ᴿᵉʸEscanor,85191376,1669111854,4154664,5408594,1048750,1982569,132557728,16621254,157618895,149178982,0,3567544110,4598233340,23329,[LR21]Lords of Rohan
188540500,TakeMe2Valhalla,77221110,1598534838,6047468,14346853,5993822,11558181,119547386,17098562,168544804,136645948,0,2840733010,7691247251,45334,[LV21]Lords of Valinor
180304933,LilLƴ,74931825,385888273,4114852,3530975,2789390,3346907,22004279,7308644,38980195,29312923,0,1201648248,5100554697,23547,[LV21]Lords of Valinor
188858506,Cúchulainn 쵸,74329599,323474722,2360669,1200564,278755,1008290,28167796,1848299,32503704,30016095,0,5245473467,562651627,39093,[LV21]Lords of Valinor
178695066,SokoDrake,69374850,139603048,2945480,1296111,106206,148891,10389225,1732180,13672613,12121405,0,8284048617,115903540,18118,[LV21]Lords of Valinor
180060983,ᴸᵛRumRamsey,67781513,492256248,2702960,115917352,5049179,1001465,37143644,4176606,163288246,41320250,0,6258942692,417518493,96945,[LV21]Lords of Valinor
179655012,ᴸᵛDØØPER,66707279,728275631,3637408,4502069,1372393,3759523,49613476,10672879,69920340,60286355,0,8602448118,1691282008,39816,[LR21]Lords of Rohan
180560115,TripEhh,63570474,482993940,1504950,3191022,822023,695405,31083529,8354739,44146718,39438268,0,6832195400,1409777077,11374,[LV21]Lords of Valinor
186009654,Dooby ᴼᴺᴱ,60889213,352901350,958454,2646333,392289,879934,31572487,1617145,37108188,33189632,0,7833549251,137216122,36607,[LV21]Lords of Valinor
188839265,A 10 Warthog,60848877,14353666,239989,42983,74269,128873,1144282,111911,1502318,1256193,0,3897629613,784780894,11746,[LR21]Lords of Rohan
179977300,ᴸᵛTmulla,60652660,950522660,1921334,5449020,421126,1525571,57440422,18404205,83240344,75844627,0,7014908290,5600679937,17877,[LV21]Lords of Valinor
184964288,ᴾᴿFïshböy,58858255,304928563,2726451,2601266,4922126,4389452,23274121,2213252,37400217,25487373,0,3642860671,632742525,40309,[LV21]Lords of Valinor
188341936,ᴸᵛ Vatson67,57652158,313003068,1758249,1362222,557836,606793,26373038,2272870,31172759,28645908,0,6828420088,384720155,43272,[LV21]Lords of Valinor
188918989,ᴼᴸ Kaymo,56657472,127639846,1123651,2484352,1386602,2529103,10393460,515938,17309455,10909398,0,3826371448,1075163587,42054,[LV21]Lords of Valinor
178814644,Øtòt x҉ Vail,51164731,448430944,3158966,18550973,3385819,2356133,31760678,5545890,61599493,37306568,0,2295222519,3979433716,16016,[LV21]Lords of Valinor
185836736,ᴸᵛMasonFTW,50983340,547036772,2813014,15931994,2250245,4957441,44839636,3556188,71535504,48395824,0,3463959489,3180393245,29819,[LV21]Lords of Valinor
186985518,HornyAPOLLOS,49622322,273435592,1852203,3559523,1749836,3485109,23138608,1194875,33127951,24333483,0,2785528881,614948054,19374,[LV21]Lords of Valinor
-3,ᴸoᵛeSalmon,49495193,572488646,4124453,19030950,2095258,5112620,40310224,7046961,73596013,47357185,0,5549176720,1110488180,55510,[LR21]Lords of Rohan
184826667,ᴸᵛAHERUS勇,49355337,590796357,1714959,13277076,6381618,13257049,50791331,721810,84428884,51513141,0,6087742502,1446853955,25494,[LV21]Lords of Valinor
186199010,Daphneᴵᴿ,48830064,281191105,2340434,5038908,1387175,4110956,21834067,2131224,34502330,23965291,0,4276378117,2067059163,57476,[LR21]Lords of Rohan
142628224,Dae jang goon,48680647,205490898,2571470,2106271,732287,391595,16547905,1827982,21606040,18375887,0,5147346163,102794418,17513,[LV21]Lords of Valinor
185355768,Majaaaaaaa,48589363,577673018,6018425,3773833,2405479,3630391,50168691,2794941,62773335,52963632,0,1749957055,8071265646,20194,-
184871937,ScazIDGFNÌGGÆ,48175969,1252308597,4532864,63972178,23364142,26120857,97159533,5835356,216452066,102994889,0,5945233649,13704268108,21053,[LV21]Lords of Valinor
181308342,ᴸᵛRockSolid,47002350,237918994,3086504,2887794,716630,1593799,16392118,3280590,24870931,19672708,0,3484637263,6452949920,42199,[LV21]Lords of Valinor
176994964,Cpl Rage,46005771,130447458,637845,2430812,1506936,2122761,10142960,851339,17054808,10994299,0,1998974152,63265830,17486,[LV21]Lords of Valinor
185808036,Ze Bosh,45682185,324557669,903869,8598579,2626646,3862918,28938009,637645,44663797,29575654,0,5524831742,631820319,29935,-
181825355,ᴸoᵛePUMA,45323892,295186077,2313606,1745448,372220,550287,21421680,3883730,27973365,25305410,0,3292818290,3599759382,36931,[LR21]Lords of Rohan
188920797,GettingIt_2021,44977374,141826798,2347425,2458292,1598832,2599064,11164858,804632,18625678,11969490,0,3760363069,1423334749,25037,[LV21]Lords of Valinor
182423962,シValkyrieCillaﾒ,43476883,141213739,1966376,5953825,841564,804654,10909287,1301418,19810748,12210705,0,5138502669,1795203015,15589,[LR21]Lords of Rohan
179750493,GuiltyMahiru,43374037,254007910,1424821,8777683,2047061,3456568,21242836,1095181,36619329,22338017,0,1521191705,2025360302,42000,[LV21]Lords of Valinor
187423027,ᴸᴳPandaFr3d,43237278,200180859,2117293,1996377,815506,932333,15607442,1917341,21268999,17524783,0,2939339806,6820681844,26853,[LV21]Lords of Valinor
179813923,ㄴ Bless ㄱ,42579437,266801565,2303388,7948187,6194983,5527478,21521299,774953,41966900,22296252,0,2604573150,978016636,23861,[LV21]Lords of Valinor
185690465,Dictator  Goat,42238538,364940491,2221525,6110717,2171650,1327422,33097216,1154660,43861665,34251876,0,6407507315,1005155698,35727,[LV21]Lords of Valinor
188241812,Gilgamesh2323,41967673,158343976,1095398,24797993,315033,469268,13685516,701104,39968914,14386620,0,5268499722,212620586,27208,[LV21]Lords of Valinor
188969478,ᴰᴹMePaul,41837140,105818563,1013773,1991609,3290337,2582057,7355162,747986,15967151,8103148,0,3911516015,278578838,3818,[LV21]Lords of Valinor
188483360,ᴼᴸTryxan,41544205,201985179,1217769,21238115,2837274,2706917,15782092,1170721,43735119,16952813,0,6324396214,2169436768,40900,[LV21]Lords of Valinor
187247613,DoRi,41243668,228911350,3612537,4512203,3064086,4146842,18166907,1181215,31071253,19348122,0,7956793137,4718542203,90109,[LV21]Lords of Valinor
188485523,ᴸᵛIMPERADOR,40585973,235940574,1363531,869270,109229,227063,19313179,2075411,22594152,21388590,0,6525319478,281752989,38987,[LV21]Lords of Valinor
188976136,ᴸᵛ MUSE,40406150,123822730,1583284,2291261,2521063,1322273,9745498,778914,16659009,10524412,0,5270183806,405719425,49578,[LV21]Lords of Valinor
179816952,Hell CAT GTR,39444409,62989321,2921173,79059086,1769322,1925680,2855916,368849,85978853,3224765,0,5593004915,1636698071,11247,[LV21]Lords of Valinor
188785515,Johnvin,39241978,214636500,2269631,1162313,1269390,2804592,17893075,1085807,24215177,18978882,0,5049346504,93446315,58343,[LV21]Lords of Valinor
185282531,Annıɛ,39060372,45496988,2695521,469962,132883,175975,4001273,221030,5001123,4222303,0,3456998437,592793562,26333,[LV21]Lords of Valinor
186765655,KönigsKlãsse,38905758,247591718,1207013,2475982,1408580,1939543,21057793,1297163,28179061,22354956,0,3750158504,407789115,9056,[LV21]Lords of Valinor
189072394,ᴵᴾLaura,38887167,52529908,1329010,15368254,388285,792807,4011586,269630,20830562,4281216,0,6509842281,362529904,27924,[LV21]Lords of Valinor
180368631,ᴸᵛWinfields,38887061,170134280,4773141,23257630,190875,621111,12498078,1881789,38449483,14379867,0,5390098184,1877834074,14212,[LV21]Lords of Valinor
188651683,Sol Aliyaa,38353806,13645781,140221,204288,216649,153294,1152169,51838,1778238,1204007,0,4094978119,201676244,15901,[LV21]Lords of Valinor
188882878,Rtthyr,38324845,117386078,1134279,425531,165024,191976,10013386,803458,11599375,10816844,0,7701244835,93046400,20279,[LV21]Lords of Valinor
178213242,ᶦˢLOCOOZ,38276012,142897517,3860481,2142456,957035,1554554,8548914,2442380,15645339,10991294,0,4469753282,1274602396,22386,[LV21]Lords of Valinor
185457048,Cman9918,38231477,133602129,1160939,3704156,1184975,873737,11641776,528932,17933576,12170708,0,1996001700,126071365,16769,-
185986678,卂尺丂,38098517,97306652,1268819,681974,1395201,1304339,8038104,439073,11858691,8477177,0,3322885236,1253919485,15400,[LV21]Lords of Valinor
187726069,ᵀᴿvSpryth,38024495,86210894,933981,1399761,170664,364321,7308417,552408,9795571,7860825,0,5663996880,15763287,24793,[LV21]Lords of Valinor
188303104,HokieHighlander,37901986,104270906,1889302,517572,116387,74552,8416137,973752,10098400,9389889,0,1127969096,84975248,14492,[LV21]Lords of Valinor
188333348,ᴷᴺLinh,37711671,74701037,942365,1904716,1645656,5139453,4266341,390378,13346544,4656719,0,5003641831,550111352,11221,[LV21]Lords of Valinor
188880730,ᴸᵛMarlone,37678521,160169403,2240632,619139,375785,278204,13390335,1213892,15877355,14604227,0,6171080539,136720000,45809,[LV21]Lords of Valinor
189060019,Tušiš,37441431,102346564,1000082,890280,656290,1053072,8784246,440059,11823947,9224305,0,3121872299,592363414,21306,[LV21]Lords of Valinor
188789133,MiniMe,37183494,50630936,475985,503381,260672,245694,4443164,229725,5682636,4672889,0,5206008257,34179151,12203,[LV21]Lords of Valinor
188648613,Känguruᴵᴰ,36588762,25538784,340214,377701,272323,171077,2091875,165777,3078753,2257652,0,2953884233,286935074,13516,-
182338045,亗ƧHiꟻT亗,36280696,150628524,1131937,2662150,1006449,1312309,10247812,2017792,17246512,12265604,0,5628767304,2545586970,32980,[LV21]Lords of Valinor
188276623,ᴸᵛArork,36005805,103588530,1184704,7582671,1379612,1676768,8447348,406611,19493010,8853959,0,3995287637,360935366,17109,[LV21]Lords of Valinor
188805469,BossAlienᴾᴴ,35816137,73466243,1313830,250948,604631,927863,6268308,290613,8342363,6558921,0,5043118261,134750966,40200,[LR21]Lords of Rohan
189017405,ᵸᵒWizzy,35540952,40980754,1135650,813122,976175,1127095,3129326,153207,6198925,3282533,0,2816053831,170159151,14924,[LV21]Lords of Valinor
188501467,direraven,35258544,121404942,756360,7355203,2369135,2788598,8931022,736551,22180509,9667573,0,5026145990,4551820,28118,[LV21]Lords of Valinor
188794709,ᶦᵗˢᵘRYU,35223079,135706441,1229909,2498368,2625705,2821052,11183211,341952,19470288,11525163,0,3895290750,94094214,36660,[LV21]Lords of Valinor
185341770,ᶜᵘRalfish,34789654,86914222,2818846,1099734,1156426,2770646,6064028,632928,11723762,6696956,0,2730597581,25760000,16419,[LV21]Lords of Valinor
188969981,ᵸᵒWand0,34612272,65852934,1286067,2054730,706949,524275,5336241,428429,9050624,5764670,0,4299659159,306699275,22655,[LV21]Lords of Valinor
190252265,Jamong,34464203,50405766,1036039,247042,332926,226639,4364139,257128,5427874,4621267,0,5423736472,81003240,23869,[LV21]Lords of Valinor
188336265,ᴸᵛiGREC,34444879,42753827,387083,548377,205422,376262,3682100,195363,5007524,3877463,0,2450337118,175934276,17641,[LV21]Lords of Valinor
185089489,ᴼᴾZOROGRANJ,34432058,89977952,1885507,550571,355159,737615,7809122,405792,9858259,8214914,0,5703855206,2083599610,21234,[LG21]Lords of Gondor
185048534,Han Sansan,34357034,183056386,1290452,1196933,572006,2199762,15830540,728427,20527668,16558967,0,6297956768,357367305,33349,[LV21]Lords of Valinor
181534760,ᴸᵛSongoku,34278220,98896926,1819604,1005300,948865,1300734,8432324,363598,12050821,8795922,0,4051148542,855945265,16952,[LV21]Lords of Valinor
182713036,쵸ﾒMØTÃSÊMツ쵸,34243465,26368298,662283,107410,239091,451161,2334603,35898,3168163,2370501,0,5279790835,123301386,20875,[LV21]Lords of Valinor
189065897,W3llsFargo,34232490,46741379,777482,1191348,898454,213963,3963477,210779,6478021,4174256,0,4023841588,2754424319,19550,[LV21]Lords of Valinor
188837916,Silent Kakashi,33893743,111664058,901900,842930,754922,750377,10282314,208049,12838592,10490363,0,1817988808,103761097,14129,[LV21]Lords of Valinor
186444772,Dr4gonツ,33824987,296379369,3364140,6142286,3582493,4325814,25637249,715509,40403351,26352758,0,5410665139,4917255397,40466,[LV21]Lords of Valinor
186841127,Anossss,33669415,97326543,1397083,5831747,161764,119554,8371545,582150,15066760,8953695,0,4430228117,4253401,14874,[LV21]Lords of Valinor
188970345,PitBlue,33652458,116260675,976918,1490795,1623967,1705978,9507395,540836,14868971,10048231,0,4091190099,1187393397,23562,[LR21]Lords of Rohan
188368264,funne,33346647,34951436,1335493,898234,647164,618063,2521175,289673,4974309,2810848,0,3857923498,61698120,17209,[LV21]Lords of Valinor
187029935,HolySpirit,33289624,144350987,1549382,1315319,1496292,1994715,12413552,449048,17668926,12862600,0,2726695142,1184079437,19246,[LV21]Lords of Valinor
188651684,Milo San,33216136,8042340,256838,43601,89395,77920,674115,40100,925131,714215,0,3007566520,359753808,12176,[LV21]Lords of Valinor
185923730,JFDLCA,33161995,343849033,649072,5921588,4346326,7848431,28082274,1087780,47286399,29170054,0,4864851182,536336005,37684,[LV21]Lords of Valinor
190407807,동탄불주먹,32919407,33335549,1129127,1095375,330899,696549,2624862,170993,4918678,2795855,0,5495433630,433522789,16180,[LV21]Lords of Valinor
189154415,ᵸᵒMDKMB,32914507,83606006,935811,2741530,896041,875937,6729693,523247,11766448,7252940,0,2221394541,2796649393,20933,[LV21]Lords of Valinor
188833519,JulieLaTueuse쵸,32533340,37164992,841338,382760,448772,273569,3198702,155480,4459283,3354182,0,3685328025,37720000,20587,[LV21]Lords of Valinor
188362493,亗MrDuck ツ,32461095,73275179,1643241,14869619,2095221,1354971,5475231,296931,24091973,5772162,0,2864457106,1301228511,17469,[LR21]Lords of Rohan
188451175,ᵸᵒTerra,32338791,63073264,870910,3422823,860914,534113,5094502,379270,10291622,5473772,0,4080434729,92432122,22634,[LV21]Lords of Valinor
185037763,ᵛBEARDY,32277187,51437912,2227119,28222212,2319488,801981,2906415,444121,34694217,3350536,0,4921911553,554484409,19513,-
188736727,Alex9003,32255620,46996502,1766706,3210104,795704,855171,3324123,405058,8590160,3729181,0,4290260515,38138060,14527,[LV21]Lords of Valinor
188242643,ᴸᵛNemoo メ G,32276819,131234582,1010399,3774670,1027002,593261,10730924,937168,17063025,11668092,0,3876011149,4465956315,31047,[LV21]Lords of Valinor
182317160,G  O  P  A R,32170818,204849227,2335101,5519517,2458103,3651697,17157213,632510,29419040,17789723,0,4429430773,786465485,29918,[LV21]Lords of Valinor
188826595,Saf1974,32045278,163344806,2190947,1942420,737761,876760,12681444,1557966,17796351,14239410,0,5337088619,234946040,53931,[LV21]Lords of Valinor
188225231,ᴾᴿSko0p,32013174,34213211,383675,178306,89071,72567,3151408,109753,3601105,3261161,0,4590136237,0,27337,[LV21]Lords of Valinor
189045190,Azura21,31782254,29061325,1079446,528436,682624,3020265,1500577,25178,5757080,1525755,0,2841204487,423984134,8223,[LV21]Lords of Valinor
188847278,ᴸᵛQuang,31511262,210808916,1361606,2895843,1876831,2874774,18189253,654223,26490924,18843476,0,4240712724,1794614837,35589,[LV21]Lords of Valinor
188364390,ᴸᵛLeonPoi,31481427,173502882,1572877,537332,421144,1045727,15069206,883908,17957317,15953114,0,3910194538,108004980,37683,[LV21]Lords of Valinor
185612447,Chaudary Zain,31451611,172859105,1767683,23841007,1625907,1347790,14474377,735208,42024289,15209585,0,4671392831,1463359200,26438,[LV21]Lords of Valinor
185724517,Feldgraŭ,31289105,150221666,1790318,475383,3849630,1436815,11310767,1178620,18251215,12489387,0,4251305600,210066760,33698,[LV21]Lords of Valinor
188352541,ᴾᴿ Mèoッ,31267867,132247542,1478051,7190642,1700314,1304919,10946283,636314,21778472,11582597,0,6277416201,0,14597,[LV21]Lords of Valinor
186043643,ƐKA,31227449,66478554,1325466,948183,319988,430578,5712981,339841,7751571,6052822,0,3360990867,501165307,31228,[LV21]Lords of Valinor
188262339,Kitty27,31023692,11339585,241477,90817,178359,37776,749342,166009,1222303,915351,0,3948861072,23588840,11898,[LV21]Lords of Valinor
188961098,Chocolalat,31019291,2667617,220977,51569,65233,15462,226419,10040,368723,236459,0,4264461392,21199999,3765,[LV21]Lords of Valinor
188316323,ᴸᵛ SAKURA,30761005,123659539,1599673,2434059,1253856,2428689,10305394,394816,16816814,10700210,0,4209054184,849454569,27487,[LR21]Lords of Rohan
184882401,Ферма а,30689761,92480601,1751855,22831138,3000621,3316968,6293708,285409,35727844,6579117,0,2701640729,3538154179,17507,[LV21]Lords of Valinor
188797972,21LuviVilu21,30682218,29677278,1672173,685070,548360,581341,2269860,170979,4255610,2440839,0,4538599229,44539709,16491,[LV21]Lords of Valinor
188789684,ᴿᵃtMadson,30609856,29479265,704701,1339007,164059,264454,2404403,189075,4360998,2593478,0,4059640049,114578620,43495,[LV21]Lords of Valinor
181581608,Fledermauz DB,30609329,38142703,702758,248895,300074,511759,3506250,19162,4586140,3525412,0,3623526638,377676127,7928,[LV21]Lords of Valinor
188598120,ᶻSharineko〤,30563385,136273606,1519469,6066172,1457894,813531,10871650,1008698,20217945,11880348,0,2387660678,259185747,19030,[LV21]Lords of Valinor
188285810,ᴵᴰJupanu,30431270,65563961,1313760,1004348,1641004,851636,5257880,304787,9059655,5562667,0,4991870648,57408174,20633,[LV21]Lords of Valinor
187559873,ｱ尺ﾉ丂ᄃﾉﾚﾚﾑ,30392293,62764587,524842,786256,540194,444292,5253292,360843,7384877,5614135,0,2629725287,626443180,15383,[LV21]Lords of Valinor
189001955,ᴸᵛTruNguyen,30365876,57928873,817662,1388349,305182,978920,4983082,164717,7820250,5147799,0,4578504132,319678867,17534,[LV21]Lords of Valinor
188944242,Đạt Feet,30244599,33701467,896647,944919,1753783,1861482,1939421,158239,6657844,2097660,0,4873695326,23846424,9812,[LV21]Lords of Valinor
188293704,ᴸᵛDrMusaab,30448567,48376996,1820120,193863,427848,173972,4067270,305697,5168650,4372967,0,3970369137,84578452,15084,[LV21]Lords of Valinor
177013392,ᴸᵛ UCC15,30182269,41040514,2710715,1200432,936754,881360,3044870,247639,6311055,3292509,0,5449846638,192271545,16473,[LV21]Lords of Valinor
188335709,Rebel Rogue,30080923,75157317,1366902,1040029,700124,771386,6362994,341679,9216212,6704673,0,3495117576,34205137,34027,[LV21]Lords of Valinor
188876886,ᴸᵛTheanh,30074060,191356680,1579225,19339010,451570,1203802,16759923,708565,38462870,17468488,0,5632541715,107966937,37383,[LV21]Lords of Valinor
186295211,ᶠˡVENDETTA,29849998,115576250,2742984,4081984,1084740,528626,9229579,909004,15833933,10138583,0,3885646386,1050356942,20089,-
188788713,Sam smith,29242120,36805077,772626,601729,331796,180165,3132232,198908,4444830,3331140,0,3955479526,33958258,12803,[LV21]Lords of Valinor
188547640,Kitty8152,28980889,1630693,12032,78078,153637,150776,70470,0,452961,70470,0,6611531664,2547000,7914,[LG21]Lords of Gondor
185651937,ᴳᵃʸGrizzy,28913697,394707496,1530202,11898130,5833583,11664631,32492852,453683,62342879,32946535,0,3744084354,952357579,20305,-
185538462,UMAYKIZ,28705158,87347872,1407782,2472032,767630,1047239,7446559,333183,12066643,7779742,0,4123163979,8566632,6538,[LV21]Lords of Valinor
188836483,YenifferDeRivia,28701625,41837660,1714676,1784534,2318341,1691838,2868362,69655,8732730,2938017,0,3414107882,140738085,4897,[LR21]Lords of Rohan
188543996,ᴸᴳﾒNØHOPEツ,28507918,34414066,931686,478590,187282,677631,2859256,132035,4334794,2991291,0,3461870004,31608954,12506,[LV21]Lords of Valinor
188880546,Graf000007,28402109,4086246,1602923,195112,206722,115320,276770,20240,814164,297010,0,3623861767,0,4233,[LG21]Lords of Gondor
185282573,ᴸᵛ3621 BANK,28235257,65727804,821714,686003,1267167,649115,5157649,444166,8204100,5601815,0,1380539975,3175856491,8718,[LV21]Lords of Valinor
188819438,ᴸᴳLuca,28230687,46983742,616568,378993,894190,250296,4088058,161890,5773427,4249948,0,4266248661,636280200,24208,[LG21]Lords of Gondor
188872694,DELİ ÜSTAD,28141691,5962066,716649,208561,290491,524323,257508,33350,1314233,290858,0,4499478387,39905983,2175,[LG21]Lords of Gondor
182720562,ᶜᴹᵈSkyy,28092367,19752884,2388318,291902,77615,310791,1289299,270156,2239763,1559455,0,3999667646,685652689,12498,-
188818127,ᴿᶝ风华,27847163,2158531,1064759,62955,74067,33164,157987,14264,342437,172251,0,4244173304,64472747,4026,[LG21]Lords of Gondor
188365363,diegokristy,27833998,59949852,504980,436800,640264,816141,4607542,462099,6962846,5069641,0,3795918728,246281206,16255,[LV21]Lords of Valinor
188853241,Алёнаа,27702476,31302992,900423,247992,344883,856812,2140828,286405,3876920,2427233,0,4614828381,45525540,13144,[LV21]Lords of Valinor
185602720,ˢᵉAbdallah,27689081,37680310,200395,749910,727131,953454,2914261,155982,5500738,3070243,0,1730155469,127071312,10236,[LV21]Lords of Valinor
188192835,SвулканS,27627140,19967704,388225,2031363,306088,979874,1431780,35598,4784703,1467378,0,3369791466,52162299,9449,[LV21]Lords of Valinor
188806334,Emrah 51,27585947,3751158,1312229,1012,10602,4008,371372,0,386994,371372,0,4150229950,0,4428,[LR21]Lords of Rohan
84905552,Schwazzier,27578794,13911756,621510,167620,94182,73167,1095908,121906,1552783,1217814,0,3325000673,60672597,8585,[LV21]Lords of Valinor
189939798,ʰᵒDestructor,27565745,19723170,52616,21684,68111,82633,1909078,8065,2089571,1917143,0,3076349465,11281500,934,[LG21]Lords of Gondor
188830020,ᴸᴳVersized,27545724,90375468,1311002,766351,950535,571562,7391704,605892,10286044,7997596,0,3900332889,156055672,11640,[LR21]Lords of Rohan
188294260,CЦEПИOH,27503323,10421111,1855157,581297,556310,288078,772954,15519,2214158,788473,0,2754555570,173206292,7548,[LG21]Lords of Gondor
188575943,BATUMSKİ08,27134366,126287588,2604699,8739204,9993384,6958475,7275346,198281,33164690,7473627,0,2874212629,529137921,21074,[LV21]Lords of Valinor
188855274,GOLTEB,27120642,137522262,1356325,1219442,175444,426239,12531591,495331,14848047,13026922,0,3412977637,35237187,42680,[LV21]Lords of Valinor
188453555,Puyols,27088320,76321381,1511886,493568,370544,264770,6568270,436990,8134142,7005260,0,7111017487,127173124,25766,[LV21]Lords of Valinor
188544046,G4mine,26718340,28387329,2022351,263306,631545,296942,2243465,172458,3607716,2415923,0,4317317823,247760315,20193,-
189040679,ㄴHORIZONㄱ,26627239,75637869,781168,978098,1081971,1076762,6855262,20932,10013025,6876194,0,4541245002,188105599,14294,[LV21]Lords of Valinor
189141193,ᴸᵛJankels,26453354,77016175,1072347,5409357,1932307,2347870,5651683,308069,15649286,5959752,0,3450823543,28726902,17293,[LV21]Lords of Valinor
186010544,Mehmet027,26328796,65385498,1626376,1945762,1718352,2118048,5170911,68917,11021990,5239828,0,3089131924,173638054,9569,[LV21]Lords of Valinor
186709522,ᴸᵛ SHERY,26317826,62901228,1562880,609853,401512,544566,5284363,347717,7188011,5632080,0,3418180525,389489407,9558,[LV21]Lords of Valinor
188877484,ᴵᵀBLOOM,26240463,73412319,1615750,429658,286070,678042,6496736,253736,8144242,6750472,0,1847010287,111895750,28933,-
188836051,Cheops Pyramide,26205490,98408383,1323682,709979,285764,469450,8364192,608757,10438142,8972949,0,4631277970,751419894,40138,[LV21]Lords of Valinor
189236516,ᴿᶝ年华,26105124,2290337,936926,56107,169818,48265,162204,6219,442613,168423,0,3902651565,48671853,3066,[LG21]Lords of Gondor
146179581,lupepvp,25785023,17722759,715194,253956,122446,45339,1450942,136815,2009498,1587757,0,5553713283,308915418,16630,[LV21]Lords of Valinor
188852900,Scorpionking乂,25776545,96188094,3167943,912832,735931,1885129,8074513,312401,11920806,8386914,0,2306789288,58256706,33592,[LR21]Lords of Rohan
188277784,ᴵᴾPecimura,25471519,28014853,96045,30115,106786,86982,2470635,137049,2831567,2607684,0,2004901092,30935666,8683,[LG21]Lords of Gondor
188891048,7BeLa,25356582,57642914,872000,370252,777201,2820258,4394591,39376,8401678,4433967,0,3249200119,137794496,5870,[LG21]Lords of Gondor
188912287,ᴸʳgCoelho,25330544,50704176,1028681,2543710,1168558,1360657,3847367,197101,9117393,4044468,0,2515882608,113818904,7952,[LR21]Lords of Rohan
188320476,ᴿᵃЛиса,25307547,53688113,1294102,367919,507145,552515,4461362,288828,6177769,4750190,0,4901039052,390428945,41019,[LV21]Lords of Valinor
188939030,TBILISI,25083121,10258580,1869920,516763,1297519,330775,519097,52306,2716460,571403,0,3159661015,460258,11902,[LG21]Lords of Gondor
189057248,Cekko23,24933396,31863092,710643,195672,272850,402577,2609703,178546,3659348,2788249,0,3844846748,76002446,11645,[LV21]Lords of Valinor
188835262,vinzsou,24917090,32755575,851628,88359,189081,410003,2910785,80594,3678822,2991379,0,2373287082,0,13847,[LV21]Lords of Valinor
185094982,Phi Dương F2P,24755736,39173205,2000799,2842665,5217763,4108284,1025931,73835,13268478,1099766,0,2127434075,147926355,5633,[LV21]Lords of Valinor
188324838,ХОНДА,24471753,7990779,1618420,319927,430706,215833,601619,9293,1577378,610912,0,2525810483,122738819,6024,[LR21]Lords of Rohan
188840841,ᴸᵛNotZach,24420197,32975744,548532,661641,826162,444933,2567192,186972,4686900,2754164,0,1699811436,107725390,4724,[LV21]Lords of Valinor
188899189,QuantSist,24392100,2171937,522590,11628,68715,76283,152109,10298,319033,162407,0,2224825911,296458,5671,[LG21]Lords of Gondor
188319008,ᴸᵛКэп21,24270069,12532523,83019,401209,200134,221141,1091329,12708,1926521,1104037,0,2233408969,0,10992,[LG21]Lords of Gondor
184845080,ᴸᵛSCAR德,24253584,65466919,972616,266495,317539,201813,5687293,354918,6828058,6042211,0,4010481331,46674299,29169,[LV21]Lords of Valinor
188851823,ᴸʳMent001,24035655,706360,45963,213744,185983,43829,11633,0,455189,11633,0,2107383828,0,2822,[LR21]Lords of Rohan
188937309,Velikiy Govard,23925943,10107004,638326,125640,141509,280242,824053,21868,1393312,845921,0,2810159816,125678023,5321,[LG21]Lords of Gondor
181974650,IDEM City,23858956,2030305,1163258,142285,141908,58538,141798,3295,487824,145093,0,3776027518,86095121,2073,[LG21]Lords of Gondor
188376202,ᴵᴾ云霄,23850217,6580450,1214571,147461,159504,83670,521541,34093,946269,555634,0,2594984100,17020000,4283,-
188880486,Kỳ tiktok,23820707,10194513,1169669,70126,30762,93811,740708,116832,1052239,857540,0,4273617925,0,3401,[LV21]Lords of Valinor
184872506,ᴾᴿF A J A R,23766513,81330450,1396757,2282220,2097345,3030279,6197714,129053,13736611,6326767,0,3250277163,28252952,13422,[LG21]Lords of Gondor
188994494,Snowplow,23590795,1094552,236306,8504,103749,19351,80795,0,212399,80795,0,2997552494,0,3495,[LR21]Lords of Rohan
188793523,FerAmaya,23350926,18830630,649322,195550,244809,195163,1315697,218214,2169433,1533911,0,3627225959,83532335,5604,[LR21]Lords of Rohan
188390528,ᶦᶠAkrosh,23336156,14179254,358164,80861,884019,546131,1021052,0,2532063,1021052,0,1408491622,139317710,2243,[21If]Immortal Falcons
191454845,ᴸᵛTueAnh,23241403,26617683,733830,6098498,110485,294896,2134417,132663,8770959,2267080,0,5979497960,1213408023,12784,[LV21]Lords of Valinor
144563085,ᴵᶜPARANOIA,23035722,4730553,1770534,15817,22531,23272,408292,25316,495228,433608,0,2853256130,1021382,4816,[LG21]Lords of Gondor
188937116,ᴵᶜTom,22847232,4798418,78668,26543,281358,25756,401873,5432,740962,407305,0,2254933220,6485919,12148,-
188878743,Jetare,22737343,16207666,998311,914090,1762279,1205895,648323,59674,4590261,707997,0,3372705932,91210728,3224,[LV21]Lords of Valinor
188830522,ᴸʳTylnmrl,22736970,1670861,37663,32839,20609,4164,155652,2495,215759,158147,0,2412995177,16585000,4716,[LG21]Lords of Gondor
187503097,Romulus1991,22723686,42959892,456090,250993,87018,335877,3654983,242116,4570987,3897099,0,4089221310,82804211,18799,[LV21]Lords of Valinor
188661481,Kängurufarm,22685146,2847269,781585,208965,117034,10247,253042,0,589288,253042,0,2409834236,1128542199,4146,[LG21]Lords of Gondor
188842111,JJ00,22601411,12821657,550923,13757,120082,40863,1088289,76620,1339611,1164909,0,2627484251,3999999,3702,[LV21]Lords of Valinor
186016235,卂丂卂千,22543608,6560319,201693,185057,152860,49387,480702,60651,928657,541353,0,2061429658,12932669,3994,[LV21]Lords of Valinor
188856715,ᴸᴳJackie,22475752,17890881,325870,100087,61889,140784,1539583,89406,1931749,1628989,0,1316545881,20000000,4301,[LV21]Lords of Valinor
188234979,iGRECfarm,22319661,15844038,286311,273003,46153,43158,1490992,30729,1884035,1521721,0,2703807026,315563112,10672,-
188884453,dm152,22136982,261473,0,20838,55033,4660,12860,0,93391,12860,0,2899352597,0,4475,[LG21]Lords of Gondor
188664465,ᴸᵛEren 勇,22074129,49965974,1623051,606890,681174,827892,4278040,119514,6513510,4397554,0,1902975921,650343921,22154,-
184817793,meto 313,21976885,2940073,2001835,184629,125724,112750,75554,72258,570915,147812,0,3071826042,1827622,1822,-
185905587,Ze Boshman,21929998,4802837,1158706,309125,97861,13805,369719,39644,830154,409363,0,2770839083,41584565,2619,-
188870613,xXVincinetteXx,21868756,8307709,1851059,867867,503902,29008,656394,22318,2079489,678712,0,4699104174,5876311,23600,-
188639928,The亗SCARFACE,21840107,2940935,64606,145589,285116,162864,139631,14691,747891,154322,0,3276156317,44040000,4426,[LG21]Lords of Gondor
188838640,Presidente CIAO,21823495,4975036,91671,13150,115450,83389,381063,29866,622918,410929,0,1710953788,23800000,4720,[LG21]Lords of Gondor
188819819,fox77778,21751880,3782562,738594,75581,204618,428450,164441,0,873090,164441,0,3432772974,1037349,4811,[LG21]Lords of Gondor
188255601,Ant Man21,21587050,21740037,261646,303216,192688,238972,1939567,47123,2721566,1986690,0,3143089623,0,3958,[LG21]Lords of Gondor
188337674,ᴵᴸAxan,21482870,13852737,908861,382486,81728,81286,1314956,6904,1867360,1321860,0,2654640236,376836150,9626,[OP1]OP CLAN
188853064,TerrorBlade98,21372403,4698786,941546,120572,115534,39441,414286,7149,696982,421435,0,3484212521,0,1409,[LG21]Lords of Gondor
189036655,Vitia back 1990,21305101,9551108,2056000,172660,105414,21917,821704,50052,1171747,871756,0,2795267508,9800000,8626,[LR21]Lords of Rohan
188818238,PoTaPyh,21290674,17945708,847850,488230,854873,981299,1155520,32896,3512818,1188416,0,3104143742,301072527,13061,[LV21]Lords of Valinor
186018265,yıldırımsefa,21276860,12642300,258459,159713,850626,471324,812371,45005,2339039,857376,0,3152665981,50620184,8907,-
145631489,BABA SON,21280212,9391733,299198,136457,752941,351560,417304,113964,1772226,531268,0,2451194637,4400000,5541,[LV21]Lords of Valinor
188889549,СЦEПИОН,21098876,2997871,1241527,21675,25683,72660,248333,8410,376761,256743,0,1929432752,102567597,3698,[LR21]Lords of Rohan
188836639,Ndiaye,21089943,5853377,660696,352077,491543,747064,181162,0,1771846,181162,0,3122876480,383503,1705,[LG21]Lords of Gondor
188876948,Ruberoid,21086988,1308095,30041,24678,63862,55794,95226,0,239560,95226,0,1497173666,3846529,4640,[21If]Immortal Falcons
188847403,Vali188847403,20937912,1805843,502942,88125,113717,240436,59904,0,502182,59904,0,1183279229,0,647,[_NDM]New Jersey Nol
184859052,ᴸᵛamadxd1,20878238,11242441,1696065,175899,454668,303269,793425,57530,1784791,850955,0,2360704560,315992716,7433,[LV21]Lords of Valinor
188903920,JoshuaSeil,20762110,13244804,988776,125344,335261,247316,1033071,61462,1802454,1094533,0,3013369949,301497,4572,[LV21]Lords of Valinor
188443825,йкйцк,20721165,48743894,1313992,1943111,2457331,1223280,2839555,507597,8970874,3347152,0,2532968576,1971457076,21172,-
187197359,Demir Bilek,20700494,11360496,827941,136423,235814,190141,923038,43532,1528948,966570,0,2385285728,30192868,11402,-
188790227,СУЛИМАH,20689024,2937806,1265520,69552,52214,89972,230812,7573,450123,238385,0,1855508039,102878721,3417,[LR21]Lords of Rohan
189075824,NooByZ,20501212,8671110,1564105,77034,121760,128921,763336,13157,1104208,776493,0,3365718003,99259891,19016,-
184819319,joe200,20426646,2022401,1197317,130789,249677,21520,45323,47879,495188,93202,0,1631673131,91263980,5852,[LG21]Lords of Gondor
183360513,ᵀᴸмønoメ,20415868,26110591,478300,186118,247673,221163,2277659,95839,3028452,2373498,0,2125813241,85509847,6981,[LG21]Lords of Gondor
188884272,ZHIANZD,20398835,1216090,246973,127800,150740,29760,77001,0,385301,77001,0,2488342395,0,2033,[LR21]Lords of Rohan
188857113,GritNGravy,20269028,2007100,46395,39362,14347,20181,188981,0,262871,188981,0,2994149430,3200971,3761,[LG21]Lords of Gondor
188325495,쵸 See La Meet 쵸,20218723,26136473,714725,1038428,1614240,1553702,1521512,63519,5791401,1585031,0,3512199870,0,7931,-
188814205,SUBUTAİ 38,20188165,1466044,274608,292102,181430,22696,95398,0,591626,95398,0,2117805305,3080000,2351,[LG21]Lords of Gondor
188261313,freezebee 21,20146177,2063501,394759,244875,375237,108803,81854,515,811284,82369,0,1800837188,5187959,14921,[LG21]Lords of Gondor
191530671,ᶦᶠtMadsonn,20163447,2806071,138871,82555,111187,249744,152879,1971,598336,154850,0,2762884175,910375198,4765,[LR21]Lords of Rohan
164927516,Iᴠᴀɴツ07,20118655,10720999,801063,584997,950594,899393,462478,24023,2921485,486501,0,1289169555,29829009,7024,[LV21]Lords of Valinor
150165925,ᴸᴳken arok,20077293,36927811,748698,4623735,278555,119051,3206967,145004,8373312,3351971,0,2582092244,54909895,13187,[LV21]Lords of Valinor
188898779,kral jon snow,20021340,113087,6227,15339,20427,859,6573,0,43198,6573,0,2758203077,8327554,2901,[21If]Immortal Falcons
188644411,IQ777,19951696,10297771,72917,271035,682547,244380,661655,64220,1923837,725875,0,1174120561,127703632,20889,-
188806434,ᴸᴳ Bimz,19940713,6186719,844385,40869,30149,21752,480982,61071,634823,542053,0,3147958897,29458520,10219,[LV21]Lords of Valinor
186613612,Inigo Montoya1,19926656,5831651,1522272,350817,116242,28761,501620,19888,1017328,521508,0,2787417716,103076547,8891,[LV21]Lords of Valinor
188776545,ᴳᵒᵈ Ingle,19731387,1048600,93501,85140,135892,24107,66336,0,311475,66336,0,1766181793,3404666,5183,-
188838663,ERON,19695465,8922046,732610,244773,879083,131064,647213,5927,1908060,653140,0,2049570608,20081022,12120,[LG21]Lords of Gondor
188232993,AKON311,19570367,17474104,658995,571073,531874,842388,1182997,54831,3183163,1237828,0,1770213436,850687088,12260,[LG21]Lords of Gondor
188430882,JapayuKingBILAT,19496089,23077762,695438,274371,733692,410201,1860768,65351,3344383,1926119,0,3032369707,154262581,16608,[LV21]Lords of Valinor
188360951,SATORUGOJO1,19487583,9648765,472927,508838,996498,575503,454115,35542,2570496,489657,0,1617482301,317828071,6914,[LV21]Lords of Valinor
140534782,ᴵᴾCoCaSNX,19345651,21797010,531203,1203243,267031,348395,1715668,123602,3657939,1839270,0,3530980381,2108538017,6924,[RC21]ROYAL CROWN
188367613,ᶦᶠKinkyTail,19271935,43400552,829621,1665920,916636,957104,3458796,140886,7139342,3599682,0,1047397965,66186939,14287,[LV21]Lords of Valinor
188844580,RedHoodJT,19210853,3724748,210774,117223,615129,546669,28437,0,1307458,28437,0,1791701774,0,1537,[LR21]Lords of Rohan
188539042,Chieu F2p,19038057,45547542,817236,971873,1760016,784479,3152688,358417,7027473,3511105,0,2180706918,185342934,12327,[LV21]Lords of Valinor
188869412,dân chơi đá,18877333,8228309,246570,288205,739830,1185717,194814,0,2408566,194814,0,2106256471,1154652,1641,-
188806199,Op khan,18821261,5045708,1364616,257074,828432,511315,101739,13739,1712299,115478,0,3110934214,4253716,3448,[LR21]Lords of Rohan
188787622,MalandrageX,18817466,20690,0,2434,1687,245,1585,0,5951,1585,0,2589081631,0,3316,[LG21]Lords of Gondor
188884243,HiagoLira,18577854,1402109,1,5567,1871,82946,106547,0,196931,106547,0,1716386163,0,2396,[21If]Immortal Falcons
188836606,Black AngEL,18427835,8655975,1937740,908418,995278,553139,422312,2403,2881550,424715,0,2141610562,18536152,1822,[LG21]Lords of Gondor
188827507,Dug1man,18379429,481528,14352,18103,18794,0,18094,12969,67960,31063,0,2663609408,0,2543,[LG21]Lords of Gondor
189014302,magister,18060393,11593788,947900,205152,1188782,528161,695989,5133,2623217,701122,0,1327725746,15363819,7384,[LG21]Lords of Gondor
189068044,Hsotits7,18036519,13855771,995230,968977,1440390,1040579,567482,47203,4064631,614685,0,2270244449,16241240,3627,[LG21]Lords of Gondor
188490339,Eudaimonia,18042207,17575118,545992,112613,61988,61830,1475802,121164,1833397,1596966,0,3553021882,30962500,6912,[LV21]Lords of Valinor
188876717,DEWO YEAGER,17922259,5955979,1113111,572647,822160,386945,262799,1068,2045619,263867,0,2598814546,0,1895,[LG21]Lords of Gondor
188865329,Việt hoang 07,17892195,607097,64769,419495,234049,900,5150,0,659594,5150,0,2214217502,1833721,888,[21M]Immortal Myrmidons
188833114,Quent2,17785227,30074039,576579,335829,77908,383322,2467365,182206,3446630,2649571,0,1529382810,21298007,11369,[LV21]Lords of Valinor
187016834,ƐKA1,17747204,8351578,227489,89143,174808,122716,677451,35938,1100056,713389,0,2823013793,1649060086,4929,[LG21]Lords of Gondor
188487100,Kir8,17716099,744292,46498,47082,45400,57564,41382,0,191428,41382,0,612457103,0,4425,[LG21]Lords of Gondor
188904786,Shadow vahalla,17713325,951871,236630,6845,11062,4462,91053,0,113422,91053,0,3012337214,0,3069,[LG21]Lords of Gondor
189231766,darkkiller666,17669854,3746982,286312,236683,195194,50737,294065,8283,784962,302348,0,2533244060,20289481,14046,[LG21]Lords of Gondor
188336750,SKY EAGLE,17569926,7355557,989123,330019,49903,45477,700784,0,1126183,700784,0,1931799839,213802552,9588,-
188879533,Qertt7,17555057,188791,322,8039,23990,816,10230,1682,44757,11912,0,4265041180,38000000,2248,[LG21]Lords of Gondor
196566747,Codrin4Valhalla,17545150,9773767,302522,278437,157257,127114,770671,59420,1392899,830091,0,659981309,105200399,6821,[LV21]Lords of Valinor
188432088,BandAid,17390820,7892936,376129,37544,89296,147014,594450,58714,927018,653164,0,3179279712,308659606,8913,[LG21]Lords of Gondor
190852683,BossAlien FARM,17366773,7057040,168409,19244,81805,135783,634645,0,871477,634645,0,4392486685,1694123182,2737,[LR21]Lords of Rohan
188368666,Derik 災,17193465,17311218,78795,189202,156137,96806,1633226,12081,2087452,1645307,0,1504456225,57910439,4670,-
188823442,VIP shooter,17446598,5054115,1194558,132688,41914,75500,425083,19546,694731,444629,0,1710368501,41800001,5629,[LG21]Lords of Gondor
189181702,222mb222,17061539,2096107,769471,199359,63662,40288,176776,0,480085,176776,0,3284232404,225401626,1791,[LR21]Lords of Rohan
188585266,メDragønメ,17046256,6200803,260935,13008,75292,24207,548489,23295,684291,571784,0,1565973095,73489482,19339,-
188503741,SİYAH KAZ,16994656,2745204,35926,148261,185391,246920,121345,7182,709099,128527,0,1557000457,38351774,6878,-
188928573,Thànhteo,16834657,1269484,231737,5214,47138,152454,56435,0,261241,56435,0,1518718910,0,3090,[21M]Immortal Myrmidons
188894198,Tomioka senpai,16794389,379272,52185,4153,47557,61967,3546,0,117223,3546,0,2683655647,0,1830,[21If]Immortal Falcons
190329472,F1Quang,16790663,14222941,1403680,76015,288128,303523,1225945,7897,1901508,1233842,0,4158461137,3052986272,8547,[LV21]Lords of Valinor
188845980,Azadi,16787704,2422486,592181,297941,476307,105066,99002,0,978316,99002,0,1866087325,3366983,1072,[I-am]RoyalLoyalMembers
188824641,Sabesaur312,16783039,178017,72,61605,21023,10955,7983,0,101566,7983,0,717328751,0,1962,[LR21]Lords of Rohan
188513738,MooSáke,16499305,198927,96089,15385,14235,12870,11590,0,54080,11590,0,1845573291,0,1223,[RC21]ROYAL CROWN
188857667,Apoathou,16330337,1322660,1124764,128214,19733,13903,120194,0,282044,120194,0,230139173,156690,1102,[LG21]Lords of Gondor
188825002,Namiq Cebrayilo,16275081,3934535,1259596,213707,290110,151386,270603,0,925806,270603,0,2400310636,0,860,[LG21]Lords of Gondor
188868206,Quocbao05032012,16261940,2261620,1027424,140343,12908,5049,202922,7916,369138,210838,0,1874266321,23500000,2348,[LV21]Lords of Valinor
188852196,DarkExecutioner,16177458,1452447,100617,60616,84044,164244,61526,0,370430,61526,0,1216662089,28060602,1834,[TFS:]The Forsaken Souls
186035363,Klgi20,16118189,1079100,1084576,54111,135908,7883,18115,29189,245206,47304,0,1968683662,1200000,3153,[21If]Immortal Falcons
188436016,KiLLedYouhaha,16078419,14839620,395201,202920,240910,231094,1226294,56495,1957713,1282789,0,2773111760,135055118,10496,[LG21]Lords of Gondor
187880560,wcwc,16017764,230115722,1527635,19485000,18674475,23053443,9591814,36893,70841625,9628707,0,3214040764,596448438,13547,[21if]farm 21If
188376429,ᴵᶜmySoul,15863805,447638,94861,165290,199177,4054,1,0,368522,1,0,1317663453,7488905,8469,[LR21]Lords of Rohan
188134384,ˢ carlossainz,15807684,6601011,1300774,21788,65922,52235,498539,63524,702008,562063,0,1190118090,25406959,4010,[LG21]Lords of Gondor
188879219,Akglate,15799360,247677,40137,19567,121882,0,0,0,141449,0,0,2089034078,1758755,595,[LR21]Lords of Rohan
188861925,blackbandito,15691243,4398886,914142,181283,407143,143151,209878,43848,985303,253726,0,1606066987,24105565,2061,[LG21]Lords of Gondor
188878343,Cheiron City,15657263,2006372,65708,76640,299335,127026,88427,0,591428,88427,0,1400727548,0,1675,[21if]farm 21If
188877463,Se Tuath De,15494250,1904865,811661,93157,158781,182383,83914,0,518235,83914,0,2602744611,5600000,2473,[LG21]Lords of Gondor
188856535,HOIANA,15452124,1190153,693357,435295,160981,54643,43890,6183,700992,50073,0,1905651328,400000,1216,[21if]farm 21If
188825941,S0SKA,15447745,1189854,237525,181770,115056,123932,42766,0,463524,42766,0,1573181792,17191302,2471,[21M]Immortal Myrmidons
150775231,Lind21,15387821,7690885,484858,498285,954081,721214,266273,6774,2446627,273047,0,1823420717,3048989,2494,-
188785649,priam,15311430,1750608,803133,48303,27617,11291,164055,0,251266,164055,0,1517600451,18007168,330,[tgqm1]amarl
187560016,Kyubi Farm1,15287808,43705703,1159458,1634869,1976614,1528733,3277221,26918,8444355,3304139,0,1368128306,409430369,6785,[LG21]Lords of Gondor
188809474,Edgar15,15275743,46285,13168,43659,11087,2650,478,0,57874,478,0,2116886110,0,1245,[21M]Immortal Myrmidons
188858878,lisabella,15225344,237752,277117,67710,112105,0,0,0,179815,0,0,594777036,0,1635,[21M]Immortal Myrmidons
188781490,Fra1d,15149062,1187031,100258,39857,116341,94712,56753,0,307663,56753,0,1220961083,5509155,3143,[LG21]Lords of Gondor
188863496,dark8582,15135834,408222,113485,9062,63839,37988,12678,0,123567,12678,0,1938306881,0,722,[jk10]jk 3621
189036275,TheBlackDragon,15092617,163506,24134,22964,32186,14353,3713,0,73216,3713,0,2077608897,0,1785,[LG21]Lords of Gondor
188931757,ᴸʳANTHRAX,15066189,659165,84307,164935,187652,32931,11915,0,397433,11915,0,1451773221,0,2121,[LR21]Lords of Rohan
12113325,Elena23EV,15024336,1817847,131418,8455,10921,55191,154067,1644,230278,155711,0,1164219491,24431024,5801,[LG21]Lords of Gondor
188800436,LilPiglet,14965868,769658,220953,34240,152043,47076,27042,0,260401,27042,0,1378299306,0,1296,[LR21]Lords of Rohan
188986083,KyoHN,14890108,58505,16806,10125,15173,711,2329,0,28338,2329,0,2366189510,69,2869,[LG21]Lords of Gondor
123456386,Igoryan,14882041,5618050,200188,1355432,223318,152292,413566,7775,2152383,421341,0,1550331753,11392165,1447,[LG21]Lords of Gondor
188365295,ᴿᵃTsumiki,14849316,2089406,0,8924,38778,19749,193107,0,260558,193107,0,1063300942,3762398,6032,-
188832666,ChifOJ,14771210,2361104,125471,94442,41533,55215,203829,0,395019,203829,0,2738216943,0,563,[21IR] Corral
188806889,Gouverneur188806889,14766308,785370,316714,61610,182543,80923,8427,0,333503,8427,0,1121412641,0,1024,[21MS]Myrmidons Farm
188902184,The Lost Legend,14751531,7058172,203577,72451,84459,10146,662590,10414,840060,673004,0,1204480667,0,6696,[LR21]Lords of Rohan
188847086,Dimiboy,14745465,75311,0,179,37638,0,0,0,37817,0,0,1294061688,0,38,[Tick]Tick tack
186073361,卂尺丂Farm,14731628,4138657,585035,39537,204145,32135,344752,7320,627889,352072,0,2286157342,489706596,1516,[LG21]Lords of Gondor
183848200,Ei Farm,14731064,38195393,1298931,2526718,1320489,1044558,2973860,56612,7922237,3030472,0,3111047090,519374881,13486,[LG21]Lords of Gondor
188802524,Yamato68,14724102,193221,131028,1699,7453,9839,13862,0,32853,13862,0,1224230305,13257436,2993,[LG21]Lords of Gondor
188796842,Menda2137,14676733,321687,136804,21106,48638,8855,18477,0,97076,18477,0,1124131552,0,1481,[LR21]Lords of Rohan
188873290,FarmЛиса,14638920,7179904,597081,64191,23711,6956,681376,13903,790137,695279,0,1569437618,122800001,4255,[LG21]Lords of Gondor
188858305,Palestine313,14465426,3028033,1334422,129577,527939,188640,119168,0,965324,119168,0,1426148826,0,4,[Alg]Palestine313
188287771,ᅟᅠᅠᅠᅠᅟᅠᅠᅠᅠ ᅟᅠᅠ,14281715,55673152,491916,382510,936262,319444,5244635,0,6882851,5244635,0,5110586744,2480968833,29023,[LG21]Lords of Gondor
191177358,RtthyrFarm,14221799,52258,8925,14892,0,0,4928,0,19820,4928,0,3811514663,1594265331,1194,[LG21]Lords of Gondor
188787790,You  andl,14224597,920284,416012,51124,134014,82128,31352,0,298618,31352,0,1451815000,4084888,1992,[LR21]Lords of Rohan
187078010,Dr4gonsFarmerツ,14203216,22559848,1325648,750694,1825252,1256244,1371139,1142,5204471,1372281,0,2607439845,1725005764,7900,[LR21]Lords of Rohan
170835406,ᴵᶜ Has,14079533,1445859,679890,46009,32626,7559,101847,16135,204176,117982,0,687055286,298517,2942,[P21J]PETANI IDAMAN
188896546,БорисBao,13996762,1182765,168254,14668,118405,170863,25957,0,329893,25957,0,1761224189,22966398,1424,[LR21]Lords of Rohan
188953179,SarahVinyard017,13861065,5795264,260817,103502,87804,304494,438098,0,933898,438098,0,1396194714,31860199,3845,[LG21]Lords of Gondor
188899884,hanaaaa230,13804936,3656113,993138,112016,538707,284659,141766,0,1077148,141766,0,1610586089,3785937,1129,[K~R~]3621 Utility Box
188837379,안정아남자,13689628,885792,199719,262430,137821,8581,52334,0,461166,52334,0,1961921472,0,1158,[LG21]Lords of Gondor
190539451,puyolF,13555073,972686,309560,2673,66571,105265,41795,0,216304,41795,0,4987761682,1818372170,2188,[LR21]Lords of Rohan
44936497,젝스킹,15991483,6996924,923387,39204,54846,41378,523118,74135,732681,597253,0,2183506756,0,9052,-
188527602,ᴵᴰROK 쵸 F2P,13501305,5484083,995214,421857,345578,97039,416904,7568,1288946,424472,0,1569741955,727650,10325,[P21J]PETANI IDAMAN
187795145,SOTER,13478732,8447735,539910,529189,65018,309343,652149,22650,1578349,674799,0,1286481653,112215799,15330,[LG21]Lords of Gondor
191069538,Shinnygamyy,13280650,3037148,499817,235031,755080,228183,56725,0,1275019,56725,0,1083252012,5089962,691,-
193596249,Korkusuz 51,13257437,239160,358859,12402,0,0,23668,0,36070,23668,0,1407021399,60357336,945,[LR21]Lords of Rohan
187257305,HolySpirits,13242258,4186335,271743,116035,83670,59317,375642,105,634769,375747,0,1170651113,477259605,5805,[21If]Immortal Falcons
188836866,zlucifer,13134321,2684582,271491,220751,328964,145856,139908,0,835479,139908,0,1701695970,0,1524,-
188845348,ᴸʳLUNICTUS,13113523,104914,26926,6884,16888,8978,3385,0,36135,3385,0,1592347434,0,463,[LR21]Lords of Rohan
185484265,Tors228,13083005,7740094,636018,1305674,1878812,627539,120762,178,3932965,120940,0,1312958755,25325363,7376,-
188887466,Jensamtresen,13063481,2851467,834974,287219,392239,254799,99035,0,1033292,99035,0,902855175,10799999,844,[I-am]RoyalLoyalMembers
192581999,LilitЛиса,12917731,4564287,2586,4079,12074,27936,442758,0,486847,442758,0,2179491744,534525710,3697,[LR21]Lords of Rohan
188817273,Munmon,12901737,1116310,211912,39551,42589,125343,52185,0,259668,52185,0,2476678488,0,125,-
188292201,쵸Bear,12762411,3636617,863462,127956,652623,13205,183272,21012,998068,204284,0,1398516677,0,8400,-
189266244,KingHenry8,12732811,2424921,681640,338989,350984,104124,70352,26757,891206,97109,0,247088987,11642489,7444,-
187384799,C H A D 3 3 3,12698855,5025006,638494,336794,550030,58137,356220,3142,1304323,359362,0,987547634,0,4564,[LG21]Lords of Gondor
185259121,Lets go Os,12646784,913938,1168728,282,16846,7330,13445,35821,73724,49266,0,1397689907,4800000,1601,[LG21]Lords of Gondor
190430624,IMPERADOR FARM,12587919,449281,436505,3716,0,322,44725,0,48763,44725,0,5239860993,2527734725,1672,[LR21]Lords of Rohan
188816893,WARRIOR FARM 10,12444018,242793,17769,22009,47558,10254,10226,0,90047,10226,0,1323090834,0,1899,[21If]Immortal Falcons
188986347,Pimpammm,12386241,390745,21517,13926,70135,29655,12907,0,126623,12907,0,1444868924,9172286,4485,[OP1]OP CLAN
142371438,NokedliF11,12328082,3005981,754566,516818,830716,67154,61715,17771,1494174,79486,0,1498984833,2400001,10466,[21M]Immortal Myrmidons
174523518,ㅡᅟᅟF2P 5      ㅡ,12318620,4068578,375472,858694,1490716,123637,42086,0,2515133,42086,0,2305341745,968382628,2434,[LG21]Lords of Gondor
188819203,Cominogr,12296003,347521,71452,268238,123679,11074,222,0,403213,222,0,1758323937,0,850,[ANTB]ANnti Banned Club
187155907,Yuzhi,12197785,5032590,1641848,115533,189407,294655,290433,27386,917414,317819,0,2127575784,257605,2059,[LR21]Lords of Rohan
188818957,alonsoisma,12189981,2300239,762386,25316,47973,75270,189815,0,338374,189815,0,1679629489,14826393,1480,-
188829162,Mkジinsane,12152527,911799,856240,15867,56941,24326,65024,2360,164518,67384,0,1543783586,1400000,3486,[LR21]Lords of Rohan
189182502,ᴵᶜVatson67F,12108009,137197,213594,1669,4693,617,12501,0,19480,12501,0,3738397266,1724148322,1661,[LR21]Lords of Rohan
188880051,qftydhunvfezbjj,12100235,18338939,1337013,1249255,1030656,1111224,1086802,35743,4513680,1122545,0,1422326310,88951930,7822,-
188900034,Rajpoots,12084165,854381,223016,55556,81433,13291,62724,0,213004,62724,0,1911549835,0,3127,[LG21]Lords of Gondor
188838338,boble 79,12081618,306757,46338,1697,52760,41937,3315,0,99709,3315,0,1312385670,0,2122,[21MA]Myrmidons Academy
188479340,ㅡᅟᅟF2P 8      ㅡ,12047136,9974813,173571,883535,766581,262971,721306,0,2634393,721306,0,2786226921,1152471741,8860,[LG21]Lords of Gondor
188900167,Charles grand 3,11996337,4207791,779277,591939,722430,168606,197012,0,1679987,197012,0,1872695074,8400000,923,[Tick]Tick tack
188217778,ᴵᴰKing Nemo,11974922,1852509,716667,684238,272077,322,117022,0,1073659,117022,0,1857331281,0,12936,-
188952266,ErDegui,11875134,7108681,230822,125436,58773,125367,620570,12944,943090,633514,0,1173596936,13045768,5398,[LG21]Lords of Gondor
188818543,GodAnubis,11847706,3265470,842158,347813,333503,280538,140675,0,1102529,140675,0,1307141774,473118,765,[21IR] Corral
184327666,ツاحمدᴰᴮ,11811512,4138118,723713,681132,488185,101508,201653,30148,1502626,231801,0,1476405409,72130,2823,[LV21]Lords of Valinor
188320795,Fïshböy F1,11740199,1130852,410313,146172,398,5918,103727,1994,258209,105721,0,1648346901,1099174673,1195,[LR21]Lords of Rohan
185877603,ㄴ Aurelio ㄱ,11688621,4548524,845202,194294,519109,20317,314930,12044,1060694,326974,0,949340477,1758080,3933,[LV21]Lords of Valinor
188887462,Dunks,11620870,1538565,760926,36818,198678,122594,64347,0,422437,64347,0,1107672787,0,1042,[LR21]Lords of Rohan
189182788,Vatson67f3,11549033,260412,485136,2684,4031,13106,19939,0,39760,19939,0,3739679531,1133268751,1415,[LR21]Lords of Rohan
188840730,FurkiTolki,11519827,1839593,1140153,3217,12856,72657,143339,4461,236530,147800,0,1745046024,3600000,2069,[21M]Immortal Myrmidons
188892262,Udi lopez,11500275,286475,30519,120358,27289,7419,17815,0,172881,17815,0,262310618,3001045,1867,[LR21]Lords of Rohan
188363322,쵸Belmont,11471499,726781,18931,225245,250029,43961,583,0,519818,583,0,1185584888,1410552,11058,-
188839518,Zaragoza,11426083,1181120,88062,120100,376712,100919,0,0,597731,0,0,1469823358,0,1201,[LR21]Lords of Rohan
188885079,ᴵᶜnoobhuhu,11287294,4932153,869902,263679,640053,58918,316980,9692,1289322,326672,0,1694858992,26599999,5002,-
188856725,Uranusuki,11234777,739219,179818,30178,67401,53658,38375,0,189612,38375,0,979430270,3859996,859,[LR21]Lords of Rohan
188300029,Hoàng Saa,11132235,5223157,463048,87026,120041,301165,368511,3795,880538,372306,0,1453450698,9873378,8258,[LR21]Lords of Rohan
188817859,oktaev,11035516,401425,359467,33669,31021,2770,32157,0,99617,32157,0,1127233643,0,100,[DD21])Dragon of Death
189443468,Hubey,10948714,2171604,462536,189562,257421,35910,147521,0,630414,147521,0,918945909,0,1967,-
195403312,môngcổ,10885591,1446809,783623,85946,65345,87040,95077,0,333408,95077,0,1342215202,0,1116,[LG21]Lords of Gondor
189007908,vua đại du,10847143,2010095,594035,32817,68882,36737,135324,18279,292039,153603,0,1664459657,27506603,6095,-
188309795,ᴵᶜ TAZIEX,10844048,8618161,951227,435439,559362,399095,559725,10936,1964557,570661,0,1632163083,0,8839,-
188881481,678907,10831837,4056171,576543,576728,812285,378314,80300,0,1847627,80300,0,1361517063,53227,1552,[LLA]Lost legion academia
189227933,Z  Hot Rain  Z,10762707,6460378,866429,52143,3457,47844,612586,6290,722320,618876,0,1457174944,13707113,1796,-
188847841,Lj1208,10756025,314850,314434,984,0,1961,30681,0,33626,30681,0,1181089928,0,911,[21If]Immortal Falcons
117517315,ᴵᶜBOTAN,10684766,13712356,945529,506093,1444925,965222,611992,37024,3565256,649016,0,1235813199,498018246,20006,-
189285062,Linh farm 2,10593401,9739359,1413236,1086939,10938,8479,938116,4251,2048723,942367,0,5642089005,3128768761,1846,[LR21]Lords of Rohan
189442766,https://drive.google.com/drive/folders/1JCxprQkZ5NmMgRhhwMCD750A4awFYpkX,10521874,77204,41779,1313,9937,12737,612,0,24599,612,0,2705012836,2557049413,737,[21IR] Corral
188889920,Carolk,10460576,642390,541227,49383,96269,35954,29616,0,211222,29616,0,1177677764,1349311,322,[fagr]alpha table
194265891,쵸MØTÃSÊMツ쵸 2,10444148,2387465,0,5126,24684,21098,225268,0,276176,225268,0,1541026724,125453620,1415,[LG21]Lords of Gondor
188899095,Minuz,10422846,1614469,364375,167345,306671,102167,55899,0,632082,55899,0,741211492,0,1715,[LR21]Lords of Rohan
188522411,Ваn,10346788,1095208,3365,36724,120447,26500,74097,0,257768,74097,0,727419882,1,2219,[21If]Immortal Falcons
188790900,Dom Daddy,10275635,3388766,1222043,27914,83403,91562,276497,4258,483634,280755,0,1845695310,0,1465,[OP1]OP CLAN
188840453,La pampara,10212877,4378816,1599817,200050,433845,478194,131470,12182,1255741,143652,0,1517975930,0,354,[21if]farm 21If
188295840,ッ Yakuza ッ 6,10205094,395204,0,3871,70818,40591,9043,0,124323,9043,0,992758872,82882904,4860,[21if]farm 21If
188906315,ᴵᶜИвaн,10194251,1248369,45240,148765,274837,58418,43527,0,525547,43527,0,943901017,16348226,12804,-
188846435,psilva3,10154830,1390439,255473,331056,379662,122656,7428,0,840802,7428,0,988873999,0,592,[21IR] Corral
188721766,ᴵᶜZver225,10146168,5600948,578427,272790,772945,368830,252518,0,1667083,252518,0,1282562432,205403656,7602,[LG21]Lords of Gondor
188857096,Di 1,10019335,909985,10470,103819,160058,85834,22577,0,372288,22577,0,934774982,1843151,2952,-
189869613,Алёнааа,9938209,3146615,691598,31047,82951,360086,153416,0,627500,153416,0,1486595043,503089664,1097,[GW21]GOATED WARRIORS
188844276,tori,9904403,213019,54967,3007,1985,1182,20372,0,26546,20372,0,496064737,0,918,[21If]Immortal Falcons
186065635,MASONFTW WOOD,9880524,1910931,810165,6189,9403,5772,186780,0,208144,186780,0,1759704876,950725213,1310,[LR21]Lords of Rohan
188471943,NoCoboY,9816138,413116,95171,64153,54918,15880,22693,0,157644,22693,0,1081418218,0,3619,[LG21]Lords of Gondor
191785327,ᴿᵃQueen,9625702,3017237,247312,228656,300820,10824,232657,0,772957,232657,0,2123392947,813781963,1187,[LR21]Lords of Rohan
186988267,Panda ᴸᴺ,9616784,2766515,1120377,7927,2980,11995,264463,3318,290683,267781,0,3082740466,512115698,1981,-
188962647,卂几Ҝ卂2,9578262,2082291,325396,3405,6149,30163,194866,0,234583,194866,0,1618176948,1219440595,2004,[LR21]Lords of Rohan
102296637,赎回ALFARM7,9565859,110313,44928,41298,16032,8990,3403,0,69723,3403,0,2258439831,0,1157,[LR21]Lords of Rohan
189238085,Christian33,9560477,471496,125768,75854,103315,62424,0,0,241593,0,0,729291551,0,1593,[21LK]legionary knight
188462426,Tysson,9512419,1483696,191746,163161,372581,171003,2189,0,708934,2189,0,647738981,310,4388,[21MA]Myrmidons Academy
191952770,Linh farm 1,9488614,721373,1408465,143385,98,0,46304,11473,201260,57777,0,4488727293,2631887494,1331,[LR21]Lords of Rohan
188308863,Rock Farm ll,9385339,10088421,459789,450027,1066779,575927,546551,4782,2644066,551333,0,737133728,45352280,6170,-
188837166,Gabrielpc321,9377517,287603,217282,104089,12819,38762,8610,0,164280,8610,0,1068363886,50000,959,[P21J]PETANI IDAMAN
188560833,Gorgona,9371349,1635913,58059,135968,120817,4039,135093,0,395917,135093,0,379010693,1749999,1348,[LR21]Lords of Rohan
105186699,Musti 13,9364627,647045,252843,43047,75095,24684,38951,0,181777,38951,0,1101186393,2316986,969,[21M]Immortal Myrmidons
188826743,Bawan,9351919,5717997,741752,222676,337891,258795,395448,401,1215211,395849,0,1021778510,18693042,3279,[K~R~]3621 Utility Box
188842001,lonepsy1,9289419,660628,140560,8104,29928,25543,48810,444,112829,49254,0,1039448442,0,741,[K~R~]3621 Utility Box
99995740,Den Sama,9279960,3818653,761156,227066,81007,194524,283313,0,785910,283313,0,3917032777,1934258745,1355,[21if]farm 21If
188850362,Facebook 12,9251040,537166,690184,22153,2494,14447,46996,0,86090,46996,0,834585053,39940354,917,[21lf]GanjaMafja
188762934,PRADESTA  A21,9217039,2095728,664006,8683,13932,21492,198016,0,242123,198016,0,2324533934,1789799718,6115,[21IR] Corral
