ID,Name,Power,Killpoints,Deads,T1 Kills,T2 Kills,T3 Kills,T4 Kills,T5 Kills,Total Kills,T45 Kills,Ranged,Rss Gathered,Rss Assistance,Helps,Alliance
179940560,ᴸᵛ k,102059932,600653439,4051526,1927675,868211,971623,34312155,12576172,50655836,46888327,0,6028086411,1873979817,80737,[LV21]Lords of Valinor
186145908,ʳᵉʸEscanor,85857991,1484943852,3712561,4231714,915441,1734412,123477340,12027779,142386686,135505119,0,3523998076,4398233340,22214,[21IR] Corral
188540500,TakeMe2Valhalla,84389450,1443874189,5160258,12511616,5652155,10639829,106631956,16059434,151494990,122691390,0,2834278325,7061247251,44591,[LV21]Lords of Valinor
180304933,LilLƴ,79797034,303901731,3361470,2381705,2764385,3236435,16610392,5942348,30935265,22552740,0,1159682654,4810554697,21942,[LV21]Lords of Valinor
188858506,Cúchulainn 쵸,75718359,232315096,1945923,640333,273416,425482,20813283,1090272,23242786,21903555,0,4969525880,512651627,36946,[LV21]Lords of Valinor
179655012,ᴸᵛDØØPER,75442821,519898586,2428454,1563621,972191,1254625,32906110,9178094,45874641,42084204,0,8399544061,1451282008,37682,[LV21]Lords of Valinor
178695066,SokoDrake,65732418,109725216,2739209,966390,105667,147411,7880738,1496179,10596385,9376917,0,7769731162,115903540,17352,[LV21]Lords of Valinor
180560115,TripEhh,62899754,382282505,1420469,2306786,813884,294450,23200346,7350606,33966072,30550952,0,6625300953,1225250480,11298,[LV21]Lords of Valinor
184964288,ᴾᴿFïshböy,61560069,264761228,2100314,2053474,4656295,3958131,20360572,1779985,32808457,22140557,0,3441057520,632742525,38293,[LV21]Lords of Valinor
186009654,Dooby ᴼᴺᴱ,59351156,273725160,699771,2071412,347817,487446,24898012,1084267,28888954,25982279,0,7414293065,137216122,35062,[LV21]Lords of Valinor
179977300,ᴸᵛTmulla,58998620,706340036,1793011,3604233,417684,1492228,38302109,15789691,59605945,54091800,0,6968070360,5480679937,17611,[LV21]Lords of Valinor
188839265,A 10 Warthog,57292337,12330470,230642,42253,74269,128873,999555,83122,1328072,1082677,0,3647771217,724780894,10790,[LV21]Lords of Valinor
188341936,ᴸᵛ Vatson67,55590010,252819598,1694949,1326311,557828,595665,21732056,1586773,25798633,23318829,0,6422070263,384720155,41750,[LV21]Lords of Valinor
188918989,ᴼᴸ Kaymo,53903372,124457280,1092879,2484352,1386449,2529103,10237668,434721,17072293,10672389,0,3755290391,1075163587,41392,[LV21]Lords of Valinor
178814644,ᵁʷᵘØtòt,53740295,444858744,3140400,18550973,3385819,2356133,31505688,5494775,61293388,37000463,0,2295222519,2329433716,15824,[LV21]Lords of Valinor
182514982,ᴸoᵛeSalmon,52617700,353767850,2943056,17662522,652736,737766,24251385,5173248,48477657,29424633,0,5474784573,1000488180,52154,[LV21]Lords of Valinor
186985518,HornyAPOLLOS,51020562,219365473,1392636,2661668,1512782,3176209,18442132,934071,26726862,19376203,0,2756179135,594947984,17907,[LV21]Lords of Valinor
184871937,ScazBigLion,49834965,1182419709,4228467,55772928,23109731,25359243,91345407,5507731,201095040,96853138,0,5923543674,13584268108,20789,[LV21]Lords of Valinor
185836736,ᴸᵛMasonFTW,49888525,464793648,2373654,5692324,2208085,4769431,38140961,2937584,53748385,41078545,0,3356207047,2802859223,28589,[LV21]Lords of Valinor
180060983,ᴸᵛRumRamsey,48248445,356649912,2206322,95097211,5048028,991336,26279725,3038591,130454891,29318316,0,6014287328,417518493,92739,[LV21]Lords of Valinor
181825355,ᴸoᵛePUMA,47572004,202308128,1285356,1372191,349354,531778,14511953,2704417,19469693,17216370,0,3290245647,3599759382,34886,[LV21]Lords of Valinor
142628224,Dae jang goon,46790033,156089727,2387504,1879815,714624,367829,12585382,1347969,16895619,13933351,0,4863860524,102794418,16676,[LV21]Lords of Valinor
181308342,ᴸᵛRockSolid,46402401,184141552,2661440,2670453,708517,1391557,12276234,2693093,19739854,14969327,0,3441554497,5592949920,40063,[LV21]Lords of Valinor
185808036,Ze Bosh,45657049,324557669,903869,8598579,2626646,3862918,28938009,637645,44663797,29575654,0,5524831742,631820319,29935,[LV21]Lords of Valinor
176994964,Cpl Rage,45626919,113923698,476638,2377013,1506916,2122761,8910414,641964,15559068,9552378,0,1889864540,63265830,17061,[LV21]Lords of Valinor
188920797,FreyaFullBosom,45010200,84426203,1751730,1735115,953550,1147280,6793166,482565,11111676,7275731,0,3509340222,1323334617,23968,[LV21]Lords of Valinor
179750493,GuiltyMahiru,44635178,146888450,961841,2864153,770432,1180564,12601410,701920,18118479,13303330,0,1474956832,1955360302,39666,[LV21]Lords of Valinor
184826667,ᴸᵛAHERUS勇,43043968,513387691,1416939,12789309,5927578,11125761,44110291,668436,74621375,44778727,0,5785532039,1396853955,24847,[LV21]Lords of Valinor
188241812,Gilgamesh2323,42040862,86712357,775600,2466419,200187,260810,7815198,331174,11073788,8146372,0,5024843232,62620586,24374,[LV21]Lords of Valinor
179813923,ㄴ Bless ㄱ,42022194,233915565,2185386,7739298,5947505,5144214,18676464,656560,38164041,19333024,0,2428973631,978016636,23343,[LV21]Lords of Valinor
187247613,Sith Padmé,41870727,188798018,2807913,3954013,2992217,3977513,15068585,771344,26763672,15839929,0,7552787725,4488542203,85607,[LV21]Lords of Valinor
181739549,kylinn,41829522,97526701,3321903,2389177,278410,278364,6880327,1328766,11155044,8209093,0,5128390117,10337862643,31310,[SFIS]Sky Fighters
182423962,シValkyrieCillaﾒ,41721373,115810413,1858806,5641345,822285,707431,8897411,1061687,17130159,9959098,0,5088010692,1265202822,15023,[LV21]Lords of Valinor
185690465,Dictator  Goat,41561943,350310517,2053726,6070059,2159337,1277583,31857908,1054421,42419308,32912329,0,6008029681,1005155698,34837,[LV21]Lords of Valinor
188976136,ᴸᵛ MUSE,41182120,93617728,1180704,2079562,2348512,921788,7202786,639489,13192137,7842275,0,5130079796,365719425,47431,[LV21]Lords of Valinor
188969478,ᴰᴹMePaul,40343304,87978111,983206,1953068,3290337,2573561,6140862,465198,14423026,6606060,0,3624282057,278578838,3488,[LV21]Lords of Valinor
188785515,Johnvin,40155032,160829221,1650691,715818,465371,1071559,13895854,825527,16974129,14721381,0,4923810772,93446315,56462,[LV21]Lords of Valinor
188483360,ᴼᴸTryxan,39743683,192148553,1209317,4297405,2837205,2706913,15307291,1085705,26234519,16392996,0,5997488818,2169436768,40065,[LV21]Lords of Valinor
187423027,ᴸᴳPandaFr3d,39314241,177505168,2048263,1957321,791324,914974,13931704,1627706,19223029,15559410,0,2821382574,6820681844,26145,[LV21]Lords of Valinor
188485523,ᴸᵛIMPERADOR,38934186,181145370,1007660,550634,31074,81329,14907446,1578666,17149149,16486112,0,6161284503,201752989,36188,[LV21]Lords of Valinor
188882878,Rtthyr,38802062,90592660,821470,226570,104672,116963,7788833,599091,8836129,8387924,0,7280872114,93046400,19041,[LV21]Lords of Valinor
186199010,Daphneᴵᴿ,38395093,195627401,1700526,1583135,1269505,3330126,14973114,1486006,22641886,16459120,0,4137140386,1458857670,54749,[LV21]Lords of Valinor
185282531,Jëster,38215377,45496988,2695521,469962,132883,175975,4001273,221030,5001123,4222303,0,3451908286,592793562,26211,[LV21]Lords of Valinor
185457048,Cman9918,38168505,133602129,1160939,3704156,1184975,873737,11641776,528932,17933576,12170708,0,1996001700,126071365,16767,[LV21]Lords of Valinor
180368631,ᴸᵛWinfields,37465621,163193246,4670313,23224272,189123,611409,11969161,1801645,37795610,13770806,0,5160139500,1877834074,13527,[LV21]Lords of Valinor
179816952,Hell CAT GTR,37145235,51640064,2888707,54839343,1765741,1889101,2279219,339606,61113010,2618825,0,5440662983,1636698071,10678,[LV21]Lords of Valinor
188651683,Sol Aliyaa,37140044,12362838,140221,119003,49805,35722,1144392,32631,1381553,1177023,0,3917360486,201676244,15436,[LV21]Lords of Valinor
188569749,ᴵᴾEndoloris,37018743,135932617,1872172,1390988,2616276,1563397,10769220,823804,17163685,11593024,0,1822151378,163440000,5369,-
187726069,ᵀᴿvSpryth,36799082,65857461,731133,1327439,163988,333442,5630975,381024,7836868,6011999,0,5405997620,15763287,22987,[LV21]Lords of Valinor
188880730,ᴸᵛMarlone,36733447,136564417,1911316,485878,371025,197873,11595534,948918,13599228,12544452,0,5863897697,136720000,44494,[LV21]Lords of Valinor
178213242,ᶦˢLOCOOZ,36492806,134570032,3696161,2103734,957035,1554554,7977964,2311868,14905155,10289832,0,4363502685,1274602396,21778,[LV21]Lords of Valinor
188648613,Känguruᴵᴰ,36373345,25517194,340067,377701,272323,171077,2089716,165777,3076594,2255493,0,2949769575,286935074,13490,[LV21]Lords of Valinor
189060019,Tušiš,36275371,75638259,775218,614426,635078,1036387,6532063,238952,9056906,6771015,0,2924849671,552362591,20055,[LV21]Lords of Valinor
188805469,BossAlienᴾᴴ,36232125,69701811,1217268,250538,604492,927660,5933562,269823,7986075,6203385,0,4950491205,134750966,39113,[LV21]Lords of Valinor
188303104,HokieHighlander,36165408,63194172,1291261,343691,109840,53066,5397791,435779,6340167,5833570,0,1052361096,84975248,13225,[LV21]Lords of Valinor
186444772,Dr4gonツ,36162264,257161971,2720408,5323835,3499917,3856115,22350757,508267,35538891,22859024,0,5320374606,4177255259,38378,[LV21]Lords of Valinor
189072394,ᴵᴾLaura,35943971,43788335,1312098,7341019,351297,767107,3351673,251619,12062715,3603292,0,6254427716,362529904,27126,[LV21]Lords of Valinor
185048534,Han Sansan,35807152,125169586,761566,790111,342096,539228,11238376,489335,13399146,11727711,0,6021601761,307367305,31346,[LV21]Lords of Valinor
182338045,亗ƧHiꟻT亗,35757827,134754048,1095353,2640524,1006449,1310254,8852061,1922571,15731859,10774632,0,5488933312,2515586970,32258,[LV21]Lords of Valinor
189065897,W3llsFargo,35599785,36866964,662685,1191313,898257,213767,3194692,101510,5599539,3296202,0,3852869848,2754424297,18901,[LV21]Lords of Valinor
188789133,MiniMe,35558290,36372777,339782,258586,224998,167551,3319890,100098,4071123,3419988,0,4904480583,34179151,11628,[LV21]Lords of Valinor
188276623,ᴸᵛArork,35541966,82930220,930236,7255610,1265703,1364258,6992642,178212,17056425,7170854,0,3736834804,360935366,16383,[LV21]Lords of Valinor
185341770,ᶜᵘRalfish,34859922,53425495,2488511,825738,380145,497142,3989001,531074,6223100,4520075,0,2670290902,25760000,15705,[LV21]Lords of Valinor
188333348,ᴷᴺLinh,34601852,67272369,935539,1886379,1645656,5139453,3771179,266709,12709376,4037888,0,4830287573,550111352,10979,[LV21]Lords of Valinor
185089489,ᴼᴾZOROGRANJ,34332185,89977952,1885507,550571,355159,737615,7809122,405792,9858259,8214914,0,5703855206,2083599610,21232,[LG21]Lords of Gondor
188794709,ᶦᵗˢᵘRYU,34185293,104597454,992902,1318150,2549412,2529700,8341254,285183,15023699,8626437,0,3593382287,94094214,35430,[LV21]Lords of Valinor
188969981,ᵸᵒWand0,34099800,65261424,1286067,2054730,706949,524275,5320812,406568,9013334,5727380,0,4272069255,306699275,22580,[LV21]Lords of Valinor
185986678,卂尺丂,33872574,84899689,1208549,680685,1395198,1286689,7029436,326602,10718610,7356038,0,3322048603,1193919485,14781,[LV21]Lords of Valinor
188336265,ᴸᵛiGREC,33730915,34239030,354919,533661,195122,279696,3003565,129381,4141425,3132946,0,2450337076,175934276,17206,[LV21]Lords of Valinor
188826595,Saf1974,33676289,99863191,1369711,1139686,553217,574540,8082822,770122,11120387,8852944,0,5092662162,230946040,48678,[LV21]Lords of Valinor
189017405,ᵸᵒWizzy,33610663,35797424,1128087,812593,975948,1093260,2708769,111114,5701684,2819883,0,2733458445,170159151,14258,[LV21]Lords of Valinor
189154415,ᵸᵒMDKMB,33169320,63642604,785334,2572471,865337,727479,4913768,467492,9546547,5381260,0,2105629945,2596649234,19891,[LV21]Lords of Valinor
182317160,G  O  P  A  Rr,33129845,162594766,1935903,3080902,2312668,2727770,13884185,380016,22385541,14264201,0,4090108130,738465485,27975,[LV21]Lords of Valinor
187029935,HolySpirit,32813490,128431757,1399813,1243036,1343710,1577860,11124753,396838,15686197,11521591,0,2699626296,1104079437,18381,[LV21]Lords of Valinor
182713036,쵸ﾒMØTÃSÊMツ쵸,32670372,20575342,613608,107410,237724,446943,1757268,35898,2585243,1793166,0,5015613201,123301386,20196,[LV21]Lords of Valinor
188970345,PitBlue,32603241,99685361,862627,1120668,1623539,1658595,8097575,430201,12930578,8527776,0,3977975657,1077393393,22789,[LV21]Lords of Valinor
188837916,Silent Kakashi,32547677,105876915,889638,839969,754922,750377,9809221,155268,12309757,9964489,0,1755328451,103761097,13986,[LV21]Lords of Valinor
190252265,Jamong,32502477,47889411,986556,240286,331111,224508,4124126,251992,5172023,4376118,0,5205589936,81003240,23435,[LV21]Lords of Valinor
188651684,Milo San,32413998,7275893,256838,5998,5637,18715,662498,28179,721027,690677,0,2948451699,359753808,11814,[LV21]Lords of Valinor
188362493,亗MrDuck ツ,32296586,53343903,1162431,14212609,2043574,1147191,3945647,118450,21467471,4064097,0,2797106102,909611190,16643,[LV21]Lords of Valinor
185037763,ᵛBEARDY,32277187,51437912,2227119,28222212,2319488,801981,2906415,444121,34694217,3350536,0,4921911553,554484409,19513,[LV21]Lords of Valinor
181534760,ᴸᵛSongoku,32207248,78402118,1418818,947363,718037,1206878,6729084,232911,9834273,6961995,0,3840746217,755945265,15807,[LV21]Lords of Valinor
185612447,Chaudary Zain,32143719,125803909,1411281,9001268,1590757,914083,10628415,544083,22678606,11172498,0,4461057919,1323892732,24950,[LV21]Lords of Valinor
188368264,funne,32053133,27814931,1265037,834275,642636,595616,2088506,154764,4315797,2243270,0,3739788186,61698120,16508,[LV21]Lords of Valinor
187559873,ｱ尺ﾉ丂ᄃﾉﾚﾚﾑ,31970796,62577567,524842,786256,540194,444292,5234590,360843,7366175,5595433,0,2629725287,626443180,15363,[LV21]Lords of Valinor
188501467,direraven,31949121,96864842,744306,5169512,2366933,2785371,6996177,499691,17817684,7495868,0,4806016421,4551820,26837,[LV21]Lords of Valinor
188833519,JulieLaTueuse쵸,31817567,24848444,592433,141152,346846,94148,2154069,110462,2846677,2264531,0,3551349811,37720000,19745,[LV21]Lords of Valinor
188544046,G4mine,31806617,26635738,854807,262602,631545,296942,2070874,171181,3433144,2242055,0,4317317823,247760315,20182,[LV21]Lords of Valinor
188352541,ᴾᴿ Mèoッ,31793914,127518876,1258710,7188100,1700314,1303642,10538936,603835,21334827,11142771,0,6143174121,0,14349,[LV21]Lords of Valinor
186765655,KönigsKlãsse,31054693,177840645,905087,2038416,1341151,1848800,14762950,986298,20977615,15749248,0,3547614721,407789115,7902,[LV21]Lords of Valinor
185724517,Feldgraŭ,31566284,145411334,1749110,439323,3849630,1436815,10990643,1098526,17814937,12089169,0,4251264117,178066760,33277,[LV21]Lords of Valinor
188335709,Rebel Rogue,31494959,72509497,813602,1040029,700124,771386,6222402,279584,9013525,6501986,0,3440753536,34205137,33634,[LR21]Lords of Rohan
186841127,Anossss,31240670,90851935,1389016,1260527,159842,119554,7935979,522107,9998009,8458086,0,4200013815,4253401,14447,[LV21]Lords of Valinor
188242643,hoahaizz,31158221,107616721,905191,3598169,968129,568030,8809761,729555,14673644,9539316,0,3710388608,567041937,29349,[LV21]Lords of Valinor
188451175,ᵸᵒTerra,30977145,54180034,870910,3422823,860914,534113,4577401,193159,9588410,4770560,0,4024917013,92432122,22278,[LV21]Lords of Valinor
189045190,Azura21,31062208,28813819,1079446,528436,682624,3020226,1479906,23146,5734338,1503052,0,2779150677,423984134,8054,[LV21]Lords of Valinor
188225231,ᴾᴿSko0p,31061188,32524184,356756,168570,89071,72567,3026488,87859,3444555,3114347,0,4545798280,0,27062,[LV21]Lords of Valinor
188736727,Alex9003,31057825,35883070,1660154,2964172,704741,765686,2469581,306110,7210290,2775691,0,4170772998,38138060,14243,[LV21]Lords of Valinor
188847278,ᴸᵛQuang,30277667,137755491,1193572,1205528,1434870,1289374,12117161,415777,16462710,12532938,0,4072219479,1610824614,33301,[LV21]Lords of Valinor
190407807,동탄불주먹,30237479,23742227,1056652,553576,330666,695585,1772008,123388,3475223,1895396,0,5296685827,433522789,15165,[LV21]Lords of Valinor
184882401,Ферма а,29920414,91459061,1732313,22831138,3000621,3316968,6225466,268453,35642646,6493919,0,2669728364,3538154179,17421,[LV21]Lords of Valinor
188836483,YenifferDeRivia,29910359,38806650,1193983,1783484,2318341,1691838,2651180,26706,8471549,2677886,0,3395185064,140738085,4873,[LR21]Lords of Rohan
188961098,Chocolalat,29769355,2573117,220977,51569,65233,15462,226397,5326,363987,231723,0,4140666250,21199999,3573,[LG21]Lords of Gondor
188598120,ᶻSharineko〤,29766499,70204073,828033,856059,1456432,800282,5340597,525645,8979015,5866242,0,2367615415,51185747,16107,[LV21]Lords of Valinor
188797972,21LuviVilu21,29718328,18427154,1165545,579952,518648,328487,1368852,113570,2909509,1482422,0,4316533660,34539709,15765,[LV21]Lords of Valinor
181581608,Fledermauz DB,29438461,32237433,694585,248895,300074,511759,2915789,19129,3995646,2934918,0,3577184021,377676127,7707,[LV21]Lords of Valinor
177013392,ᴸᵛ UCC15,29413011,39005363,2664930,1200338,936753,880990,2885533,225625,6129239,3111158,0,5316478367,192271545,16121,[LV21]Lords of Valinor
188316323,ᴸᵛ SAKURA,29396892,99136859,1378468,2351048,1068606,1856632,8525365,192463,13994114,8717828,0,4114889013,539454569,26369,[LV21]Lords of Valinor
188852900,Scorpionking乂,29300880,77703824,1873870,693170,535193,1654576,6630700,178475,9692114,6809175,0,2204058460,58256706,31722,[LV21]Lords of Valinor
188293704,ᴸᵛDrMusaab,29149257,41641126,1575242,191211,427716,173783,3574586,215323,4582619,3789909,0,3733422486,84578452,14388,[LV21]Lords of Valinor
185923730,JFDLCA,29128698,269931842,434687,5131053,3803977,6044357,22922445,394790,38296622,23317235,0,4704688720,386336005,36470,[LV21]Lords of Valinor
188262339,Kitty27,28994692,6681813,100178,54908,178359,33366,440995,88535,796163,529530,0,3741774107,23588840,10474,[LV21]Lords of Valinor
185651937,ᴳᵃʸGrizzy,28827761,394704092,1530202,11881112,5833583,11664631,32492852,453683,62325861,32946535,0,3744084354,952357579,20305,[LV21]Lords of Valinor
188789684,ᴿᵃtMadson,28625940,21289170,542169,1003633,121638,152532,1816666,103419,3197888,1920085,0,3875674791,72421016,40069,[LV21]Lords of Valinor
188543996,ᴸᴳﾒNØHOPEツ,28619023,21444332,721180,315022,75011,175524,1854561,99180,2519298,1953741,0,3385326125,31608954,11511,[LV21]Lords of Valinor
188853241,Алёнаа,28597597,24913509,741702,246727,344883,856812,1689341,192687,3330450,1882028,0,4479339253,45525540,12859,[LV21]Lords of Valinor
188364390,ᴸᵛLeonPoi,28446596,143752605,1305936,493535,399103,640818,12504200,762521,14800177,13266721,0,3739444247,108004980,36180,[LV21]Lords of Valinor
188819438,ᴸᴳLuca,28410513,46044144,573803,296542,432636,250296,4088058,161890,5229422,4249948,0,4219666986,286280200,24189,[LG21]Lords of Gondor
185282573,ᴸᵛ3621 BANK,28344977,62632106,771884,668111,1267167,649115,4855577,440596,7880566,5296173,0,1355169005,923285969,8656,[LV21]Lords of Valinor
188830020,ᴸᴳVersized,28311643,53599723,842032,600749,938250,417681,4387649,302793,6647122,4690442,0,3679447811,46055668,10327,[LV21]Lords of Valinor
186295211,ᶠˡVENDETTA,28301086,115576250,2742984,4081984,1084740,528626,9229579,909004,15833933,10138583,0,3885646386,1050356942,20048,[LV21]Lords of Valinor
188944242,Đạt Feet,28236869,19579018,699227,769072,733958,1500022,1053224,71248,4127524,1124472,0,4538967511,16457231,9010,[LV21]Lords of Valinor
186709522,ᴸᵛ SHERY,28204386,61761728,1562880,609853,401512,544566,5186391,339728,7082050,5526119,0,3407463504,99489407,9527,[LV21]Lords of Valinor
189001955,ᴸᵛTruNguyen,28192707,14720945,718506,375837,139163,226938,1198402,73784,2014124,1272186,0,4390144404,67678867,16232,[LV21]Lords of Valinor
182720562,ᶜᴹᵈSkyy,28092367,19752884,2388318,291902,77615,310791,1289299,270156,2239763,1559455,0,3999667646,685652689,12498,-
188785575,ᴵᶜ Cairo xx,27765720,22263445,718609,343839,319881,399109,1877180,59334,2999343,1936514,0,3313749039,8507066,17115,[LG21]Lords of Gondor
185538462,UMAYKIZ,27729019,78468756,1210994,2427602,751593,861735,6743305,280003,11064238,7023308,0,4058555649,8566632,6381,[LV21]Lords of Valinor
188788713,Sam smith,27728511,31515939,760222,583097,331614,179458,2740812,130507,3965488,2871319,0,3883909710,33958258,12515,[LV21]Lords of Valinor
188876886,ᴸᵛTheanh,27672524,118365974,1312305,418004,283931,571188,10851050,345963,12470136,11197013,0,5520382013,107966937,33742,[LV21]Lords of Valinor
186043643,卂几Ҝ卂,27252706,55474907,1172006,880728,299895,375673,4777248,271190,6604734,5048438,0,3283342554,501165307,29476,[LV21]Lords of Valinor
188880546,Graf000007,27127432,3908846,1602923,195112,206722,115320,259030,20240,796424,279270,0,3427389737,0,3973,[LG21]Lords of Gondor
188547640,Kitty8152,27044507,1630693,12032,78078,153637,150776,70470,0,452961,70470,0,6177187540,2547000,7548,[LG21]Lords of Gondor
188806334,Emrah 51,26971037,3751158,1312229,1012,10602,4008,371372,0,386994,371372,0,4126810750,0,4417,[LR21]Lords of Rohan
188294260,CЦEПИOH,26956093,10421111,1855157,581297,556310,288078,772954,15519,2214158,788473,0,2716905400,173206292,7519,[LG21]Lords of Gondor
188453555,Puyols,26899200,51940678,983819,408613,350807,193153,4463257,287608,5703438,4750865,0,6658472875,127173124,23768,[LV21]Lords of Valinor
185905587,Ze Boshman,26638325,3821207,404399,309125,97861,13805,316140,17352,754283,333492,0,2770839083,41584565,2619,-
188285810,ᴵᴰJupanu,26600561,46572577,1043044,864619,1573717,521185,3674114,221317,6854952,3895431,0,4721488544,57408174,19970,[LV21]Lords of Valinor
189040679,ㄴHORIZONㄱ,26471939,74776471,764075,947828,1035889,885967,6855262,20932,9745878,6876194,0,4541244792,188105599,14261,[LG21]Lords of Gondor
188364525,ᴵᴾEmrys II,26412458,3119874,218964,53070,30135,8285,294045,3770,389305,297815,0,2091717356,0,2715,-
188872694,DELİ ÜSTAD,26378921,5962066,716649,208561,290491,524323,257508,33350,1314233,290858,0,4199397674,39905983,2099,[LG21]Lords of Gondor
188319889,亗ChancellorT,26292095,19038322,395290,392020,290920,381817,1561679,61701,2688137,1623380,0,2876805661,1085215,13309,[LG21]Lords of Gondor
188877484,ᴵᵀBLOOM,26240463,73412319,1615750,429658,286070,678042,6496736,253736,8144242,6750472,0,1847010287,111895750,28933,[LV21]Lords of Valinor
188581465,ᴸᵛSpSmeagle,26107902,55758671,2639905,1264396,1093916,361345,4822736,182261,7724654,5004997,0,4086975508,150346971,19906,-
189141193,ᴸᵛJankels,26093603,51676659,819486,2368695,1924928,2323951,3591440,107143,10316157,3698583,0,3300444942,28726902,16066,[LV21]Lords of Valinor
188575943,BATUMSKİ08,25874131,121519003,2518476,8713459,9991171,6956425,6923451,136688,32721194,7060139,0,2774601887,529137921,20567,[LV21]Lords of Valinor
188192835,SвулканS,25823014,19939344,388225,2031363,306088,979874,1431780,34180,4783285,1465960,0,3359464979,52162299,9013,[LV21]Lords of Valinor
188793086,GANDAlF EL GRIS,25816572,6393451,180602,29227,83125,35629,549478,29203,726662,578681,0,2742675239,132716687,7283,[LG21]Lords of Gondor
189939798,ʰᵒDestructor,25791214,18469100,52616,21684,68111,82633,1799801,0,1972229,1799801,0,2812000237,11281500,851,[LG21]Lords of Gondor
188806124,ᴵᴾAltar,25682493,111614407,1481141,3177848,4192360,2583327,8685363,270359,18909257,8955722,0,2531022967,7742830,26734,[LG21]Lords of Gondor
188818127,ᴿᶝ风华,25589552,2158531,1064759,62955,74067,33164,157987,14264,342437,172251,0,4105296462,64472747,3825,[LG21]Lords of Gondor
188939030,TBILISI,25508137,7839528,1253222,516102,1297487,330601,372081,4906,2521177,376987,0,3008537929,460258,11644,[LG21]Lords of Gondor
188836051,Cheops Pyramide,25503978,68168874,1082769,644864,285017,461502,6166316,198035,7755734,6364351,0,4404490543,711419894,35821,[LV21]Lords of Valinor
188891048,7BeLa,25337382,57642914,872000,370252,777201,2820258,4394591,39376,8401678,4433967,0,3249200119,137794496,5868,[LG21]Lords of Gondor
188365363,diegokristy,25321237,42552399,464864,421018,640200,815724,3314350,239070,5430362,3553420,0,3724189269,246281206,15383,[LV21]Lords of Valinor
188835262,vinzsou,25227656,16189363,318641,46309,92071,38810,1462884,60594,1700668,1523478,0,2293899163,0,12866,[LV21]Lords of Valinor
188855274,GOLTEB,24940741,127088844,1327294,1219432,175391,426239,11664566,407178,13892806,12071744,0,3362014346,35237187,41677,[LV21]Lords of Valinor
188320476,ᴿᵃЛиса,24792749,33010708,1141689,367524,506339,542999,2686935,144159,4247956,2831094,0,4746989845,362428945,39342,[LV21]Lords of Valinor
146179581,lupepvp,24748633,11445255,602010,166315,115101,34970,951227,76482,1344095,1027709,0,5239842326,108915418,14721,[LV21]Lords of Valinor
188319008,ᴸᵛКэп21,24483757,10075514,29597,216150,128394,92909,914970,12708,1365131,927678,0,2233408969,0,10985,[LG21]Lords of Gondor
186010544,Mehmet027,24421548,55879312,1540749,1745924,1605817,1988711,4389253,23556,9753261,4412809,0,2969222976,173638054,8662,[LV21]Lords of Valinor
188324838,ХОНДА,24355553,7990779,1618420,319927,430706,215833,601619,9293,1577378,610912,0,2514329809,122738819,6012,[LR21]Lords of Rohan
84905552,Schwazzier,24283636,9986086,494014,147563,86882,62010,782287,85595,1164337,867882,0,3184466277,60672597,7859,[LV21]Lords of Valinor
188937309,Velikiy Govard,24048954,5370314,638326,125640,141509,280242,350384,21868,919643,372252,0,2615343245,85678023,5196,[LG21]Lords of Gondor
184845080,ᴸᵛSCAR德,23923418,55014834,645401,187812,313729,200941,4908393,223106,5833981,5131499,0,3781525664,46674299,28012,[LV21]Lords of Valinor
188912287,ᴸʳgCoelho,23827706,31884556,820622,1257952,802707,1014738,2365130,115865,5556392,2480995,0,2414887584,113818904,6692,[LV21]Lords of Valinor
181974650,IDEM City,23791400,2030305,1163258,142285,141908,58538,141798,3295,487824,145093,0,3776027518,86095121,2071,[LG21]Lords of Gondor
189236516,ᴿᶝ年华,23777737,2290337,936926,56107,169818,48265,162204,6219,442613,168423,0,3708252380,48671853,2900,[LG21]Lords of Gondor
184872506,ᴾᴿF A J A R,23766513,81330450,1396757,2282220,2097345,3030279,6197714,129053,13736611,6326767,0,3250277163,28252952,13422,[LG21]Lords of Gondor
185094982,Phi Dương F2P,23425994,38295492,1940175,2842133,5213473,4079345,961356,68459,13164766,1029815,0,2109637550,147926355,5318,[LV21]Lords of Valinor
188376202,ᴵᴾ云霄,23318484,6413730,1214571,147461,159504,83670,504869,34093,929597,538962,0,2593018500,17020000,4256,[LV21]Lords of Valinor
188390528,ᶦᶠAkrosh,23277756,14179254,358164,80861,884019,546131,1021052,0,2532063,1021052,0,1408491622,139317710,2243,[21If]Immortal Falcons
189057248,Cekko23,23158761,20835814,595985,139302,267141,394238,1719364,75154,2595199,1794518,0,3550995331,76002446,11178,[LV21]Lords of Valinor
188840841,ᴸᵛNotZach,23062009,30110904,506333,591643,826092,444463,2318528,168863,4349589,2487391,0,1585804394,107725390,4466,[LV21]Lords of Valinor
188994494,Snowplow,23012449,1094552,236306,8504,103749,19351,80795,0,212399,80795,0,2851011399,0,3439,[LR21]Lords of Rohan
185602720,ˢᵉAbdallah,22991213,37384800,200395,749910,727131,953454,2885936,155369,5471800,3041305,0,1707106341,13071304,9505,[LV21]Lords of Valinor
188880486,Kỳ tiktok,22864027,8487802,1062340,68271,30446,79884,622510,93431,894542,715941,0,3820678467,0,3129,[LV21]Lords of Valinor
188937116,ᴵᶜTom,22847232,4798418,78668,26543,281358,25756,401873,5432,740962,407305,0,2254933220,6485919,12148,-
189324168,인절미,22772318,11044249,1368116,65146,304808,90751,963836,21012,1445553,984848,0,3411419703,7500000,15231,-
188793523,FerAmaya,22750903,8571281,404492,129947,223590,105868,617402,75031,1151838,692433,0,3610487668,43532335,5161,[LV21]Lords of Valinor
144563085,ᴵᶜPARANOIA,22766180,4730553,1770534,15817,22531,23272,408292,25316,495228,433608,0,2817619564,1021382,4807,[LG21]Lords of Gondor
188661481,Kängurufarm,22685146,2847269,781585,208965,117034,10247,253042,0,589288,253042,0,2409834236,1128542199,4146,[LG21]Lords of Gondor
185134660,PetitDr,22413048,3101404,85261,63894,67172,12418,288305,1078,432867,289383,0,1499181335,17979430,10865,[21if]farm 21If
184817793,meto 313,20386603,2415531,1898609,176676,118771,63196,44471,72258,475372,116729,0,2951232771,1827622,1793,-
188899189,QuantSist,22340544,1720056,385409,11624,68715,76283,127517,0,284139,127517,0,2023893552,296458,5493,[LG21]Lords of Gondor
188234979,iGRECfarm,22298461,15844038,286311,273003,46153,43158,1490992,30729,1884035,1521721,0,2703807026,315563112,10672,-
186016235,卂丂卂千,21935568,5455072,172363,142922,151729,14030,395527,55582,759790,451109,0,1879009579,12932669,3808,[LV21]Lords of Valinor
188842111,JJ00,21878131,12581657,546042,13757,120082,40863,1073927,71801,1320430,1145728,0,2619609251,3999999,3629,[LV21]Lords of Valinor
188870613,xXVincinetteXx,21868756,8307709,1851059,867867,503902,29008,656394,22318,2079489,678712,0,4699104174,5876311,23600,-
188846843,BoboFranek,21704370,1436892,86860,96434,230127,133623,42286,0,502470,42286,0,1842439115,45731253,5585,[LG21]Lords of Gondor
191454845,ᴸᵛTueAnh,21691418,17631407,653650,42867,104981,279588,1501094,64179,1992709,1565273,0,5519628951,997408023,11558,[LV21]Lords of Valinor
188639928,The亗SCARFACE,21688374,2476955,64606,145589,285116,162864,116131,3242,712942,119373,0,3208454826,44040000,4296,[LG21]Lords of Gondor
188851823,ᴸʳMent001,21651945,706360,45963,213744,185983,43829,11633,0,455189,11633,0,1913787274,0,2705,[LR21]Lords of Rohan
188255601,Ant Man21,21587050,21740037,261646,303216,192688,238972,1939567,47123,2721566,1986690,0,3143089623,0,3958,[LG21]Lords of Gondor
188830522,ᴸʳTylnmrl,21534736,1670861,37663,32839,20609,4164,155652,2495,215759,158147,0,2261045846,16585000,4635,[LG21]Lords of Gondor
188337674,ᴵᴸAxan,21286602,13852737,908861,382486,81728,81286,1314956,6904,1867360,1321860,0,2621782599,376836150,9603,[OP1]OP CLAN
187503097,Romulus1991,21082998,25645676,179996,143691,70341,268479,2145150,147542,2775203,2292692,0,3754020383,82802390,16890,[LV21]Lords of Valinor
188889549,СЦEПИОН,20926077,2997871,1241527,21675,25683,72660,248333,8410,376761,256743,0,1923428853,102567597,3693,[LR21]Lords of Rohan
186018265,yıldırımsefa,20905412,12642300,258459,159713,850626,471324,812371,45005,2339039,857376,0,3091634481,50620184,8851,-
188819819,fox77778,20795950,3782562,738594,75581,204618,428450,164441,0,873090,164441,0,3296530892,1037349,4682,[LG21]Lords of Gondor
188878743,Jetare,20761417,13928200,984262,914090,1759002,1062897,559859,18860,4314708,578719,0,3162489910,91210728,2933,[LV21]Lords of Valinor
188443825,йкйцк,20721165,48743894,1313992,1943111,2457331,1223280,2839555,507597,8970874,3347152,0,2532968576,1971457076,21172,-
189036655,Vitia back 1990,20681543,9551108,2056000,172660,105414,21917,821704,50052,1171747,871756,0,2635805950,9800000,8565,[LR21]Lords of Rohan
188856715,ᴸᴳJackie,20603435,13833750,284873,80252,30041,24787,1256279,54784,1446143,1311063,0,1242639661,20000000,4037,[LV21]Lords of Valinor
183360513,ᵀᴸмønoメ,20415868,26110591,478300,186118,247673,221163,2277659,95839,3028452,2373498,0,2125813241,85509847,6981,[LG21]Lords of Gondor
188884272,ZHIANZD,20398835,1216090,246973,127800,150740,29760,77001,0,385301,77001,0,2488342395,0,2033,[LR21]Lords of Rohan
188838640,Presidente CIAO,20339408,3248958,61803,13150,115426,83389,268192,0,480157,268192,0,1615279194,23800000,4485,[LG21]Lords of Gondor
184819319,joe200,20330410,2022401,1197317,130789,249677,21520,45323,47879,495188,93202,0,1624485065,91263980,5850,[LG21]Lords of Gondor
188876948,Ruberoid,20285318,1308095,30041,24678,63862,55794,95226,0,239560,95226,0,1468073126,3846529,4600,[21If]Immortal Falcons
188790227,СУЛИМАH,20234807,2937806,1265520,69552,52214,89972,230812,7573,450123,238385,0,1837825253,102878721,3411,[LR21]Lords of Rohan
188325495,쵸 See La Meet 쵸,20218723,26136473,714725,1038428,1614240,1553702,1521512,63519,5791401,1585031,0,3512199870,0,7931,-
184859052,ᴸᵛamadxd1,20213982,10023642,1080886,167940,454668,303192,677143,54826,1657769,731969,0,2189325174,315992716,7066,[LV21]Lords of Valinor
188847403,Vali188847403,20213068,1805843,502942,88125,113717,240436,59904,0,502182,59904,0,1173495329,0,641,[_NDM]New Jersey Nol
188903920,JoshuaSeil,20037584,5346112,817155,57530,197583,100305,414492,19665,789575,434157,0,2914601274,301497,3979,[LV21]Lords of Valinor
188806434,ᴸᴳ Bimz,19927695,4607063,658635,38897,29786,6973,369512,40835,486003,410347,0,2927944448,29458520,9657,[LV21]Lords of Valinor
188836639,Ndiaye,19887074,5853377,660696,352077,491543,747064,181162,0,1771846,181162,0,2951107641,383503,1612,[LLA]Lost legion academia
188884453,dm152,19884338,261473,0,20838,55033,4660,12860,0,93391,12860,0,2645554095,0,4309,[LG21]Lords of Gondor
145631489,BABA SON,19850908,5108715,290848,136245,494296,267396,273217,14556,1185710,287773,0,2096496803,4400000,4683,[LV21]Lords of Valinor
188898779,kral jon snow,19738727,113087,6227,15339,20427,859,6573,0,43198,6573,0,2753058077,8327554,2899,[21If]Immortal Falcons
189075824,NooByZ,19621709,8523920,1530004,77034,121760,128921,748617,13157,1089489,761774,0,3365718003,99259891,19016,-
188232993,AKON311,19570367,17474104,658995,571073,531874,842388,1182997,54831,3183163,1237828,0,1770213436,850687088,12260,[LG21]Lords of Gondor
188857113,GritNGravy,19519476,1953070,46395,39362,14347,20181,183578,0,257468,183578,0,2918725386,3200971,3708,[LG21]Lords of Gondor
188806199,Op khan,16220641,4774879,1311876,240925,827408,507637,83281,10426,1669677,93707,0,2826437314,4253716,3116,[OP1]OP CLAN
188261313,freezebee 21,19379685,2027071,234347,244875,375237,108803,79241,0,808156,79241,0,1742483621,5187959,14517,[LG21]Lords of Gondor
191530671,ᶦᶠtMadsonn,19347643,1846035,34099,69047,86817,200703,85578,0,442145,85578,0,2597787828,910375198,4569,[LR21]Lords of Rohan
188430882,JapayuKingBILAT,19260823,13523742,558247,244614,718820,347450,997854,33442,2342180,1031296,0,2808307407,142262581,15324,[LV21]Lords of Valinor
188814205,SUBUTAİ 38,19122842,1466044,274608,292102,181430,22696,95398,0,591626,95398,0,1925026694,3080000,2296,[LG21]Lords of Gondor
186613612,Inigo Montoya1,19111509,4781554,1455414,349831,116242,28761,403220,16593,914647,419813,0,2602909272,103076547,8515,[LV21]Lords of Valinor
188818238,PoTaPyh,19086561,17945708,847850,488230,854873,981299,1155520,32896,3512818,1188416,0,3095818179,301072527,13039,-
188539042,Chieu F2p,19056698,23363790,464904,857870,1727252,652023,1370004,171479,4778628,1541483,0,2068608319,35342934,10912,[LV21]Lords of Valinor
188282297,MinasTirith秋,19050064,67391767,1935936,4739757,348069,495597,5982319,197105,11762847,6179424,0,2949663138,2562027272,30485,-
188853064,TerrorBlade98,19033626,4698786,941546,120572,115534,39441,414286,7149,696982,421435,0,3302113955,0,1335,[LG21]Lords of Gondor
188838663,ERON,19015674,7419903,732610,190505,250716,72425,647213,5927,1166786,653140,0,1988254222,20081022,12054,[LG21]Lords of Gondor
188845810,BARBALIAS,18899874,5080729,1177937,167048,291925,201260,352189,6827,1019249,359016,0,1731230822,0,5851,-
188869412,dân chơi đá,18877333,8228309,246570,288205,739830,1185717,194814,0,2408566,194814,0,2106256471,1154652,1641,-
188776545,ᴳᵒᵈ Ingle,18839608,1048600,93501,85140,135892,24107,66336,0,311475,66336,0,1690985099,3404666,5122,[LG21]Lords of Gondor
188360951,SATORUGOJO1,18420133,9398145,472927,508838,996498,575503,431459,34339,2546637,465798,0,1605356212,317828071,6658,[LV21]Lords of Valinor
150165925,ᴸᴳken arok,18325979,8920983,594938,105507,278014,108601,728213,31366,1251701,759579,0,2419965788,26909895,10613,[LV21]Lords of Valinor
188836606,Black AngEL,18316975,8655975,1937740,908418,995278,553139,422312,2403,2881550,424715,0,2137121812,18536152,1820,[LG21]Lords of Gondor
188844580,RedHoodJT,18285345,3724748,210774,117223,615129,546669,28437,0,1307458,28437,0,1652892965,0,1445,[LR21]Lords of Rohan
188827507,Dug1man,18259897,106428,5346,18103,18794,0,6522,0,43419,6522,0,2486129141,0,2476,[LG21]Lords of Gondor
187197359,Demir Bilek,18241616,9273471,779097,120768,235808,174193,781889,13102,1325760,794991,0,2170580364,30192868,11113,[LG21]Lords of Gondor
188336750,SKY EAGLE,18136313,7121747,985124,330019,49903,45477,677403,0,1102802,677403,0,1931799839,213802552,9588,-
188490339,Eudaimonia,18123110,5149512,227320,56910,36785,12770,444932,28208,579605,473140,0,3155315573,30962500,5591,-
189014302,magister,18034793,11593788,947900,205152,1188782,528161,695989,5133,2623217,701122,0,1327725746,15363819,7383,[LG21]Lords of Gondor
188865329,Việt hoang 07,17892195,607097,64769,419495,234049,900,5150,0,659594,5150,0,2214217502,1833721,888,[21M]Immortal Myrmidons
188884243,HiagoLira,17759698,1285899,1,5567,1871,82946,94926,0,185310,94926,0,1622512749,0,2360,[21If]Immortal Falcons
188787622,MalandrageX,17723799,20690,0,2434,1687,245,1585,0,5951,1585,0,2511718655,0,3274,[LG21]Lords of Gondor
189231766,darkkiller666,17669854,3746982,286312,236683,195194,50737,294065,8283,784962,302348,0,2533244060,20289481,14046,[LG21]Lords of Gondor
188367613,ᶦᶠKinkyTail,17639099,27102367,652235,411575,750063,721224,2032895,115304,4031061,2148199,0,922979276,42186939,11319,[LV21]Lords of Valinor
190852683,BossAlien FARM,17369235,6771910,168409,19244,81805,135783,606132,0,842964,606132,0,4206451715,1694123182,2612,[LR21]Lords of Rohan
196566747,Codrin4Valhalla,17231737,4921491,177359,259178,157063,124705,383161,11255,935362,394416,0,653908880,89594454,6112,[LV21]Lords of Valinor
188904786,Shadow vahalla,17215735,951871,236630,6845,11062,4462,91053,0,113422,91053,0,2824203464,0,3005,[LG21]Lords of Gondor
188368666,Derik 災,17193465,17311218,78795,189202,156137,96806,1633226,12081,2087452,1645307,0,1504456225,57910439,4670,-
188487100,Kir8,17188463,744292,46498,47082,45400,57564,41382,0,191428,41382,0,604975853,0,4405,[LG21]Lords of Gondor
188585266,メDragønメ,17046256,6200803,260935,13008,75292,24207,548489,23295,684291,571784,0,1565973095,73489482,19339,-
187016834,ƐƘÁ,17019426,5969476,107689,89142,174787,122716,511121,0,897766,511121,0,2727572216,1489060086,4786,[LR21]Lords of Rohan
188879533,Qertt7,17026656,188791,322,8039,23990,816,10230,1682,44757,11912,0,4064085655,38000000,2135,[LG21]Lords of Gondor
188503741,SİYAH KAZ,16994656,2745204,35926,148261,185391,246920,121345,7182,709099,128527,0,1557000457,38351774,6878,-
188823442,VIP shooter,16904675,3305125,846887,132688,41914,75500,277768,5754,533624,283522,0,1617663134,41800001,5163,[LG21]Lords of Gondor
188824641,Sabesaur312,16783039,178017,72,61605,21023,10955,7983,0,101566,7983,0,717328751,0,1962,[LR21]Lords of Rohan
189068044,Hsotits7,16719606,13123610,995230,966771,1440390,1040579,499742,44487,3991969,544229,0,2080522571,16241240,3408,[LG21]Lords of Gondor
189579148,стратег,16475452,2439007,1269763,90576,272116,146355,125592,1766,636405,127358,0,2309890690,1378833,2187,-
188928573,Thànhteo,16453413,1269484,231737,5214,47138,152454,56435,0,261241,56435,0,1511473910,0,3089,[21M]Immortal Myrmidons
188845980,Azadi,16440016,2414584,591878,280392,474111,105066,99002,0,958571,99002,0,1853486476,3366983,1070,[I-am]RoyalLoyalMembers
164927516,iven0007,16391481,10077159,800589,584997,950594,899393,404788,20676,2860448,425464,0,1096047545,29829009,5907,[LG21]Lords of Gondor
189181702,222mb222,16379605,2096107,769471,199359,63662,40288,176776,0,480085,176776,0,3034584838,225401626,1728,[LR21]Lords of Rohan
188868206,Quocbao05032012,16363785,1765350,652703,140343,12908,5049,169127,0,327427,169127,0,1699178647,6000000,2009,-
188432088,BandAid,16308844,6291099,303434,23738,88926,146960,503492,24287,787403,527779,0,2955824336,308659606,8287,-
190329472,F1Quang,16236503,12942191,1403680,76015,288128,303523,1097870,7897,1773433,1105767,0,3881324018,2734670795,8463,[LR21]Lords of Rohan
188861925,blackbandito,16218133,3299236,432177,181283,407143,143151,130863,28373,890813,159236,0,1437773019,24105565,1960,[LG21]Lords of Gondor
188513738,MooSáke,16217270,198927,96089,15385,14235,12870,11590,0,54080,11590,0,1785178292,0,1221,[RC21]ROYAL CROWN
188833114,Quent2,16197814,22793082,342325,313030,76329,372177,1907169,100871,2769576,2008040,0,1434244209,21298007,10228,[LV21]Lords of Valinor
188852196,DarkExecutioner,16132302,1452447,100617,60616,84044,164244,61526,0,370430,61526,0,1216662089,28060602,1834,[TFS:]The Forsaken Souls
188823187,AZERBAIJAN90,16127248,891992,1273713,78632,32607,42323,49764,7206,210532,56970,0,2188918647,3040,1275,[~AKT]BR AKATSUKI
188894198,Tomioka senpai,16066078,379272,52185,4153,47557,61967,3546,0,117223,3546,0,2555388697,0,1802,[21If]Immortal Falcons
187880560,wcwc,16017764,230115722,1527635,19485000,18674475,23053443,9591814,36893,70841625,9628707,0,3214040764,596448438,13547,[21if]farm 21If
188376429,ᴵᶜmySoul,15812605,447638,94861,165290,199177,4054,1,0,368522,1,0,1311135078,7488905,8464,[LR21]Lords of Rohan
188436016,KiLLedYouhaha,15695632,5814413,215611,186675,224968,166558,432477,16807,1027485,449284,0,2576011801,79055118,9691,[LV21]Lords of Valinor
187078010,Dr4gonsFarmerツ,15450978,22163921,1316246,641729,1799365,1256244,1338903,1142,5037383,1340045,0,2602487365,1725005764,7885,-
188825941,S0SKA,15447745,1189854,237525,181770,115056,123932,42766,0,463524,42766,0,1573181792,17191302,2471,[21M]Immortal Myrmidons
188134384,ˢ carlossainz,15354071,6601011,1300774,21788,65922,52235,498539,63524,702008,562063,0,1190118090,25406959,3997,-
188809474,Edgar15,15275743,46285,13168,43659,11087,2650,478,0,57874,478,0,2116886110,0,1245,[21M]Immortal Myrmidons
188879219,Akglate,15231878,247677,40137,19567,121882,0,0,0,141449,0,0,2071709078,1758755,592,[LR21]Lords of Rohan
188878343,Cheiron City,15174547,2006372,65708,76640,299335,127026,88427,0,591428,88427,0,1338777538,0,1653,[21if]farm 21If
188857667,Apoathou,14986899,1322660,1124764,128214,19733,13903,120194,0,282044,120194,0,230139173,156690,1080,[LG21]Lords of Gondor
188781490,Fra1d,14963604,1187031,100258,39857,116341,94712,56753,0,307663,56753,0,1220961083,5509155,3143,[LG21]Lords of Gondor
187560016,Kyubi Farm1,14903377,43242083,1156562,1634869,1976614,1528733,3245429,19633,8405278,3265062,0,1348799318,409430369,6743,[LG21]Lords of Gondor
188825002,Namiq Cebrayilo,14872158,3934535,1259596,213707,290110,151386,270603,0,925806,270603,0,2107428748,0,724,[21MA]Myrmidons Academy
188365295,ᴿᵃTsumiki,14849316,2089406,0,8924,38778,19749,193107,0,260558,193107,0,1063300942,3762398,6032,-
150775231,Lind21,14802402,7690885,484858,498285,954081,721214,266273,6774,2446627,273047,0,1823420717,3048989,2494,-
188858878,lisabella,14788383,237752,277117,67710,112105,0,0,0,179815,0,0,569020405,0,1605,[21M]Immortal Myrmidons
188877463,Se Tuath De,14774978,1904865,811661,93157,158781,182383,83914,0,518235,83914,0,2506923354,5600000,2399,[LG21]Lords of Gondor
189036275,TheBlackDragon,14751862,163506,24134,22964,32186,14353,3713,0,73216,3713,0,2024451597,0,1763,[LG21]Lords of Gondor
188963486,GÖZTEPELİ35,14745890,131575,0,26938,85,5222,10513,0,42758,10513,0,1956299993,230887100,3805,-
188785649,priam,14698331,1161695,776393,45887,18254,7335,108667,0,180143,108667,0,1458782922,18007168,326,[tgqm1]amarl
188281290,1GuiltyCrown1,14694409,19247655,1007323,1096697,1425467,992963,1183957,18298,4717382,1202255,0,3378739737,1967206382,17061,[LG21]Lords of Gondor
186035363,Klgi20,14681439,1079100,1084576,54111,135908,7883,18115,29189,245206,47304,0,1817560946,1200000,3120,[21If]Immortal Falcons
183848200,Ei Farm,14658739,38195393,1298931,2526718,1320489,1044558,2973860,56612,7922237,3030472,0,3111047090,519374881,13482,[LG21]Lords of Gondor
186073361,卂尺丂Farm,14634408,3668107,345837,39537,204145,32135,312337,0,588154,312337,0,2285339693,489706596,1512,-
188802524,Mickodem,14576767,193221,131028,1699,7453,9839,13862,0,32853,13862,0,1197961668,13257436,2968,[LG21]Lords of Gondor
188863496,dark8582,14504087,408222,113485,9062,63839,37988,12678,0,123567,12678,0,1864955080,0,705,[jk10]jk 3621
188885079,ᴵᶜnoobhuhu,11287294,4932153,869902,263679,640053,58918,316980,9692,1289322,326672,0,1694858992,26599999,5002,-
188986083,KyoHN,14330730,58505,16806,10125,15173,711,2329,0,28338,2329,0,2309657510,69,2853,[LG21]Lords of Gondor
12113325,Elena23EV,14296474,1297747,131418,8455,10921,55191,102057,1644,178268,103701,0,1086648978,24431024,5686,[LG21]Lords of Gondor
188796842,Menda2137,14259991,321687,136804,21106,48638,8855,18477,0,97076,18477,0,1116877840,0,1466,[LR21]Lords of Rohan
188885945,whyreall,14191004,1427513,1410059,61686,45602,10688,128122,0,246098,128122,0,1497367838,862617,2035,-
188287771,ᅟᅠᅠᅠᅠᅟᅠᅠᅠᅠ ᅟᅠᅠ,14135955,55138144,428726,330732,673936,319444,5244635,0,6568747,5244635,0,4982620194,2156968833,28835,[LG21]Lords of Gondor
188858305,Palestine313,14064548,3028033,1334422,129577,527939,188640,119168,0,965324,119168,0,1367260605,0,4,[Alg]Palestine313
188873290,FarmЛиса,13958405,2607974,596991,64191,23711,6956,237079,7455,339392,244534,0,1422870299,122800001,4115,[LG21]Lords of Gondor
188800436,LilPiglet,13948495,769658,220953,34240,152043,47076,27042,0,260401,27042,0,1362486306,0,1286,[LR21]Lords of Rohan
188847086,Dimiboy,13937455,75311,0,179,37638,0,0,0,37817,0,0,1184216673,0,21,[Tick]Tick tack
170835406,ᴵᶜ Has,13928147,1445859,679890,46009,32626,7559,101847,16135,204176,117982,0,687055286,298517,2939,[21If]Immortal Falcons
188806889,Gouverneur188806889,13892166,785370,316714,61610,182543,80923,8427,0,333503,8427,0,1084023412,0,1024,[21MS]Myrmidons Farm
188896546,БорисBao,13857624,1182765,168254,14668,118405,170863,25957,0,329893,25957,0,1761224189,22966398,1423,[LR21]Lords of Rohan
188856535,HOIANA,13763477,1190153,693357,435295,160981,54643,43890,6183,700992,50073,0,1738733985,400000,1157,[21if]farm 21If
188953179,SarahVinyard017,13756390,5795264,260817,103502,87804,304494,438098,0,933898,438098,0,1388844714,31860199,3832,[LG21]Lords of Gondor
188832666,ChifOJ,13580990,2361104,125471,94442,41533,55215,203829,0,395019,203829,0,2486171257,0,528,[21IR] Corral
44936497,젝스킹,15991483,6996924,923387,39204,54846,41378,523118,74135,732681,597253,0,2183506756,0,9052,-
188931757,ᴸʳANTHRAX,13405400,659165,84307,164935,187652,32931,11915,0,397433,11915,0,1379161784,0,2094,-
187795145,SOTER,13310832,8447735,539910,529189,65018,309343,652149,22650,1578349,674799,0,1281516203,112215799,15231,[LG21]Lords of Gondor
191177358,RtthyrFarm,13297053,52258,8925,14892,0,0,4928,0,19820,4928,0,3457282733,1594265331,1124,[LG21]Lords of Gondor
188787790,You  andl,13282823,920284,416012,51124,134014,82128,31352,0,298618,31352,0,1305215779,4084888,1930,[LR21]Lords of Rohan
191069538,Shinnygamyy,13259416,3037148,499817,235031,755080,228183,56725,0,1275019,56725,0,1083252012,5089962,691,-
187257305,HolySpirits,13200658,4186335,271743,116035,83670,59317,375642,105,634769,375747,0,1158659063,477259605,5803,[21If]Immortal Falcons
188836866,zlucifer,13134321,2684582,271491,220751,328964,145856,139908,0,835479,139908,0,1701695970,0,1524,-
185484265,Tors228,13083005,7740094,636018,1305674,1878812,627539,120762,178,3932965,120940,0,1312958755,25325363,7376,-
188981583,Calep2012,13028091,5854580,972385,252824,915423,175225,313923,6652,1664047,320575,0,1371560025,704256,4512,[K~R~]3621 Utility Box
193596249,Korkusuz 51,12958052,239160,358859,12402,0,0,23668,0,36070,23668,0,1401609699,60357336,943,[LR21]Lords of Rohan
188817273,Munmon,12901737,1116310,211912,39551,42589,125343,52185,0,259668,52185,0,2476678488,0,125,-
188291209,ROCKS  D  XEBEC,12853105,3694092,969555,42334,42629,46712,328702,6325,466702,335027,0,1822462533,37349860,9225,[jk10]jk 3621
188837379,안정아남자,12850869,885792,199719,262430,137821,8581,52334,0,461166,52334,0,1823493664,0,1094,[LG21]Lords of Gondor
188845348,ᴸʳLUNICTUS,12833107,104914,26926,6884,16888,8978,3385,0,36135,3385,0,1542672979,0,452,[LR21]Lords of Rohan
188292201,쵸Bear,12762411,3636617,863462,127956,652623,13205,183272,21012,998068,204284,0,1398516677,0,8400,-
190539451,puyolF,12753353,972686,309560,2673,66571,105265,41795,0,216304,41795,0,4587570194,1818372170,2021,[LR21]Lords of Rohan
188887466,Jensamtresen,12529683,2851467,834974,287219,392239,254799,99035,0,1033292,99035,0,872502186,10799999,840,[I-am]RoyalLoyalMembers
189266244,ᴵᴾRágnär,12376390,2424921,681640,338989,350984,104124,70352,26757,891206,97109,0,245500638,11642489,7444,-
142371438,NokedliF11,12302691,3005981,754566,516818,830716,67154,61715,17771,1494174,79486,0,1496304971,2400001,10465,[21M]Immortal Myrmidons
192581999,LilitЛиса,12260127,1758597,2586,4079,12074,27936,162189,0,206278,162189,0,2045234056,516525710,3563,[LG21]Lords of Gondor
188816893,WARRIOR FARM 10,12243174,242793,17769,22009,47558,10254,10226,0,90047,10226,0,1306471434,0,1890,[21If]Immortal Falcons
178904209,MorFarm2,12182432,243458,0,0,0,3117,23099,0,26216,23099,0,1692919713,335244116,803,-
123456386,Igoryan,12176542,4604101,193112,1352415,222892,143876,329557,838,2049578,330395,0,1287848632,11392165,1276,[LG21]Lords of Gondor
188829162,Mkジinsane,12152527,911799,856240,15867,56941,24326,65024,2360,164518,67384,0,1543783586,1400000,3486,[LR21]Lords of Rohan
188880051,qftydhunvfezbjj,12100235,18338939,1337013,1249255,1030656,1111224,1086802,35743,4513680,1122545,0,1422326310,88951930,7822,-
188899884,hanaaaa230,12030541,3656113,993138,112016,538707,284659,141766,0,1077148,141766,0,1447258878,3785937,1100,[K~R~]3621 Utility Box
188217778,ᴵᴰKing Nemo,11974922,1852509,716667,684238,272077,322,117022,0,1073659,117022,0,1857331281,0,12936,-
190430624,IMPERADOR FARM,11919555,449281,436505,3716,0,322,44725,0,48763,44725,0,4668164640,2527734725,1537,[LR21]Lords of Rohan
185259121,Lets go Os,11907314,913938,1168728,282,16846,7330,13445,35821,73724,49266,0,1375527451,4800000,1568,[LG21]Lords of Gondor
188900034,Rajpoots,11888266,854381,223016,55556,81433,13291,62724,0,213004,62724,0,1851926635,0,3100,[LG21]Lords of Gondor
188479340,ㅡᅟᅟF2P 8      ㅡ,11874571,9974813,173571,883535,766581,262971,721306,0,2634393,721306,0,2705117571,956471741,8844,[LG21]Lords of Gondor
188946350,BaabyyKiller,11764448,45777543,823248,1480408,3397133,2896319,2635750,37221,10446831,2672971,0,1760569996,20189360,9196,-
187384799,C H A D 3 3 3,11746674,5025006,638494,336794,550030,58137,356220,3142,1304323,359362,0,942780690,0,4530,[LG21]Lords of Gondor
188838338,boble 79,11724752,306757,46338,1697,52760,41937,3315,0,99709,3315,0,1268137620,0,2118,[21MA]Myrmidons Academy
188952266,ErDegui,11704483,7108681,230822,125436,58773,125367,620570,12944,943090,633514,0,1166685836,13045768,5395,-
188819203,Cominogr,11653427,347521,71452,268238,123679,11074,222,0,403213,222,0,1647195087,0,850,[ANTB]ANnti Banned Club
60584385,silverlion9,11596083,7926707,936250,516238,906635,1186930,126153,47,2736003,126200,0,1472425909,5041847,1012,-
188887462,Dunks,11542870,1538565,760926,36818,198678,122594,64347,0,422437,64347,0,1107672787,0,1037,[LR21]Lords of Rohan
188801943,Brunk100,11490847,938220,200395,171290,279130,31043,22153,0,503616,22153,0,1330342807,2513093,2827,[21If]Immortal Falcons
187155907,Yuzhi,11434837,5032590,1641848,115533,189407,294655,290433,27386,917414,317819,0,2012883919,257605,2003,[LR21]Lords of Rohan
188363322,쵸Belmont,11394210,726781,18931,225245,250029,43961,583,0,519818,583,0,1181365988,1410552,11058,-
185877603,ㄴ Aurelio ㄱ,11366004,3426162,734268,194294,519109,17374,220713,3623,955113,224336,0,891518433,1758080,3475,[LG21]Lords of Gondor
188892262,Udi lopez,11336767,286475,30519,120358,27289,7419,17815,0,172881,17815,0,256378975,3001045,1834,[21If]Immortal Falcons
188900167,Charles grand 3,11255677,4207791,779277,591939,722430,168606,197012,0,1679987,197012,0,1742101324,8400000,913,[Tick]Tick tack
184327666,ツاحمدᴰᴮ,10577436,2523140,510987,680474,487997,101508,74698,12902,1357579,87600,0,1415642404,72130,2177,[LV21]Lords of Valinor
174523518,ㅡᅟᅟF2P 5      ㅡ,11170338,3700033,325966,825415,1309771,123637,42086,0,2300909,42086,0,2231549845,808382628,2414,[LG21]Lords of Gondor
188840453,La pampara,11162484,3222569,940369,143239,363307,305562,124506,0,936614,124506,0,1403569305,0,288,[21if]farm 21If
188307234,ᴵᵀJessyS2,11159564,3418968,138406,130180,168640,9783,301652,0,610255,301652,0,1509177777,180913621,6306,-
188818543,GodAnubis,11127495,3265470,842158,347813,333503,280538,140675,0,1102529,140675,0,1200287081,473118,746,[21IR] Corral
188840892,AlbertO,11026319,415004,15277,47370,78237,8794,21388,0,155789,21388,0,1666596987,0,1894,[21If]Immortal Falcons
188856725,Uranusuki,11019093,268914,32838,25630,66282,25841,2786,0,120539,2786,0,788756025,3859996,709,[LR21]Lords of Rohan
189443468,Hubey,10948714,2171604,462536,189562,257421,35910,147521,0,630414,147521,0,918945909,0,1967,-
188818957,alonsoisma,10934397,2300239,762386,25316,47973,75270,189815,0,338374,189815,0,1494136832,4826393,1387,[LR21]Lords of Rohan
188840730,FurkiTolki,10921127,1839593,1140153,3217,12856,72657,143339,4461,236530,147800,0,1658918724,3600000,2019,[21M]Immortal Myrmidons
189007908,vua đại du,10847143,2010095,594035,32817,68882,36737,135324,18279,292039,153603,0,1664459657,27506603,6095,-
188309795,ᴵᶜ TAZIEX,10844048,8618161,951227,435439,559362,399095,559725,10936,1964557,570661,0,1632163083,0,8839,-
189182502,ᴵᶜVatson67F,10970611,137197,213594,1669,4693,617,12501,0,19480,12501,0,3429617279,1724148322,1595,[LR21]Lords of Rohan
188320795,Fïshböy F1,10728035,1130852,410313,146172,398,5918,103727,1994,258209,105721,0,1481035785,649927741,1082,[LR21]Lords of Rohan
188817859,oktaev,10615195,401425,359467,33669,31021,2770,32157,0,99617,32157,0,1061532734,0,100,[DD21])Dragon of Death
188839518,Zaragoza,10601166,1181120,88062,120100,376712,100919,0,0,597731,0,0,1395445559,0,1099,[LR21]Lords of Rohan
188847841,Lj1208,10595108,314850,314434,984,0,1961,30681,0,33626,30681,0,1168489928,0,903,[21If]Immortal Falcons
188889920,Carolk,10367699,642390,541227,49383,96269,35954,29616,0,211222,29616,0,1150502285,1349311,322,[fagr]alpha table
117517315,ᴵᶜBOTAN,10360428,13712356,945529,506093,1444925,965222,611992,37024,3565256,649016,0,1235813199,498018246,20006,-
188522411,Ваn,10341550,1095208,3365,36724,120447,26500,74097,0,257768,74097,0,727419882,1,2218,[21If]Immortal Falcons
189182788,Vatson67f3,10329676,260412,485136,2684,4031,13106,19939,0,39760,19939,0,3417613185,1133268751,1344,[LR21]Lords of Rohan
189442766,Gubernur189442766,10254674,77204,41779,1313,9937,12737,612,0,24599,612,0,2440653903,1989430704,702,[21IR] Corral
188295840,ッ Yakuza ッ 6,10205094,395204,0,3871,70818,40591,9043,0,124323,9043,0,992758872,82882904,4847,[21if]farm 21If
188906315,ᴵᶜИвaн,10115924,1248369,45240,148765,274837,58418,43527,0,525547,43527,0,943901017,16348226,12804,-
188840603,andyrendy,10073872,1722850,894100,10373,99042,247058,53446,0,409919,53446,0,1032365452,0,459,[Slon]Slonii
195403312,môngcổ,10051155,1446809,783623,85946,65345,87040,95077,0,333408,95077,0,1256472656,0,1035,-
188857096,Di 1,10019335,909985,10470,103819,160058,85834,22577,0,372288,22577,0,934774982,1843151,2952,-
188899095,Minuz,9939468,1614469,364375,167345,306671,102167,55899,0,632082,55899,0,718006492,0,1683,[LR21]Lords of Rohan
189285062,Linh farm 2,9906193,9739359,1413236,1086939,10938,8479,938116,4251,2048723,942367,0,5394370581,3128768761,1808,[LR21]Lords of Rohan
194265891,쵸MØTÃSÊMツ쵸 2,9891913,1597892,0,0,0,2233,158896,0,161129,158896,0,1362590604,125453620,1353,[LG21]Lords of Gondor
188881481,678907,9885358,4054167,576543,566707,812285,378314,80300,0,1837606,80300,0,1199218053,53227,1508,[LLA]Lost legion academia
188300029,Hoàng Saa,9874587,5137975,463048,87026,120041,279872,368510,3795,859244,372305,0,1247523353,9873378,8131,[LR21]Lords of Rohan
188898591,Dthomas,9838220,468487,81006,125157,122286,22516,10882,0,280841,10882,0,434478065,0,1343,[LR21]Lords of Rohan
188471943,NoCoboY,9790738,413116,95171,64153,54918,15880,22693,0,157644,22693,0,1074224406,0,3617,[LG21]Lords of Gondor
189869613,Алёнааа,9733098,3146615,691598,31047,82951,360086,153416,0,627500,153416,0,1463285043,503089664,1094,[GW21]GOATED WARRIORS
188846435,psilva3,9647600,1390439,255473,331056,379662,122656,7428,0,840802,7428,0,932279349,0,582,[21IR] Corral
191785327,ᴿᵃQueen,9625702,3017237,247312,228656,300820,10824,232657,0,772957,232657,0,2123392947,813781963,1187,[LR21]Lords of Rohan
186988267,Panda ᴸᴺ,9616784,2766515,1120377,7927,2980,11995,264463,3318,290683,267781,0,3082740466,512115698,1981,-
