ID,Name,Power,Killpoints,Deads,T1 Kills,T2 Kills,T3 Kills,T4 Kills,T5 Kills,Total Kills,T45 Kills,Ranged,Rss Gathered,Rss Assistance,Helps,Alliance
179940560,ᴸᵛ ink,106865291,682092329,4362036,2922076,868211,971623,40544654,13521923,58828487,54066577,0,6185804199,1873979817,82418,[LV21]Lords of Valinor
186145908,ʳᵉʸEscanor,87786082,1533502776,3712561,4662483,915441,1734412,126563151,12908512,146783999,139471663,0,3563737722,4498233340,22750,[LV21]Lords of Valinor
188540500,TakeMe2Valhalla,84964610,1482723542,5287240,13604724,5658631,10686709,109781468,16406191,156137723,126187659,0,2834280658,7101247251,44958,[LV21]Lords of Valinor
180304933,LilLƴ,79913667,327479762,3362990,2782862,2764385,3236435,18086322,6379273,33249277,24465595,0,1186033142,5020554697,22622,[LV21]Lords of Valinor
179655012,ᴸᵛDØØPER,74808915,562184985,2663787,2667918,973558,1257919,36172451,9647405,50719251,45819856,0,8548948453,1491282008,38863,[LV21]Lords of Valinor
188858506,Cúchulainn 쵸,74347069,267274240,1972640,936833,278745,498321,23396992,1528309,26639200,24925301,0,5139019892,552651627,38246,[LV21]Lords of Valinor
178695066,SokoDrake,69519346,126212966,2755706,1295551,106206,148891,9230362,1642113,12423123,10872475,0,8059496512,115903540,17841,[LV21]Lords of Valinor
180560115,TripEhh,63643249,426887247,1462944,2776979,822023,695354,26535253,7827693,38657302,34362946,0,6738918463,1225250480,11338,[LV21]Lords of Valinor
184964288,ᴾᴿFïshböy,63416511,278949681,2109563,2057085,4656295,3958131,21230437,2054439,33956387,23284876,0,3530044236,632742525,39409,[LV21]Lords of Valinor
179977300,ᴸᵛTmulla,61649292,803546821,1802694,3860548,420787,1492407,45345975,17125188,68244905,62471163,0,7003558338,5600679937,17779,[LV21]Lords of Valinor
186009654,Dooby ᴼᴺᴱ,60872570,325377358,750830,2581671,360853,500752,29416947,1398342,34258565,30815289,0,7646604520,137216122,36059,[LV21]Lords of Valinor
188839265,A 10 Warthog,59113533,12765610,230642,42253,74269,128873,1010827,99243,1355465,1110070,0,3801574523,754780894,11387,[LV21]Lords of Valinor
180060983,ᴸᵛRumRamsey,57388717,388009988,2388036,115868081,5049133,999044,28349719,3362237,153628214,31711956,0,6176931342,417518493,95019,[LV21]Lords of Valinor
188341936,ᴸᵛ Vatson67,57010274,288820822,1699405,1362222,557828,606793,24713879,1893338,29134060,26607217,0,6677417018,384720155,42663,[LV21]Lords of Valinor
188918989,ᴼᴸ Kaymo,56153511,125177460,1092879,2484352,1386449,2529103,10279320,449904,17129128,10729224,0,3826371448,1075163587,41877,[LV21]Lords of Valinor
178814644,ᵁʷᵘØtòt,55196361,444858744,3140400,18550973,3385819,2356133,31505688,5494775,61293388,37000463,0,2295222519,2329433716,15921,[LV21]Lords of Valinor
182514982,ᴸoᵛeSalmon,52852696,440735817,3085752,17974388,656723,752616,30423365,6429169,56236261,36852534,0,5529656185,1060488180,53891,[LV21]Lords of Valinor
185836736,ᴸᵛMasonFTW,51278519,487911661,2396695,13306045,2218733,4779924,39924969,3122180,63351851,43047149,0,3411081344,2802859223,29031,[LV21]Lords of Valinor
186985518,HornyAPOLLOS,50739950,247740685,1638181,3315575,1545689,3188978,20999522,1061753,30111517,22061275,0,2765944860,594948054,18882,[LV21]Lords of Valinor
184826667,ᴸᵛAHERUS勇,49727180,525146146,1493172,12792273,5953573,11268784,45198363,681089,75894082,45879452,0,6028396280,1446853955,25245,[LV21]Lords of Valinor
142628224,Dae jang goon,49435053,179520430,2398902,2082564,718074,369855,14260849,1678993,19110335,15939842,0,4992646937,102794418,17171,[LV21]Lords of Valinor
184871937,ScazBigLion,48859410,1217022721,4528382,56591135,23364142,26120855,94350903,5549188,205976223,99900091,0,5931437553,13704268108,20902,[LV21]Lords of Valinor
185355768,Majaaaaaaa,48589363,577673018,6018425,3773833,2405479,3630391,50168691,2794941,62773335,52963632,0,1749957055,8071265646,20194,[LG21]Lords of Gondor
181825355,ᴸoᵛePUMA,48306672,240290972,1420218,1482144,360220,537196,17255176,3228678,22863414,20483854,0,3290251532,3599759382,35752,[LV21]Lords of Valinor
186199010,Daphneᴵᴿ,48202622,211400524,1801838,1835853,1275812,3351750,16214427,1646523,24324365,17860950,0,4226123897,1538857670,56180,[LV21]Lords of Valinor
181308342,ᴸᵛRockSolid,47853816,200534376,2758682,2730982,709675,1442730,13578131,2850830,21312348,16428961,0,3457457400,6082949920,41481,[LV21]Lords of Valinor
188920797,FreyaFullBosom,46113771,105672530,1839298,1860054,961746,1182547,8493034,685825,13183206,9178859,0,3674179019,1323334617,24635,[LV21]Lords of Valinor
176994964,Cpl Rage,45920650,115452738,476905,2377013,1506916,2122761,9023966,661640,15692296,9685606,0,1910845311,63265830,17173,[LV21]Lords of Valinor
185808036,Ze Bosh,45682185,324557669,903869,8598579,2626646,3862918,28938009,637645,44663797,29575654,0,5524831742,631820319,29935,-
179750493,GuiltyMahiru,45259295,188157446,1078908,2988644,770599,1221215,16166080,973643,22120181,17139723,0,1506241607,2025360302,41055,[LV21]Lords of Valinor
182423962,シValkyrieCillaﾒ,43018959,120607461,1875411,5641345,823181,711090,9277781,1110533,17563930,10388314,0,5110094746,1265202822,15249,[LV21]Lords of Valinor
188241812,Gilgamesh2323,42961946,121074770,938540,24286930,210544,281714,10279740,593602,35652530,10873342,0,5188112702,62620586,26024,[LV21]Lords of Valinor
179813923,ㄴ Bless ㄱ,42568357,241537502,2188438,7770721,5954918,5164873,19241179,750112,38881803,19991291,0,2544184953,978016636,23617,[LV21]Lords of Valinor
187423027,ᴸᴳPandaFr3d,42535785,190281160,2048263,1957321,794040,914974,14729262,1867455,20263052,16596717,0,2856780371,6820681844,26396,[21M]Immortal Myrmidons
185690465,Dictator  Goat,41872196,357470758,2170212,6092140,2162244,1318953,32523873,1070665,43167875,33594538,0,6209087277,1005155698,35314,[LV21]Lords of Valinor
181739549,kylinn,41829522,97526701,3321903,2389177,278410,278364,6880327,1328766,11155044,8209093,0,5128390117,10337862643,31310,[SFIS]Sky Fighters
187247613,Queen Padmé,41642172,215175254,3313856,4426292,2996263,4013920,16998645,1112767,29547887,18111412,0,7777384844,4688542203,88230,[LV21]Lords of Valinor
188485523,ᴸᵛIMPERADOR,41177170,198854196,1007660,600362,31074,81329,16162108,1836279,18711152,17998387,0,6384736748,281752989,37480,[LV21]Lords of Valinor
188483360,ᴼᴸTryxan,41167981,200913899,1210760,21238115,2837274,2706917,15674964,1170721,43627991,16845685,0,6174880061,2169436768,40701,[LV21]Lords of Valinor
188969478,ᴰᴹMePaul,40776765,97715103,990857,1956006,3290337,2582057,6816540,612480,15257420,7429020,0,3762165501,278578838,3681,[LV21]Lords of Valinor
188785515,Johnvin,40674554,174423228,1722597,874780,509812,1100372,15013974,934371,18433309,15948345,0,4982084782,93446315,57423,[LV21]Lords of Valinor
188976136,ᴸᵛ MUSE,40214661,105848648,1240457,2095231,2355914,944966,8234111,729840,14360062,8963951,0,5230726015,365719425,48622,[LV21]Lords of Valinor
179816952,Hell CAT GTR,38799498,59970288,2896557,79058810,1765741,1889101,2627306,339879,85680837,2967185,0,5512842178,1636698071,11055,[LV21]Lords of Valinor
185282531,Annıɛ,38667309,45496988,2695521,469962,132883,175975,4001273,221030,5001123,4222303,0,3456998437,592793562,26307,[LV21]Lords of Valinor
180368631,ᴸᵛWinfields,38508884,165655176,4678721,23224970,189123,611409,12182006,1818312,38025820,14000318,0,5288291223,1877834074,13975,[LV21]Lords of Valinor
188880730,ᴸᵛMarlone,38332875,148209496,1942492,485972,373109,200006,12467842,1094382,14621311,13562224,0,6032166290,136720000,45380,[LV21]Lords of Valinor
188303104,HokieHighlander,38261359,85190423,1556655,393175,111135,71502,7077577,691387,8344776,7768964,0,1084392579,84975248,13873,[LV21]Lords of Valinor
185457048,Cman9918,38231477,133602129,1160939,3704156,1184975,873737,11641776,528932,17933576,12170708,0,1996001700,126071365,16769,-
186765655,KönigsKlãsse,38216318,233880441,1176829,2425318,1403168,1938998,19762699,1260303,26790486,21023002,0,3628786434,407789115,8756,[LV21]Lords of Valinor
188882878,Rtthyr,38197356,108559645,1037752,262928,107597,121724,9276273,752112,10520634,10028385,0,7535049742,93046400,19776,[LV21]Lords of Valinor
178213242,ᶦˢLOCOOZ,38189900,140178485,3850546,2141345,957035,1554554,8372481,2394656,15420071,10767137,0,4422109729,1274602396,22198,[LV21]Lords of Valinor
189060019,Tušiš,38004007,90873149,842859,792209,636796,1052564,7749328,386879,10617776,8136207,0,3019181747,572362862,20843,[LV21]Lords of Valinor
187726069,ᵀᴿvSpryth,37888634,77885559,809475,1399758,170663,364308,6716619,432043,9083391,7148662,0,5541632062,15763287,24231,[LV21]Lords of Valinor
188651683,Sol Aliyaa,37647794,13645781,140221,204288,216649,153294,1152169,51838,1778238,1204007,0,4014900292,201676244,15756,[LV21]Lords of Valinor
189072394,ᴵᴾLaura,37581186,51126391,1312098,15223045,383206,780510,3891089,264122,20541972,4155211,0,6355965622,362529904,27568,[LV21]Lords of Valinor
185986678,卂尺丂,36954265,91846834,1214629,681974,1395198,1304176,7560868,404733,11346949,7965601,0,3322868864,1223919485,15171,[LV21]Lords of Valinor
188789133,MiniMe,36870063,42476021,359853,260258,224998,177101,3821353,152602,4636312,3973955,0,5080566492,34179151,11995,[LV21]Lords of Valinor
188648613,Känguruᴵᴰ,36588762,25538784,340214,377701,272323,171077,2091875,165777,3078753,2257652,0,2953884233,286935074,13516,[LV21]Lords of Valinor
188276623,ᴸᵛArork,36363975,91915549,961128,7304379,1269333,1365737,7613004,316151,17868604,7929155,0,3872371708,360935366,16794,[LV21]Lords of Valinor
188805469,BossAlienᴾᴴ,36337961,69990201,1238059,250538,604492,927660,5961291,270378,8014359,6231669,0,5020720832,134750966,39904,[LV21]Lords of Valinor
189065897,W3llsFargo,35926102,36866964,662685,1191313,898257,213767,3194692,101510,5599539,3296202,0,3978222877,2754424297,19040,[21M]Immortal Myrmidons
185048534,Han Sansan,35645229,150889156,910143,979301,344434,570272,13461016,655659,16010682,14116675,0,6189410145,357367305,32648,[LV21]Lords of Valinor
185341770,ᶜᵘRalfish,35607866,60399425,2577295,843215,394122,498537,4521775,611532,6869181,5133307,0,2713206332,25760000,16085,[LV21]Lords of Valinor
182338045,亗ƧHiꟻT亗,35573433,150628524,1131937,2662150,1006449,1312309,10247812,2017792,17246512,12265604,0,5572729240,2545586970,32839,[LV21]Lords of Valinor
188333348,ᴷᴺLinh,35532296,70104133,935539,1902695,1645656,5139453,3916781,335333,12939918,4252114,0,4948379730,550111352,11110,[LV21]Lords of Valinor
186444772,Dr4gonツ,34951606,289385091,3324962,5956177,3581878,4318595,25023732,675920,39556302,25699652,0,5343190072,4407255328,39742,[LV21]Lords of Valinor
188794709,ᶦᵗˢᵘRYU,34895694,109556794,998511,1318150,2549412,2529700,8724680,341437,15463379,9066117,0,3785860677,94094214,35992,[LV21]Lords of Valinor
181534760,ᴸᵛSongoku,34708203,83069917,1462391,951608,718037,1206878,7102593,279504,10258620,7382097,0,3942160988,755945265,16366,[LV21]Lords of Valinor
188969981,ᵸᵒWand0,34494064,65852934,1286067,2054730,706949,524275,5336241,428429,9050624,5764670,0,4299659159,306699275,22642,[LV21]Lords of Valinor
185089489,ᴼᴾZOROGRANJ,34432058,89977952,1885507,550571,355159,737615,7809122,405792,9858259,8214914,0,5703855206,2083599610,21234,[LG21]Lords of Gondor
188336265,ᴸᵛiGREC,34399631,40103594,370445,535084,195209,299340,3462098,189391,4681122,3651489,0,2450337118,175934276,17514,[LV21]Lords of Valinor
189017405,ᵸᵒWizzy,34369867,39309436,1128087,812593,976175,1093762,2997282,142335,6022147,3139617,0,2778517130,170159151,14710,[LV21]Lords of Valinor
182713036,쵸ﾒMØTÃSÊMツ쵸,34098941,26368298,662283,107410,239091,451161,2334603,35898,3168163,2370501,0,5216141935,123301386,20808,[LV21]Lords of Valinor
190252265,Jamong,34051997,48035801,986726,240286,331209,224664,4135373,253647,5185179,4389020,0,5345394438,81003240,23659,[LV21]Lords of Valinor
188826595,Saf1974,34002295,126019425,1458385,1385035,561971,596074,9785512,1218953,13547545,11004465,0,5256377890,230946040,51599,[LV21]Lords of Valinor
188362493,亗MrDuck ツ,33892376,57978367,1226707,14227296,2044148,1147653,4304378,170511,21893986,4474889,0,2847637747,909611190,17156,[LV21]Lords of Valinor
188837916,Silent Kakashi,33800391,105876915,889638,839969,754922,750377,9809221,155268,12309757,9964489,0,1802727274,103761097,14062,[LV21]Lords of Valinor
188970345,PitBlue,33714865,103471743,903418,1127677,1623539,1658595,8383181,476647,13269639,8859828,0,4045179171,1077393394,23175,[LV21]Lords of Valinor
188501467,direraven,33601293,113304367,752809,5174288,2368802,2785599,8264977,686987,19280653,8951964,0,4932051229,4551820,27599,[LV21]Lords of Valinor
189154415,ᵸᵒMDKMB,33552581,64633908,791070,2593060,873151,733286,5003407,470089,9672993,5473496,0,2202846883,2686649393,20404,[LV21]Lords of Valinor
182317160,G  O  P  A R,33100308,181958180,2023644,5315311,2321165,2745552,15556380,485339,26423747,16041719,0,4301942688,754465485,29064,[LV21]Lords of Valinor
185612447,Chaudary Zain,33065348,146846462,1444870,9269291,1590830,914396,12575602,619867,24969986,13195469,0,4584685206,1323892732,25723,[21M]Immortal Myrmidons
188651684,Milo San,33046137,8042340,256838,43601,89395,77920,674115,40100,925131,714215,0,2999577648,359753808,12117,[LV21]Lords of Valinor
186841127,Anossss,32878878,96732783,1396074,5831747,161764,119554,8346773,564848,15024686,8911621,0,4310840755,4253401,14751,[LV21]Lords of Valinor
188736727,Alex9003,32841229,39909345,1661889,2965695,704903,767680,2742202,370683,7551163,3112885,0,4233496553,38138060,14381,[LV21]Lords of Valinor
187029935,HolySpirit,32776580,139214472,1508586,1270651,1347299,1593326,12091148,449048,16751472,12540196,0,2699705942,1104079437,19012,[LV21]Lords of Valinor
188368264,funne,32308290,33272269,1315248,897805,642680,597232,2395572,273135,4806424,2668707,0,3808771615,61698120,16890,[LV21]Lords of Valinor
185037763,ᵛBEARDY,32277187,51437912,2227119,28222212,2319488,801981,2906415,444121,34694217,3350536,0,4921911553,554484409,19513,-
187559873,ｱ尺ﾉ丂ᄃﾉﾚﾚﾑ,31983704,62577567,524842,786256,540194,444292,5234590,360843,7366175,5595433,0,2629725287,626443180,15368,-
188352541,ᴾᴿ Mèoッ,31973971,127518876,1258710,7188100,1700314,1303642,10538936,603835,21334827,11142771,0,6210768998,0,14417,[LV21]Lords of Valinor
188225231,ᴾᴿSko0p,31928090,33459441,362846,178306,89071,72567,3099403,98067,3537414,3197470,0,4568964965,0,27269,[LV21]Lords of Valinor
190407807,동탄불주먹,31825907,29393118,1082915,1045271,330899,696549,2256677,158465,4487861,2415142,0,5367711896,433522789,15738,[LV21]Lords of Valinor
188242643,hoahaizz,31769731,125342482,960344,3664404,983434,590291,10198875,914641,16351645,11113516,0,3845697953,4457191315,30547,[LV21]Lords of Valinor
188847278,ᴸᵛQuang,31767910,156416688,1233699,1297840,1436737,1289374,13827307,492654,18343912,14319961,0,4143141426,1618614837,34536,[LV21]Lords of Valinor
188833519,JulieLaTueuse쵸,31747517,29358324,658444,141152,346846,94148,2531257,147362,3260765,2678619,0,3603903046,37720000,20105,[LV21]Lords of Valinor
188451175,ᵸᵒTerra,31679968,60330864,870910,3422823,860914,534113,4853150,362826,10033826,5215976,0,4066628218,92432122,22539,[LV21]Lords of Valinor
189045190,Azura21,31410841,28966509,1079446,528436,682624,3020226,1491111,25178,5747575,1516289,0,2809004926,423984134,8185,[LV21]Lords of Valinor
188316323,ᴸᵛ SAKURA,31032640,103904316,1378468,2386732,1137444,2024123,8778847,263356,14590502,9042203,0,4151703695,539454569,26859,[LV21]Lords of Valinor
188598120,ᶻSharineko〤,30990368,93672833,982600,925849,1457411,810508,7229999,751541,11175308,7981540,0,2372887112,63185747,17662,[LV21]Lords of Valinor
188364390,ᴸᵛLeonPoi,30954046,158003555,1363790,518948,400864,665017,13736413,853692,16174934,14590105,0,3838852107,108004980,37111,[LV21]Lords of Valinor
185724517,Feldgraŭ,30906696,148059187,1759486,439339,3849630,1436815,11170614,1140933,18037331,12311547,0,4251305527,178066760,33572,[LV21]Lords of Valinor
184882401,Ферма а,30637166,92480601,1751855,22831138,3000621,3316968,6293708,285409,35727844,6579117,0,2694259785,3538154179,17503,[LV21]Lords of Valinor
188285810,ᴵᴰJupanu,30634320,52133016,1139226,875231,1573881,523582,4135952,267818,7376464,4403770,0,4877427972,57408174,20355,[LV21]Lords of Valinor
188876886,ᴸᵛTheanh,30524345,156133674,1388404,17901111,323206,628120,13750806,594325,33197568,14345131,0,5592173014,107966937,36141,[LV21]Lords of Valinor
188262339,Kitty27,30515560,8586612,109121,58400,178359,37776,575261,115725,965521,690986,0,3901059004,23588840,11274,[LV21]Lords of Valinor
188961098,Chocolalat,30362586,2667617,220977,51569,65233,15462,226419,10040,368723,236459,0,4240108897,21199999,3662,[LV21]Lords of Valinor
189001955,ᴸᵛTruNguyen,30313429,34803561,725153,1039838,168924,415164,3020441,119634,4764001,3140075,0,4502059983,231678867,17079,[LV21]Lords of Valinor
181581608,Fledermauz DB,30300813,37243233,694585,248895,300074,511759,3416369,19129,4496226,3435498,0,3616659454,377676127,7850,[LV21]Lords of Valinor
188797972,21LuviVilu21,30185119,21647635,1485800,587315,524579,345021,1642331,133881,3233127,1776212,0,4442555115,34539709,16115,[LV21]Lords of Valinor
188944242,Đạt Feet,30164964,23416085,783287,794019,734205,1502573,1353810,112024,4496631,1465834,0,4706072861,16457231,9413,[LV21]Lords of Valinor
185923730,JFDLCA,30155112,285229030,474199,5150543,3803977,6044367,24046806,597272,39642965,24644078,0,4777065467,386336005,37029,[LV21]Lords of Valinor
177013392,ᴸᵛ UCC15,30143892,40187311,2690015,1200429,936753,881360,2997858,228485,6244885,3226343,0,5381677759,192271545,16263,[LV21]Lords of Valinor
188293704,ᴸᵛDrMusaab,29724433,45641826,1613595,191214,427716,173783,3854486,275408,4922607,4129894,0,3850124501,84578452,14761,[LV21]Lords of Valinor
188789684,ᴿᵃtMadson,29716075,25314393,558556,1318578,162620,152532,2144219,133656,3911605,2277875,0,3978594948,92421016,41916,[LV21]Lords of Valinor
186295211,ᶠˡVENDETTA,29659742,115576250,2742984,4081984,1084740,528626,9229579,909004,15833933,10138583,0,3885646386,1050356942,20089,[LV21]Lords of Valinor
188335709,Rebel Rogue,29646296,74476257,1366902,1040029,700124,771386,6310028,334109,9155676,6644137,0,3481882713,34205137,33796,[LV21]Lords of Valinor
186043643,ƐKA,30017193,66412584,1325466,948183,319988,430578,5706384,339841,7744974,6046225,0,3307144931,501165307,31017,-
185651937,ᴳᵃʸGrizzy,28913873,394704092,1530202,11881112,5833583,11664631,32492852,453683,62325861,32946535,0,3744084354,952357579,20305,-
188830020,ᴸᴳVersized,28886560,71672121,891087,658409,938556,437662,5862888,464190,8361705,6327078,0,3835057989,46055668,11071,[LV21]Lords of Valinor
188543996,ᴸᴳﾒNØHOPEツ,28620750,27663640,832839,367702,78081,197027,2406743,128920,3178473,2535663,0,3411662070,31608954,12199,[LV21]Lords of Valinor
186709522,ᴸᵛ SHERY,28441773,62185658,1562880,609853,401512,544566,5212806,347717,7116454,5560523,0,3409511725,99489407,9543,[LV21]Lords of Valinor
185282573,ᴸᵛ3621 BANK,28384177,62632106,771884,668111,1267167,649115,4855577,440596,7880566,5296173,0,1380539730,2253285969,8673,[LV21]Lords of Valinor
188819438,ᴸᴳLuca,28371247,46983742,616568,378993,894190,250296,4088058,161890,5773427,4249948,0,4256954061,626280200,24205,[LG21]Lords of Gondor
188853241,Алёнаа,28174506,28003663,751734,247949,344883,856812,1850580,266563,3566787,2117143,0,4578698547,45525540,13084,[LV21]Lords of Valinor
188453555,Puyols,28172968,60922765,1151228,436986,356297,226446,5266867,327416,6614012,5594283,0,6907174875,127173124,24982,[LV21]Lords of Valinor
188788713,Sam smith,28123607,36247697,772626,601729,331796,180165,3096282,189014,4398986,3285296,0,3933549282,33958258,12683,[LV21]Lords of Valinor
182720562,ᶜᴹᵈSkyy,28092367,19752884,2388318,291902,77615,310791,1289299,270156,2239763,1559455,0,3999667646,685652689,12498,-
188547640,Kitty8152,27978791,1630693,12032,78078,153637,150776,70470,0,452961,70470,0,6431065511,2547000,7711,[LG21]Lords of Gondor
188880546,Graf000007,27786109,4086246,1602923,195112,206722,115320,276770,20240,814164,297010,0,3525457093,0,4108,[LG21]Lords of Gondor
188872694,DELİ ÜSTAD,27652680,5962066,716649,208561,290491,524323,257508,33350,1314233,290858,0,4370054545,39905983,2138,[LG21]Lords of Gondor
188806334,Emrah 51,27555499,3751158,1312229,1012,10602,4008,371372,0,386994,371372,0,4144112650,0,4425,[LR21]Lords of Rohan
188852900,Scorpionking乂,27537388,86546597,2576331,701687,536852,1689544,7398736,229351,10556170,7628087,0,2255315533,58256706,327117,[LV21]Lords of Valinor
185538462,UMAYKIZ,27406331,83778027,1228227,2428097,767351,902894,7178353,318130,11594825,7496483,0,4091375133,8566632,6487,[LV21]Lords of Valinor
188294260,CЦEПИOH,27142026,10421111,1855157,581297,556310,288078,772954,15519,2214158,788473,0,2747070645,173206292,7540,[LG21]Lords of Gondor
185602720,ˢᵉAbdallah,27055353,37680310,200395,749910,727131,953454,2914261,155982,5500738,3070243,0,1730155469,127071312,10129,[LV21]Lords of Valinor
188192835,SвулканS,26912331,19967704,388225,2031363,306088,979874,1431780,35598,4784703,1467378,0,3369791466,52162299,9148,[LV21]Lords of Valinor
189141193,ᴸᵛJankels,26876919,65828229,899417,5409357,1932099,2347605,4719550,214812,14623423,4934362,0,3365232093,28726902,16825,[LV21]Lords of Valinor
188544046,G4mine,26718340,28362778,2022351,262704,631545,296942,2242480,171729,3605400,2414209,0,4317317823,247760315,20193,-
188365363,diegokristy,26683503,51716215,476980,429498,640200,815724,3975172,366765,6227359,4341937,0,3732548700,246281206,15857,[LV21]Lords of Valinor
188818127,ᴿᶝ风华,26640600,2158531,1064759,62955,74067,33164,157987,14264,342437,172251,0,4177206907,64472747,3929,[LG21]Lords of Gondor
188575943,BATUMSKİ08,26625140,124654920,2518476,8729094,9991171,6956425,7155716,177195,33009601,7332911,0,2820885482,529137921,20887,[LV21]Lords of Valinor
188836051,Cheops Pyramide,26609654,78091823,1222442,665596,285383,464232,6982969,285066,8683246,7268035,0,4537325894,751419894,38932,[LV21]Lords of Valinor
84905552,Schwazzier,26606981,10701276,506526,147563,86882,62010,838244,93376,1228075,931620,0,3238129736,60672597,8301,[LV21]Lords of Valinor
189040679,ㄴHORIZONㄱ,26495211,74776471,764075,947828,1035889,885967,6855262,20932,9745878,6876194,0,4541245002,188105599,14268,[LG21]Lords of Gondor
188939030,TBILISI,26462419,7839558,1253222,516250,1297487,330601,372081,4906,2521325,376987,0,3097098501,460258,11739,[LG21]Lords of Gondor
188364525,ᴵᴾEmrys II,26412458,3119874,218964,53070,30135,8285,294045,3770,389305,297815,0,2091717356,0,2715,-
188877484,ᴵᵀBLOOM,26240463,73412319,1615750,429658,286070,678042,6496736,253736,8144242,6750472,0,1847010287,111895750,28933,-
189939798,ʰᵒDestructor,23985704,19723170,52616,21684,68111,82633,1909078,8065,2089571,1917143,0,2928573864,11281500,896,[LV21]Lords of Valinor
188836483,YenifferDeRivia,26020679,41837660,1714676,1784534,2318341,1691838,2868362,69655,8732730,2938017,0,3409146471,140738085,4887,[LR21]Lords of Rohan
186010544,Mehmet027,25796643,62968898,1626376,1870063,1718352,2118048,4930765,68917,10706145,4999682,0,3069259292,173638054,9369,[LV21]Lords of Valinor
188806124,ᴵᴾAltar,25682493,111614407,1481141,3177848,4192360,2583327,8685363,270359,18909257,8955722,0,2531022967,7742830,26734,[LG21]Lords of Gondor
188912287,ᴸʳgCoelho,25582872,37205295,820622,1467378,848164,1089303,2821252,132288,6358385,2953540,0,2465387741,113818904,7408,[LV21]Lords of Valinor
188277784,ᴵᴾPecimura,25471519,28014853,96045,30115,106786,86982,2470635,137049,2831567,2607684,0,2004901092,30935666,8683,[LG21]Lords of Gondor
188855274,GOLTEB,25474039,130249344,1327294,1219432,175391,426239,11912788,441092,14174942,12353880,0,3412250344,35237187,42124,[LV21]Lords of Valinor
188835262,vinzsou,25441725,21197939,412411,54559,97814,69115,1915356,78069,2214913,1993425,0,2311185245,0,13416,[LV21]Lords of Valinor
188891048,7BeLa,25348582,57642914,872000,370252,777201,2820258,4394591,39376,8401678,4433967,0,3249200119,137794496,5869,[LG21]Lords of Gondor
146179581,lupepvp,25027557,13849126,618028,207971,115291,37945,1123945,109286,1594438,1233231,0,5427015870,108915418,15949,[LV21]Lords of Valinor
188320476,ᴿᵃЛиса,25091987,46189864,1180179,367833,506674,549870,3875059,207644,5507080,4082703,0,4842831750,362428945,40190,[LV21]Lords of Valinor
189236516,ᴿᶝ年华,24673456,2290337,936926,56107,169818,48265,162204,6219,442613,168423,0,3799804359,48671853,2980,[LG21]Lords of Gondor
188319008,ᴸᵛКэп21,24483757,10075514,29597,216150,128394,92909,914970,12708,1365131,927678,0,2233408969,0,10987,[LG21]Lords of Gondor
185094982,Phi Dương F2P,24438028,38331232,1940175,2842133,5213473,4079345,964930,68459,13168340,1033389,0,2125376882,147926355,5517,[LV21]Lords of Valinor
188324838,ХОНДА,24413953,7990779,1618420,319927,430706,215833,601619,9293,1577378,610912,0,2520068321,122738819,6016,[LR21]Lords of Rohan
188937309,Velikiy Govard,24326788,9823194,638326,125640,141509,280242,795672,21868,1364931,817540,0,2760775123,125678023,5283,[LG21]Lords of Gondor
188899189,QuantSist,24173168,1720056,385409,11624,68715,76283,127517,0,284139,127517,0,2122271929,296458,5589,[LG21]Lords of Gondor
184845080,ᴸᵛSCAR德,24106120,59044985,674804,215275,313814,201078,5133337,311831,6175335,5445168,0,3931532204,46674299,28706,[LV21]Lords of Valinor
189057248,Cekko23,24004156,25143406,621793,180774,267446,395040,2050364,124428,3018052,2174792,0,3722649993,76002446,11481,[LV21]Lords of Valinor
188840841,ᴸᵛNotZach,24024452,32939204,548532,661641,826162,444933,2565980,185751,4684467,2751731,0,1685796358,107725390,4664,[LV21]Lords of Valinor
188376202,ᴵᴾ云霄,23850217,6580450,1214571,147461,159504,83670,521541,34093,946269,555634,0,2594984100,17020000,4283,[LV21]Lords of Valinor
181974650,IDEM City,23791400,2030305,1163258,142285,141908,58538,141798,3295,487824,145093,0,3776027518,86095121,2071,[LG21]Lords of Gondor
184872506,ᴾᴿF A J A R,23766513,81330450,1396757,2282220,2097345,3030279,6197714,129053,13736611,6326767,0,3250277163,28252952,13422,[LG21]Lords of Gondor
188880486,Kỳ tiktok,23723331,9134722,1062496,68271,30446,79884,647748,113158,939507,760906,0,4092980863,0,3284,[LV21]Lords of Valinor
188793523,FerAmaya,23724594,14144029,506442,137105,231910,107247,957884,182248,1616394,1140132,0,3618381186,43532335,5409,[LV21]Lords of Valinor
188994494,Snowplow,23380274,1094552,236306,8504,103749,19351,80795,0,212399,80795,0,2947021244,0,3473,[LR21]Lords of Rohan
187503097,Romulus1991,23305239,35322045,243649,236337,79945,281812,2962594,218085,3778773,3180679,0,3974413835,82802396,18122,[LV21]Lords of Valinor
188390528,ᶦᶠAkrosh,23306956,14179254,358164,80861,884019,546131,1021052,0,2532063,1021052,0,1408491622,139317710,2243,[21If]Immortal Falcons
188851823,ᴸʳMent001,23168979,706360,45963,213744,185983,43829,11633,0,455189,11633,0,2053526446,0,2793,[LR21]Lords of Rohan
191454845,ᴸᵛTueAnh,23099669,24754938,683409,6097691,110426,294887,1948174,132663,8583841,2080837,0,5733713463,1141408023,12497,[LV21]Lords of Valinor
144563085,ᴵᶜPARANOIA,22878266,4730553,1770534,15817,22531,23272,408292,25316,495228,433608,0,2831381744,1021382,4811,[LG21]Lords of Gondor
188937116,ᴵᶜTom,22847232,4798418,78668,26543,281358,25756,401873,5432,740962,407305,0,2254933220,6485919,12148,-
188661481,Kängurufarm,22685146,2847269,781585,208965,117034,10247,253042,0,589288,253042,0,2409834236,1128542199,4146,[LG21]Lords of Gondor
188842111,JJ00,22535635,12699687,546042,13757,120082,40863,1080466,74433,1329601,1154899,0,2619609251,3999999,3677,[LV21]Lords of Valinor
188830522,ᴸʳTylnmrl,22389052,1670861,37663,32839,20609,4164,155652,2495,215759,158147,0,2344244017,16585000,4669,[LG21]Lords of Gondor
188234979,iGRECfarm,22319661,15844038,286311,273003,46153,43158,1490992,30729,1884035,1521721,0,2703807026,315563112,10672,-
188639928,The亗SCARFACE,22178323,2476955,64606,145589,285116,162864,116131,3242,712942,119373,0,3254171295,44040000,4355,[LG21]Lords of Gondor
186016235,卂丂卂千,22126860,5571622,172363,142922,151729,14030,405110,56618,770409,461728,0,1997490685,12932669,3892,[LV21]Lords of Valinor
188878743,Jetare,22092838,15241706,984262,914090,1762279,1205895,613645,28715,4524624,642360,0,3300560305,91210728,3115,[LV21]Lords of Valinor
188664465,ᴸᵛEren 勇,22074129,49965974,1623051,606890,681174,827892,4278040,119514,6513510,4397554,0,1902975921,650343921,22154,-
185905587,Ze Boshman,21929998,4802837,1158706,309125,97861,13805,369719,39644,830154,409363,0,2770839083,41584565,2619,-
188870613,xXVincinetteXx,21868756,8307709,1851059,867867,503902,29008,656394,22318,2079489,678712,0,4699104174,5876311,23600,-
188846843,BoboFranek,21704370,1436892,86860,96434,230127,133623,42286,0,502470,42286,0,1842439115,45731253,5585,[LG21]Lords of Gondor
184817793,meto 313,21672529,2940073,2001835,184629,125724,112750,75554,72258,570915,147812,0,3025966242,1827622,1808,[LR21]Lords of Rohan
188838640,Presidente CIAO,21625090,3248958,61803,13150,115426,83389,268192,0,480157,268192,0,1671616680,23800000,4582,[LG21]Lords of Gondor
188255601,Ant Man21,21587050,21740037,261646,303216,192688,238972,1939567,47123,2721566,1986690,0,3143089623,0,3958,[LG21]Lords of Gondor
188337674,ᴵᴸAxan,21396102,13852737,908861,382486,81728,81286,1314956,6904,1867360,1321860,0,2648070537,376836150,9613,[OP1]OP CLAN
188819819,fox77778,21361337,3782562,738594,75581,204618,428450,164441,0,873090,164441,0,3381427824,1037349,4762,[LG21]Lords of Gondor
186018265,yıldırımsefa,21255660,12642300,258459,159713,850626,471324,812371,45005,2339039,857376,0,3143688481,50620184,8903,[LV21]Lords of Valinor
189036655,Vitia back 1990,21171001,9551108,2056000,172660,105414,21917,821704,50052,1171747,871756,0,2750426383,9800000,8608,[LR21]Lords of Rohan
188856715,ᴸᴳJackie,21045312,15197220,284873,80252,30041,24787,1332528,84833,1552441,1417361,0,1290194986,20000000,4186,[LV21]Lords of Valinor
188889549,СЦEПИОН,21044476,2997871,1241527,21675,25683,72660,248333,8410,376761,256743,0,1929432752,102567597,3695,[LR21]Lords of Rohan
188876948,Ruberoid,20822879,1308095,30041,24678,63862,55794,95226,0,239560,95226,0,1492296960,3846529,4626,[21If]Immortal Falcons
188443825,йкйцк,20721165,48743894,1313992,1943111,2457331,1223280,2839555,507597,8970874,3347152,0,2532968576,1971457076,21172,-
188884453,dm152,20717792,261473,0,20838,55033,4660,12860,0,93391,12860,0,2768590157,0,4380,[LG21]Lords of Gondor
188790227,СУЛИМАH,20689024,2937806,1265520,69552,52214,89972,230812,7573,450123,238385,0,1855508039,102878721,3417,[LR21]Lords of Rohan
187197359,Demir Bilek,20680499,9273471,779097,120768,235808,174193,781889,13102,1325760,794991,0,2313761115,30192868,11252,[LG21]Lords of Gondor
188853064,TerrorBlade98,20464769,4698786,941546,120572,115534,39441,414286,7149,696982,421435,0,3397014243,0,1381,[LG21]Lords of Gondor
188836639,Ndiaye,20437596,5853377,660696,352077,491543,747064,181162,0,1771846,181162,0,3036367661,383503,1637,[LLA]Lost legion academia
184819319,joe200,20426646,2022401,1197317,130789,249677,21520,45323,47879,495188,93202,0,1631673131,91263980,5852,[LG21]Lords of Gondor
145631489,BABA SON,20420494,7880142,290848,136434,494296,267396,373532,102968,1374626,476500,0,2319664679,4400000,5236,[LV21]Lords of Valinor
188903920,JoshuaSeil,20416005,6169856,820331,57540,197750,100917,483086,26416,865709,509502,0,2970338273,301497,4259,[LV21]Lords of Valinor
183360513,ᵀᴸмønoメ,20415868,26110591,478300,186118,247673,221163,2277659,95839,3028452,2373498,0,2125813241,85509847,6981,[LG21]Lords of Gondor
188884272,ZHIANZD,20398835,1216090,246973,127800,150740,29760,77001,0,385301,77001,0,2488342395,0,2033,[LR21]Lords of Rohan
188847403,Vali188847403,20380868,1805843,502942,88125,113717,240436,59904,0,502182,59904,0,1175700329,0,641,[_NDM]New Jersey Nol
188806434,ᴸᴳ Bimz,20262543,5080363,658635,38897,29786,6973,390944,53784,520384,444728,0,3061786742,29458520,9965,[LV21]Lords of Valinor
188325495,쵸 See La Meet 쵸,20218723,26136473,714725,1038428,1614240,1553702,1521512,63519,5791401,1585031,0,3512199870,0,7931,-
191530671,ᶦᶠtMadsonn,20211141,1846035,34099,69047,86817,200703,85578,0,442145,85578,0,2694177227,910375198,4638,[LR21]Lords of Rohan
188857113,GritNGravy,20196778,1953070,46395,39362,14347,20181,183578,0,257468,183578,0,2981158195,3200971,3747,[LG21]Lords of Gondor
188261313,freezebee 21,20070819,2027071,234347,244875,375237,108803,79241,0,808156,79241,0,1784309560,5187959,14640,[LG21]Lords of Gondor
188898779,kral jon snow,20021340,113087,6227,15339,20427,859,6573,0,43198,6573,0,2753058077,8327554,2901,[21If]Immortal Falcons
188644411,IQ777,19923652,10297771,72917,271035,682547,244380,661655,64220,1923837,725875,0,1174120561,127703632,20887,-
186613612,Inigo Montoya1,19879548,4819124,1455414,349831,116242,28761,406977,16593,918404,423570,0,2728576217,103076547,8767,[LV21]Lords of Valinor
188814205,SUBUTAİ 38,19815144,1466044,274608,292102,181430,22696,95398,0,591626,95398,0,2021022942,3080000,2319,[LG21]Lords of Gondor
189075824,NooByZ,19621709,8523920,1530004,77034,121760,128921,748617,13157,1089489,761774,0,3365718003,99259891,19016,-
188430882,JapayuKingBILAT,19588517,16224241,589575,264537,718955,348631,1254670,39610,2626403,1294280,0,2920008022,142262581,16038,[LV21]Lords of Valinor
188232993,AKON311,19570367,17474104,658995,571073,531874,842388,1182997,54831,3183163,1237828,0,1770213436,850687088,12260,[LG21]Lords of Gondor
188539042,Chieu F2p,19563032,33659485,572222,886405,1728535,661706,2285137,226347,5788130,2511484,0,2156545974,185342934,11722,[LV21]Lords of Valinor
140534782,ᴵᴾCoCaSNX,19345651,21797010,531203,1203243,267031,348395,1715668,123602,3657939,1839270,0,3530980381,2108538017,6924,[RC21]ROYAL CROWN
188776545,ᴳᵒᵈ Ingle,19312962,1048600,93501,85140,135892,24107,66336,0,311475,66336,0,1714419959,3404666,5154,[LR21]Lords of Rohan
188838663,ERON,19222660,7863869,732610,213966,443761,85721,647213,5927,1396588,653140,0,2028990199,20081022,12095,[LG21]Lords of Gondor
184859052,ᴸᵛamadxd1,19221520,11242441,1696065,175899,454668,303269,793425,57530,1784791,850955,0,2272889679,315992716,7308,[LV21]Lords of Valinor
188360951,SATORUGOJO1,19141927,9648765,472927,508838,996498,575503,454115,35542,2570496,489657,0,1617479709,317828071,6794,[LV21]Lords of Valinor
188818238,PoTaPyh,19129159,17945708,847850,488230,854873,981299,1155520,32896,3512818,1188416,0,3095818334,301072527,13050,[LV21]Lords of Valinor
188827507,Dug1man,19125225,106428,5346,18103,18794,0,6522,0,43419,6522,0,2615672502,0,2504,[LG21]Lords of Gondor
188367613,ᶦᶠKinkyTail,19079489,31473081,685293,1501619,757662,736951,2401851,134556,5532639,2536407,0,1024801401,58186939,13452,[LV21]Lords of Valinor
186011194,RTHAlek607,19069278,35766505,529513,503086,617804,436705,3145940,61203,4764738,3207143,0,3156745349,271316554,20311,[OP1]OP CLAN
164927516,Iᴠᴀɴツ07,19022774,10598389,800589,584997,950594,899393,450217,24023,2909224,474240,0,1150997560,29829009,6510,[LV21]Lords of Valinor
188490339,Eudaimonia,18911911,6979272,227320,56910,36785,12770,605770,39277,751512,645047,0,3397688925,30962500,6057,[LV21]Lords of Valinor
188869412,dân chơi đá,18877333,8228309,246570,288205,739830,1185717,194814,0,2408566,194814,0,2106256471,1154652,1641,-
188806199,Op khan,18768398,4774879,1311876,240925,827408,507637,83281,10426,1669677,93707,0,3008747837,4253716,3284,[LR21]Lords of Rohan
188844580,RedHoodJT,18733886,3724748,210774,117223,615129,546669,28437,0,1307458,28437,0,1736827787,0,1493,[LR21]Lords of Rohan
150165925,ᴸᴳken arok,18723723,23080945,626373,4481846,278206,119051,1916932,99132,6895167,2016064,0,2507392153,26909895,12186,[LV21]Lords of Valinor
188836606,Black AngEL,18388085,8655975,1937740,908418,995278,553139,422312,2403,2881550,424715,0,2141610562,18536152,1822,[LG21]Lords of Gondor
188336750,SKY EAGLE,18136313,7121747,985124,330019,49903,45477,677403,0,1102802,677403,0,1931799839,213802552,9588,-
189014302,magister,18060393,11593788,947900,205152,1188782,528161,695989,5133,2623217,701122,0,1327725746,15363819,7384,[LG21]Lords of Gondor
188823442,VIP shooter,18054177,3305125,846887,132688,41914,75500,277768,5754,533624,283522,0,1675592376,41800001,5299,[LG21]Lords of Gondor
188787622,MalandrageX,17911504,20690,0,2434,1687,245,1585,0,5951,1585,0,2550463655,0,3294,[LG21]Lords of Gondor
188865329,Việt hoang 07,17892195,607097,64769,419495,234049,900,5150,0,659594,5150,0,2214217502,1833721,888,[21M]Immortal Myrmidons
188884243,HiagoLira,17903770,1361299,1,5567,1871,82946,102466,0,192850,102466,0,1673300617,0,2376,[21If]Immortal Falcons
189231766,darkkiller666,17669854,3746982,286312,236683,195194,50737,294065,8283,784962,302348,0,2533244060,20289481,14046,[LG21]Lords of Gondor
188487100,Kir8,17669699,744292,46498,47082,45400,57564,41382,0,191428,41382,0,612457103,0,4413,[LG21]Lords of Gondor
196566747,Codrin4Valhalla,17661996,8039404,238960,278433,157181,127114,642058,37016,1241802,679074,0,653910155,105200399,6616,[LV21]Lords of Valinor
190852683,BossAlien FARM,17618699,6771910,168409,19244,81805,135783,606132,0,842964,606132,0,4361562822,1694123182,2709,[LR21]Lords of Rohan
187016834,卂几Ҝ卂1,17485369,5969476,107689,89142,174787,122716,511121,0,897766,511121,0,2808116054,1649060086,4842,-
188904786,Shadow vahalla,17484585,951871,236630,6845,11062,4462,91053,0,113422,91053,0,2895472214,0,3038,[LG21]Lords of Gondor
189068044,Hsotits7,17466946,13123610,995230,966771,1440390,1040579,499742,44487,3991969,544229,0,2205296903,16241240,3504,[LG21]Lords of Gondor
188879533,Qertt7,17313562,188791,322,8039,23990,816,10230,1682,44757,11912,0,4212733977,38000000,2204,[LG21]Lords of Gondor
188368666,Derik 災,17193465,17311218,78795,189202,156137,96806,1633226,12081,2087452,1645307,0,1504456225,57910439,4670,-
188868206,Quocbao05032012,17138666,1765350,652703,140343,12908,5049,169127,0,327427,169127,0,1795608881,6000000,2056,[LR21]Lords of Rohan
188432088,BandAid,17089804,6291099,303434,23738,88926,146960,503492,24287,787403,527779,0,3096265216,308659606,8349,[LR21]Lords of Rohan
188585266,メDragønメ,17046256,6200803,260935,13008,75292,24207,548489,23295,684291,571784,0,1565973095,73489482,19339,-
188503741,SİYAH KAZ,16994656,2745204,35926,148261,185391,246920,121345,7182,709099,128527,0,1557000457,38351774,6878,-
188833114,Quent2,16989080,28402168,426151,334512,76938,382240,2357331,153956,3304977,2511287,0,1501362112,21298007,10851,[LV21]Lords of Valinor
188928573,Thànhteo,16834657,1269484,231737,5214,47138,152454,56435,0,261241,56435,0,1518718910,0,3090,[21M]Immortal Myrmidons
189181702,222mb222,16790176,2096107,769471,199359,63662,40288,176776,0,480085,176776,0,3170899683,225401626,1755,[LR21]Lords of Rohan
188824641,Sabesaur312,16783039,178017,72,61605,21023,10955,7983,0,101566,7983,0,717328751,0,1962,[LR21]Lords of Rohan
188845980,Azadi,16707316,2414584,591878,280392,474111,105066,99002,0,958571,99002,0,1863882325,3366983,1072,[I-am]RoyalLoyalMembers
188861925,blackbandito,16603350,3299236,432177,181283,407143,143151,130863,28373,890813,159236,0,1587463977,24105565,2008,[LG21]Lords of Gondor
190329472,F1Quang,16557564,14222941,1403680,76015,288128,303523,1225945,7897,1901508,1233842,0,4043715673,2942670794,8519,[LV21]Lords of Valinor
188894198,Tomioka senpai,16517707,379272,52185,4153,47557,61967,3546,0,117223,3546,0,2627690647,0,1818,[21If]Immortal Falcons
188513738,MooSáke,16340499,198927,96089,15385,14235,12870,11590,0,54080,11590,0,1815534891,0,1221,[RC21]ROYAL CROWN
188436016,KiLLedYouhaha,16257233,7835320,255634,186713,224968,166588,620167,24001,1222437,644168,0,2680979771,135055118,10095,[LV21]Lords of Valinor
188852196,DarkExecutioner,16177458,1452447,100617,60616,84044,164244,61526,0,370430,61526,0,1216662089,28060602,1834,[TFS:]The Forsaken Souls
188876717,DEWO YEAGER,16023961,5410832,1101397,456314,785790,354455,230881,1068,1828508,231949,0,2561404689,0,1793,[21if]farm 21If
187880560,wcwc,16017764,230115722,1527635,19485000,18674475,23053443,9591814,36893,70841625,9628707,0,3214040764,596448438,13547,[21if]farm 21If
188376429,ᴵᶜmySoul,15863805,447638,94861,165290,199177,4054,1,0,368522,1,0,1317663453,7488905,8468,[LR21]Lords of Rohan
188134384,ˢ carlossainz,15730884,6601011,1300774,21788,65922,52235,498539,63524,702008,562063,0,1190118090,25406959,4007,[LG21]Lords of Gondor
188825002,Namiq Cebrayilo,15673313,3934535,1259596,213707,290110,151386,270603,0,925806,270603,0,2264201192,0,775,[LG21]Lords of Gondor
188857667,Apoathou,15552635,1322660,1124764,128214,19733,13903,120194,0,282044,120194,0,230139173,156690,1092,[LG21]Lords of Gondor
188878343,Cheiron City,15509672,2006372,65708,76640,299335,127026,88427,0,591428,88427,0,1369437548,0,1667,[21if]farm 21If
186035363,Klgi20,15502890,1079100,1084576,54111,135908,7883,18115,29189,245206,47304,0,1920614662,1200000,3140,[21If]Immortal Falcons
187078010,Dr4gonsFarmerツ,15490724,22163921,1316246,641729,1799365,1256244,1338903,1142,5037383,1340045,0,2602487365,1725005764,7894,[21If]Immortal Falcons
188825941,S0SKA,15447745,1189854,237525,181770,115056,123932,42766,0,463524,42766,0,1573181792,17191302,2471,[21M]Immortal Myrmidons
188809474,Edgar15,15275743,46285,13168,43659,11087,2650,478,0,57874,478,0,2116886110,0,1245,[21M]Immortal Myrmidons
188879219,Akglate,15231878,247677,40137,19567,121882,0,0,0,141449,0,0,2071709078,1758755,592,[LR21]Lords of Rohan
187560016,Kyubi Farm1,15179147,43242083,1156562,1634869,1976614,1528733,3245429,19633,8405278,3265062,0,1354099339,409430369,6748,[LG21]Lords of Gondor
188877463,Se Tuath De,15160541,1904865,811661,93157,158781,182383,83914,0,518235,83914,0,2580568611,5600000,2445,[LG21]Lords of Gondor
188785649,priam,15077958,1750608,803133,48303,27617,11291,164055,0,251266,164055,0,1492426308,18007168,328,[tgqm1]amarl
188858878,lisabella,15023338,237752,277117,67710,112105,0,0,0,179815,0,0,582058911,0,1621,[21M]Immortal Myrmidons
188781490,Fra1d,14963604,1187031,100258,39857,116341,94712,56753,0,307663,56753,0,1220961083,5509155,3143,[LG21]Lords of Gondor
188800436,LilPiglet,14965868,769658,220953,34240,152043,47076,27042,0,260401,27042,0,1373555406,0,1296,[LR21]Lords of Rohan
189036275,TheBlackDragon,14933728,163506,24134,22964,32186,14353,3713,0,73216,3713,0,2058269997,0,1779,[LG21]Lords of Gondor
188365295,ᴿᵃTsumiki,14849316,2089406,0,8924,38778,19749,193107,0,260558,193107,0,1063300942,3762398,6032,-
12113325,Elena23EV,14848677,1817847,131418,8455,10921,55191,154067,1644,230278,155711,0,1149358278,24431024,5768,[LG21]Lords of Gondor
188863496,dark8582,14805765,408222,113485,9062,63839,37988,12678,0,123567,12678,0,1912476881,0,712,[jk10]jk 3621
188986083,KyoHN,14770298,58505,16806,10125,15173,711,2329,0,28338,2329,0,2349901910,69,2863,[LG21]Lords of Gondor
188963486,GÖZTEPELİ35,14745890,131575,0,26938,85,5222,10513,0,42758,10513,0,1956299993,230887100,3805,-
183848200,Ei Farm,14731064,38195393,1298931,2526718,1320489,1044558,2973860,56612,7922237,3030472,0,3111047090,519374881,13486,[LG21]Lords of Gondor
188802524,Yamato68,14724102,193221,131028,1699,7453,9839,13862,0,32853,13862,0,1224230305,13257436,2993,[LG21]Lords of Gondor
188902184,The Lost Legend,14664931,7058172,203577,72451,84459,10146,662590,10414,840060,673004,0,1204480667,0,6695,[LR21]Lords of Rohan
188847086,Dimiboy,14527283,75311,0,179,37638,0,0,0,37817,0,0,1257165423,0,30,[Tick]Tick tack
188796842,Menda2137,14427115,321687,136804,21106,48638,8855,18477,0,97076,18477,0,1124131552,0,1471,[LR21]Lords of Rohan
188873290,FarmЛиса,14338645,6668204,596991,64191,23711,6956,643102,7455,745415,650557,0,1515676502,122800001,4185,[LG21]Lords of Gondor
188806889,Gouverneur188806889,14331490,785370,316714,61610,182543,80923,8427,0,333503,8427,0,1097913878,0,1024,[21MS]Myrmidons Farm
188858305,Palestine313,14309726,3028033,1334422,129577,527939,188640,119168,0,965324,119168,0,1414339359,0,4,[Alg]Palestine313
188885945,whyreall,14191004,1427513,1410059,61686,45602,10688,128122,0,246098,128122,0,1497367838,862617,2035,-
188287771,ᅟᅠᅠᅠᅠᅟᅠᅠᅠᅠ ᅟᅠᅠ,14163617,55673152,491916,382510,936262,319444,5244635,0,6882851,5244635,0,5064638544,2464968833,28976,[LG21]Lords of Gondor
188856535,HOIANA,14077466,1190153,693357,435295,160981,54643,43890,6183,700992,50073,0,1825422664,400000,1190,[21if]farm 21If
123456386,Igoryan,14062673,5049921,193112,1352415,222892,143876,374139,838,2094160,374977,0,1456842406,11392165,1391,[LG21]Lords of Gondor
191177358,RtthyrFarm,14037074,52258,8925,14892,0,0,4928,0,19820,4928,0,3668033781,1594265331,1168,[LG21]Lords of Gondor
188832666,ChifOJ,14022298,2361104,125471,94442,41533,55215,203829,0,395019,203829,0,2627599443,0,547,[21IR] Corral
188931757,ᴸʳANTHRAX,14007150,659165,84307,164935,187652,32931,11915,0,397433,11915,0,1443661971,0,2113,[LR21]Lords of Rohan
170835406,ᴵᶜ Has,13955620,1445859,679890,46009,32626,7559,101847,16135,204176,117982,0,687055286,298517,2940,-
188896546,БорисBao,13857624,1182765,168254,14668,118405,170863,25957,0,329893,25957,0,1761224189,22966398,1423,[LR21]Lords of Rohan
188953179,SarahVinyard017,13756390,5795264,260817,103502,87804,304494,438098,0,933898,438098,0,1388844714,31860199,3832,[LG21]Lords of Gondor
188787790,You  andl,13704092,920284,416012,51124,134014,82128,31352,0,298618,31352,0,1394432008,4084888,1968,[LR21]Lords of Rohan
44936497,젝스킹,15991483,6996924,923387,39204,54846,41378,523118,74135,732681,597253,0,2183506756,0,9052,-
188837379,안정아남자,13507678,885792,199719,262430,137821,8581,52334,0,461166,52334,0,1900778126,0,1125,[LG21]Lords of Gondor
188527602,ᴵᴰROK 쵸 F2P,13501305,5484083,995214,421857,345578,97039,416904,7568,1288946,424472,0,1569741955,727650,10325,[P21J]PETANI IDAMAN
187795145,SOTER,13473232,8447735,539910,529189,65018,309343,652149,22650,1578349,674799,0,1286481653,112215799,15313,[LG21]Lords of Gondor
186073361,卂尺丂Farm,13435636,4138657,585035,39537,204145,32135,344752,7320,627889,352072,0,2286157342,489706596,1515,[LG21]Lords of Gondor
190539451,puyolF,13349295,972686,309560,2673,66571,105265,41795,0,216304,41795,0,4821625644,1818372170,2091,[LR21]Lords of Rohan
191069538,Shinnygamyy,13280650,3037148,499817,235031,755080,228183,56725,0,1275019,56725,0,1083252012,5089962,691,-
193596249,Korkusuz 51,13257437,239160,358859,12402,0,0,23668,0,36070,23668,0,1407021399,60357336,945,[LR21]Lords of Rohan
187257305,HolySpirits,13221458,4186335,271743,116035,83670,59317,375642,105,634769,375747,0,1164962213,477259605,5804,[21If]Immortal Falcons
188899884,hanaaaa230,13199265,3656113,993138,112016,538707,284659,141766,0,1077148,141766,0,1548547163,3785937,1118,[K~R~]3621 Utility Box
188836866,zlucifer,13134321,2684582,271491,220751,328964,145856,139908,0,835479,139908,0,1701695970,0,1524,-
185484265,Tors228,13083005,7740094,636018,1305674,1878812,627539,120762,178,3932965,120940,0,1312958755,25325363,7376,-
188887466,Jensamtresen,12961460,2851467,834974,287219,392239,254799,99035,0,1033292,99035,0,880825536,10799999,842,[I-am]RoyalLoyalMembers
188817273,Munmon,12901737,1116310,211912,39551,42589,125343,52185,0,259668,52185,0,2476678488,0,125,-
188845348,ᴸʳLUNICTUS,12877100,104914,26926,6884,16888,8978,3385,0,36135,3385,0,1558632979,0,455,[LR21]Lords of Rohan
188292201,쵸Bear,12762411,3636617,863462,127956,652623,13205,183272,21012,998068,204284,0,1398516677,0,8400,-
192581999,LilitЛиса,12594502,4558817,2586,4079,12074,27936,442211,0,486300,442211,0,2123698981,534525710,3628,[LG21]Lords of Gondor
188816893,WARRIOR FARM 10,12407218,242793,17769,22009,47558,10254,10226,0,90047,10226,0,1316715234,0,1895,[21If]Immortal Falcons
188986347,Pimpammm,12386241,390745,21517,13926,70135,29655,12907,0,126623,12907,0,1444868924,9172286,4484,[OP1]OP CLAN
189266244,ᴵᴾRágnär,12376390,2424921,681640,338989,350984,104124,70352,26757,891206,97109,0,245500638,11642489,7444,-
190430624,IMPERADOR FARM,12346483,449281,436505,3716,0,322,44725,0,48763,44725,0,5021713189,2527734725,1615,[LR21]Lords of Rohan
142371438,NokedliF11,12328082,3005981,754566,516818,830716,67154,61715,17771,1494174,79486,0,1498984833,2400001,10466,[21M]Immortal Myrmidons
187384799,C H A D 3 3 3,12154750,5025006,638494,336794,550030,58137,356220,3142,1304323,359362,0,963590883,0,4549,[LG21]Lords of Gondor
188829162,Mkジinsane,12152527,911799,856240,15867,56941,24326,65024,2360,164518,67384,0,1543783586,1400000,3486,[LR21]Lords of Rohan
188880051,qftydhunvfezbjj,12100235,18338939,1337013,1249255,1030656,1111224,1086802,35743,4513680,1122545,0,1422326310,88951930,7822,-
185259121,Lets go Os,12068464,913938,1168728,282,16846,7330,13445,35821,73724,49266,0,1378846196,4800000,1588,[LG21]Lords of Gondor
188900034,Rajpoots,12042565,854381,223016,55556,81433,13291,62724,0,213004,62724,0,1893809035,0,3118,[LG21]Lords of Gondor
174523518,ㅡᅟᅟF2P 5      ㅡ,12034288,4068578,375472,858694,1490716,123637,42086,0,2515133,42086,0,2291150995,968382628,2432,[LG21]Lords of Gondor
188838338,boble 79,12008818,306757,46338,1697,52760,41937,3315,0,99709,3315,0,1294670070,0,2122,[21MA]Myrmidons Academy
188479340,ㅡᅟᅟF2P 8      ㅡ,11999252,9974813,173571,883535,766581,262971,721306,0,2634393,721306,0,2771982621,1052471741,8854,[LG21]Lords of Gondor
188217778,ᴵᴰKing Nemo,11974922,1852509,716667,684238,272077,322,117022,0,1073659,117022,0,1857331281,0,12936,-
187155907,Yuzhi,11965737,5032590,1641848,115533,189407,294655,290433,27386,917414,317819,0,2079452318,257605,2038,[LR21]Lords of Rohan
188952266,ErDegui,11875134,7108681,230822,125436,58773,125367,620570,12944,943090,633514,0,1173596936,13045768,5398,[LG21]Lords of Gondor
188819203,Cominogr,11787827,347521,71452,268238,123679,11074,222,0,403213,222,0,1715584737,0,850,[ANTB]ANnti Banned Club
188946350,BaabyyKiller,11764448,45777543,823248,1480408,3397133,2896319,2635750,37221,10446831,2672971,0,1760569996,20189360,9196,-
188856725,Uranusuki,11739563,268914,32838,25630,66282,25841,2786,0,120539,2786,0,898298998,3859996,761,[LR21]Lords of Rohan
188818957,alonsoisma,11677340,2300239,762386,25316,47973,75270,189815,0,338374,189815,0,1593305801,4826393,1440,[LR21]Lords of Rohan
188900167,Charles grand 3,11652938,4207791,779277,591939,722430,168606,197012,0,1679987,197012,0,1818725074,8400000,919,[Tick]Tick tack
189182502,ᴵᶜVatson67F,11634052,137197,213594,1669,4693,617,12501,0,19480,12501,0,3571711915,1724148322,1620,[LR21]Lords of Rohan
188887462,Dunks,11620870,1538565,760926,36818,198678,122594,64347,0,422437,64347,0,1107672787,0,1042,[LR21]Lords of Rohan
188818543,GodAnubis,11589324,3265470,842158,347813,333503,280538,140675,0,1102529,140675,0,1268396774,473118,757,[21IR] Corral
184327666,ツاحمدᴰᴮ,11961918,3060237,532767,681079,488185,101508,109342,22410,1402524,131752,0,1461565573,72130,2491,[LV21]Lords of Valinor
188363322,쵸Belmont,11471499,726781,18931,225245,250029,43961,583,0,519818,583,0,1185584888,1410552,11058,-
185877603,ㄴ Aurelio ㄱ,11459232,3426162,734268,194294,519109,17374,220713,3623,955113,224336,0,929172473,1758080,3489,[LG21]Lords of Gondor
188892262,Udi lopez,11441297,286475,30519,120358,27289,7419,17815,0,172881,17815,0,259390568,3001045,1857,[LR21]Lords of Rohan
188840730,FurkiTolki,11345504,1839593,1140153,3217,12856,72657,143339,4461,236530,147800,0,1709897274,3600000,2057,[21M]Immortal Myrmidons
188320795,Fïshböy F1,11316968,1130852,410313,146172,398,5918,103727,1994,258209,105721,0,1566736172,820170438,1130,[LR21]Lords of Rohan
188885079,ᴵᶜnoobhuhu,11287294,4932153,869902,263679,640053,58918,316980,9692,1289322,326672,0,1694858992,26599999,5002,-
188840453,La pampara,11304426,4065536,1018214,200050,433845,478194,124506,0,1236595,124506,0,1512594680,0,331,[21if]farm 21If
188307234,ᴵᵀJessyS2,11159564,3418968,138406,130180,168640,9783,301652,0,610255,301652,0,1509177777,180913621,6306,-
189182788,Vatson67f3,10986654,260412,485136,2684,4031,13106,19939,0,39760,19939,0,3566673923,1133268751,1378,[LR21]Lords of Rohan
189443468,Hubey,10948714,2171604,462536,189562,257421,35910,147521,0,630414,147521,0,918945909,0,1967,-
189007908,vua đại du,10847143,2010095,594035,32817,68882,36737,135324,18279,292039,153603,0,1664459657,27506603,6095,-
188309795,ᴵᶜ TAZIEX,10844048,8618161,951227,435439,559362,399095,559725,10936,1964557,570661,0,1632163083,0,8839,-
188839518,Zaragoza,10770570,1181120,88062,120100,376712,100919,0,0,597731,0,0,1451432608,0,1183,[LR21]Lords of Rohan
189227933,Z  Hot Rain  Z,10762707,6460378,866429,52143,3457,47844,612586,6290,722320,618876,0,1457174944,13707113,1796,-
188817859,oktaev,10852518,401425,359467,33669,31021,2770,32157,0,99617,32157,0,1102334555,0,100,[DD21])Dragon of Death
117517315,ᴵᶜBOTAN,10684766,13712356,945529,506093,1444925,965222,611992,37024,3565256,649016,0,1235813199,498018246,20006,-
188847841,Lj1208,10608508,314850,314434,984,0,1961,30681,0,33626,30681,0,1177309928,0,906,[21If]Immortal Falcons
195403312,môngcổ,10481572,1446809,783623,85946,65345,87040,95077,0,333408,95077,0,1290253327,0,1066,[LG21]Lords of Gondor
189442766,Gubernur189442766,10408274,77204,41779,1313,9937,12737,612,0,24599,612,0,2596316384,2133430704,722,[21IR] Corral
188889920,Carolk,10405243,642390,541227,49383,96269,35954,29616,0,211222,29616,0,1163880734,1349311,322,[fagr]alpha table
188522411,Ваn,10346788,1095208,3365,36724,120447,26500,74097,0,257768,74097,0,727419882,1,2219,[21If]Immortal Falcons
188881481,678907,10291205,4054167,576543,566707,812285,378314,80300,0,1837606,80300,0,1297152063,53227,1527,[LLA]Lost legion academia
188300029,Hoàng Saa,10287810,5137975,463048,87026,120041,279872,368510,3795,859244,372305,0,1325449513,9873378,8177,[LR21]Lords of Rohan
188899095,Minuz,10287287,1614469,364375,167345,306671,102167,55899,0,632082,55899,0,733441492,0,1706,[LR21]Lords of Rohan
189285062,Linh farm 2,10253748,9739359,1413236,1086939,10938,8479,938116,4251,2048723,942367,0,5539685677,3128768761,1832,[LR21]Lords of Rohan
188295840,ッ Yakuza ッ 6,10205094,395204,0,3871,70818,40591,9043,0,124323,9043,0,992758872,82882904,4853,[21if]farm 21If
188906315,ᴵᶜИвaн,10194251,1248369,45240,148765,274837,58418,43527,0,525547,43527,0,943901017,16348226,12804,-
194265891,쵸MØTÃSÊMツ쵸 2,10152084,2387465,0,5126,24684,21098,225268,0,276176,225268,0,1502906474,125453620,1410,[LG21]Lords of Gondor
188721766,ᴵᶜZver225,10146168,5600948,578427,272790,772945,368830,252518,0,1667083,252518,0,1282562432,205403656,7602,[LG21]Lords of Gondor
188840603,andyrendy,10073872,1722850,894100,10373,99042,247058,53446,0,409919,53446,0,1032365452,0,459,[Slon]Slonii
188857096,Di 1,10019335,909985,10470,103819,160058,85834,22577,0,372288,22577,0,934774982,1843151,2952,-
188846435,psilva3,9925288,1390439,255473,331056,379662,122656,7428,0,840802,7428,0,965012690,0,590,[21IR] Corral
189869613,Алёнааа,9878154,3146615,691598,31047,82951,360086,153416,0,627500,153416,0,1475255043,503089664,1095,[GW21]GOATED WARRIORS
188898591,Dthomas,9838220,468487,81006,125157,122286,22516,10882,0,280841,10882,0,434478065,0,1343,[LR21]Lords of Rohan
188471943,NoCoboY,9816138,413116,95171,64153,54918,15880,22693,0,157644,22693,0,1081418218,0,3619,[LG21]Lords of Gondor
191785327,ᴿᵃQueen,9625702,3017237,247312,228656,300820,10824,232657,0,772957,232657,0,2123392947,813781963,1187,[LR21]Lords of Rohan
186988267,Panda ᴸᴺ,9616784,2766515,1120377,7927,2980,11995,264463,3318,290683,267781,0,3082740466,512115698,1981,-
186065635,MASONFTW WOOD,9598793,1910931,810165,6189,9403,5772,186780,0,208144,186780,0,1710757026,950725213,1293,[LR21]Lords of Rohan
188790900,Dom Daddy,9580078,3388766,1222043,27914,83403,91562,276497,4258,483634,280755,0,1776018503,0,1450,[OP1]OP CLAN
188962647,卂几Ҝ卂2,9578262,2082291,325396,3405,6149,30163,194866,0,234583,194866,0,1618176948,1219440595,2004,[LR21]Lords of Rohan
188815675,KōbøLord,9517898,145859,16647,15805,9235,19277,4712,0,49029,4712,0,843374303,0,1696,[LR21]Lords of Rohan
189238085,Christian33,9470954,471496,125768,75854,103315,62424,0,0,241593,0,0,716179466,0,1590,[21LK]legionary knight
188462426,Tysson,9463093,1483696,191746,163161,372581,171003,2189,0,708934,2189,0,647738981,310,4387,[21MA]Myrmidons Academy
188844276,tori,9437438,213019,54967,3007,1985,1182,20372,0,26546,20372,0,489310087,0,916,[21If]Immortal Falcons
