ID,Name,Power,Killpoints,Deads,T1 Kills,T2 Kills,T3 Kills,T4 Kills,T5 Kills,Total Kills,T45 Kills,Ranged,Rss Gathered,Rss Assistance,Helps,Alliance
179940560,ᴸᵛ k,108390802,456501732,3515439,779580,858571,656156,24091281,10554562,36940150,34645843,0,5988166807,1873979817,80251,[LV21]Lords of Valinor
186145908,ʳᵉʸEscanor,86664851,1405517994,3617960,4044172,914540,1661085,117531558,11046008,135197363,128577566,0,3508628046,4398233340,21788,[LV21]Lords of Valinor
188540500,TakeMe2Valhalla,85550390,1397770226,5133677,12405750,5648863,10614805,103159899,15496657,147325974,118656556,0,2825870975,6861247251,44401,[LV21]Lords of Valinor
180304933,LilLƴ,83253766,285873301,3206564,2202158,2764385,3176405,15411790,5654029,29208767,21065819,0,1131567489,4660554697,21389,[LV21]Lords of Valinor
179655012,ᴸᵛDØØPER,78963119,410238067,2165656,1239458,969397,1232048,23937477,8187421,35565801,32124898,0,8345038256,1451282007,37149,[LV21]Lords of Valinor
188858506,Cúchulainn 쵸,75808583,204221330,1721129,560024,261133,417020,18425772,883063,20547012,19308835,0,4891435242,512651627,36404,[LV21]Lords of Valinor
178695066,SokoDrake,70263808,70669571,2511465,457338,102654,145569,4840970,1069041,6615572,5910011,0,7681435337,115903540,17057,[LV21]Lords of Valinor
179977300,ᴸᵛTmulla,64233190,504791687,1724908,2409495,413380,894297,22376348,13807118,39900638,36183466,0,6934339447,5440679937,17514,[LV21]Lords of Valinor
180560115,TripEhh,63050496,312955225,1366497,1534135,808547,280026,17686968,6652076,26961752,24339044,0,6605422878,1225250480,11291,[LV21]Lords of Valinor
184964288,ᴾᴿFïshböy,62252378,234143607,2065225,1997698,4656245,3957977,18631487,1114240,30357647,19745727,0,3402154387,632742525,37740,[LV21]Lords of Valinor
186009654,Dooby ᴼᴺᴱ,57543324,242854395,669917,1577826,342124,485548,22425633,782803,25613934,23208436,0,7331276883,137216122,34798,[LV21]Lords of Valinor
188839265,A 10 Warthog,56848891,9326548,177018,42253,74269,128745,733958,65750,1044975,799708,0,3599126102,724780894,10545,[LV21]Lords of Valinor
178814644,ᵁʷᵘØtòt,56324953,395415835,2902845,18382416,3352869,2295591,27275303,5154911,56461090,32430214,0,2295222519,2229433716,15250,[LV21]Lords of Valinor
188341936,ᴸᵛ Vatson67,54428243,224273637,1658475,1045115,544821,595628,19541176,1259035,22985775,20800211,0,6356076894,384720155,41430,[LV21]Lords of Valinor
188918989,ᴼᴸ Kaymo,53534047,117238951,1027599,2450325,1386449,2524567,9588672,399550,16349563,9988222,0,3700102661,1075163587,40739,[LV21]Lords of Valinor
184871937,ScazBigLion,51796350,1057597913,3975727,54245068,22592962,23784399,80545096,5048721,186216246,85593817,0,5893276717,13364268108,20636,[LV21]Lords of Valinor
186985518,HornyAPOLLOS,50772540,203844038,1328117,2284490,1512134,3131188,17165898,808957,24902667,17974855,0,2725375138,594947915,17301,[LV21]Lords of Valinor
182514982,ᴸoᵛeSalmon,50379208,328984023,2776573,17629437,652284,729252,22370318,4876669,46257960,27246987,0,5454063086,1000488180,51356,[LV21]Lords of Valinor
185836736,ᴸᵛMasonFTW,49827003,448624018,2372746,5692324,2208085,4769431,36724398,2837384,52231622,39561782,0,3310341551,2802859223,28382,[LV21]Lords of Valinor
180060983,ᴸᵛRumRamsey,49238680,333551178,2163165,95038663,5047920,969934,24473825,2791481,128321823,27265306,0,5985286488,417518493,91648,[LV21]Lords of Valinor
181825355,ᴸoᵛePUMA,47483769,166614387,1017476,1171836,347822,494479,11869684,2250481,16134302,14120165,0,3269228314,3599759382,34296,[LV21]Lords of Valinor
181308342,ᴸᵛRockSolid,46703622,161642338,2426820,2664193,707125,1385050,10333863,2540821,17631052,12874684,0,3436496385,5482949920,39431,[LV21]Lords of Valinor
185808036,Ze Bosh,45554185,324557669,903869,8598579,2626646,3862918,28938009,637645,44663797,29575654,0,5524831643,631820319,29929,[LV21]Lords of Valinor
188920797,FreyaFullBosom,45337451,73915772,1618954,1713022,951963,1141723,6059521,325357,10191586,6384878,0,3468995413,1323334617,23864,[LV21]Lords of Valinor
176994964,Cpl Rage,45176297,93502377,401978,2192506,1505524,2116032,7329702,414584,13558348,7744286,0,1864342718,63265830,16816,[LV21]Lords of Valinor
179750493,GuiltyMahiru,43016246,110707044,940254,2798051,770150,1126071,9530887,439699,14664858,9970586,0,1468908693,1875360302,38913,[LV21]Lords of Valinor
187247613,Sith Padmé,42852998,171163054,2414455,3465372,2992211,3976522,13863179,497384,24794668,14360563,0,7471213538,4298542203,84060,[LV21]Lords of Valinor
184826667,ᴸᵛAHERUS勇,42761660,490291349,1238404,12756897,5925857,11113854,42022688,560298,72379594,42582986,0,5723510204,1396853955,24696,[LV21]Lords of Valinor
182423962,シValkyrieCillaﾒ,41847847,110279806,1842465,5640832,822285,707170,8502119,982860,16655266,9484979,0,5070000175,1265202822,14959,[LV21]Lords of Valinor
185690465,Dictator  Goat,41830967,331246659,1938979,6061698,2157810,1271305,30165982,948683,40605478,31114665,0,5939172421,1005155698,34589,[LV21]Lords of Valinor
181739549,kylinn,41829522,97526701,3321903,2389177,278410,278364,6880327,1328766,11155044,8209093,0,5128390117,10337862643,31310,[SFIS]Sky Fighters
142628224,Dae jang goon,41823556,130917630,2352556,1879642,714373,319759,10830512,976440,14720726,11806952,0,4842260566,102794418,16256,[LV21]Lords of Valinor
179813923,ㄴ Bless ㄱ,41805962,224888323,2184266,7734825,5947505,5124577,17876604,609100,37292611,18485704,0,2421108081,978016636,23228,[LV21]Lords of Valinor
188241812,Gilgamesh2323,41511236,76135849,734147,2437579,200187,257995,7031488,195055,10122304,7226543,0,4970129341,62620586,23758,[LV21]Lords of Valinor
188976136,ᴸᵛ MUSE,40635542,88067231,1161048,1973136,2348512,917125,6725226,602741,12566740,7327967,0,5091837865,365719425,46912,[LV21]Lords of Valinor
188969478,ᴰᴹMePaul,40571572,86031221,830319,1953068,3290337,2573561,5970399,453085,14240450,6423484,0,3560091573,278578838,3410,[LV21]Lords of Valinor
188785515,Johnvin,40027032,133815653,1611749,703907,454416,1065340,12009530,420469,14653662,12429999,0,4888902345,93446315,56003,[LV21]Lords of Valinor
186199010,Daphneᴵᴿ,39507699,180468531,1617039,1524876,1269505,3309484,13885695,1276483,21266043,15162178,0,4110955087,1458857670,54100,[LV21]Lords of Valinor
187423027,ᴸᴳPandaFr3d,39401660,165963117,1977352,1953268,791324,911124,13257788,1388372,18301876,14646160,0,2801248826,6820681844,26086,[LV21]Lords of Valinor
188485523,ᴸᵛIMPERADOR,39149152,128134294,897333,405653,28816,60168,11236214,769636,12500487,12005850,0,6116201178,181752989,35413,[LV21]Lords of Valinor
188882878,Rtthyr,38867345,73927094,744753,194923,102500,108215,6524661,400182,7330481,6924843,0,7180813742,93046400,18806,[LV21]Lords of Valinor
188483360,ᴼᴸTryxan,38817232,164199613,1033557,4173876,2836548,2675448,12845559,926718,23458149,13772277,0,5945477716,2169436768,39403,[LV21]Lords of Valinor
185282531,Jëster,38199377,45496988,2695521,469962,132883,175975,4001273,221030,5001123,4222303,0,3451908286,592793562,26190,-
179816952,Hell CAT GTR,38124779,47870265,2646607,54836838,1765720,1888997,1945681,317933,60755169,2263614,0,5416114779,1636698071,10482,[LV21]Lords of Valinor
187726069,ᵀᴿvSpryth,37854985,44024577,615317,1261609,163544,319012,3796266,210323,5750754,4006589,0,5377364213,15763287,22297,[LV21]Lords of Valinor
185457048,Cman9918,37622429,128598399,1146301,3704156,1184975,873737,11230033,484617,17477518,11714650,0,1991413988,126071365,16604,[LV21]Lords of Valinor
188315680,ᴵᶜ VXYzzz,37466146,106686501,786586,2876549,2107155,3146783,8237479,346748,16714714,8584227,0,5801318511,34554649,30832,[LV21]Lords of Valinor
188880730,ᴸᵛMarlone,37127515,122639340,1756178,423040,370088,130184,10623796,752793,12299901,11376589,0,5821694462,136720000,43623,[LV21]Lords of Valinor
178213242,ᶦˢLOCOOZ,37091306,121205681,3688087,2053376,957035,1554554,6929606,2168333,13662904,9097939,0,4338797235,1274602396,21621,[LV21]Lords of Valinor
188569749,ᴵᴾEndoloris,37018743,135932617,1872172,1390988,2616276,1563397,10769220,823804,17163685,11593024,0,1822151378,163440000,5369,-
180368631,ᴸᵛWinfields,36966261,154026288,4521082,23185411,189020,606014,11227691,1715510,36923646,12943201,0,5074516397,1877834074,13245,[LV21]Lords of Valinor
188651683,Sol Aliyaa,36899132,12035638,109645,119003,49805,35722,1123748,26593,1354871,1150341,0,3879055825,201676244,15277,[LV21]Lords of Valinor
188303104,HokieHighlander,36802688,53195967,1258821,163806,109840,34689,4749991,265243,5323569,5015234,0,1052361096,84975248,12957,[LV21]Lords of Valinor
186444772,Dr4gonツ,36410616,246494879,2586688,5247209,3482356,3833359,21462407,426161,34451492,21888568,0,5302126508,4177255259,37701,[LV21]Lords of Valinor
188805469,BossAlienᴾᴴ,35983179,64633159,1158071,214067,604492,927433,5604071,181546,7531609,5785617,0,4889570468,134750966,37929,[LV21]Lords of Valinor
189072394,ᴵᴾLaura,35946069,38673975,1303254,7315756,351266,767013,3006194,168915,11609144,3175109,0,6209984433,362529904,26828,[LV21]Lords of Valinor
185048534,Han Sansan,35714238,104403330,743566,376122,342082,415533,9482387,357897,10974021,9840284,0,5956837148,307367305,30508,[LV21]Lords of Valinor
189060019,Tušiš,35704125,71298403,773174,583219,635078,1036021,6206012,185370,8645700,6391382,0,2886502435,552362591,19716,[LV21]Lords of Valinor
188276623,ᴸᵛArork,35674923,75881536,928755,727440,1265703,1364258,6449499,162631,9969531,6612130,0,3700963392,360935366,16214,[LV21]Lords of Valinor
188789133,MiniMe,35636016,34559322,331090,235413,224998,167551,3200660,69272,3897894,3269932,0,4852601965,28996015,11512,[LV21]Lords of Valinor
188333348,ᴷᴺLinh,35270035,64133429,919906,1886379,1645656,5139453,3560857,214923,12447268,3775780,0,4788068128,550111352,10927,[LV21]Lords of Valinor
188648613,Känguruᴵᴰ,35183014,25242454,339495,377701,272323,171077,2085000,154398,3060499,2239398,0,2945432025,286935074,13393,[LV21]Lords of Valinor
185341770,ᶜᵘRalfish,34749933,51183105,2488511,825738,380145,497142,3892812,467049,6062886,4359861,0,2654342823,25760000,15584,[LV21]Lords of Valinor
185089489,ᴼᴾZOROGRANJ,34332185,89977952,1885507,550571,355159,737615,7809122,405792,9858259,8214914,0,5703855206,2083599610,21232,[LG21]Lords of Gondor
189065897,W3llsFargo,34225849,36866964,662685,1191313,898257,213767,3194692,101510,5599539,3296202,0,3792328556,2754424297,18665,[LV21]Lords of Valinor
188969981,ᵸᵒWand0,34142160,63904594,1283673,2054730,706949,524275,5242253,378006,8906213,5620259,0,4248371236,156699275,22419,[LV21]Lords of Valinor
188794709,ᶦᵗˢᵘRYU,34007589,101000149,978863,1317829,2549412,2529700,8119460,216218,14732619,8335678,0,3511908892,94094214,35011,[LV21]Lords of Valinor
185986678,卂尺丂,33937870,79609471,1173531,678506,1395180,1286320,6587265,283274,10230545,6870539,0,3322045338,1093919485,14531,[LV21]Lords of Valinor
188336265,ᴸᵛiGREC,33453903,32653366,354919,476172,194921,277535,2878759,113528,3940915,2992287,0,2450337076,175934276,17156,[LV21]Lords of Valinor
189017405,ᵸᵒWizzy,33185977,33816104,1104851,812593,975948,1093260,2600439,66213,5548453,2666652,0,2711771438,170159151,14063,[LV21]Lords of Valinor
182317160,G O P A Rᴸᵛ,33086411,157680983,1882435,3078776,2312591,2727624,13559485,296735,21975211,13856220,0,4015715371,738465485,27623,[LV21]Lords of Valinor
188826595,Saf1974,33011500,78278399,1331285,721829,553217,574540,6917562,277691,9044839,7195253,0,5025445633,226946040,47400,[LV21]Lords of Valinor
190252265,Jamong,32995205,41644923,945829,240286,331111,223656,3559642,222180,4576875,3781822,0,5153891888,81003240,23114,[LV21]Lords of Valinor
181534760,ᴸᵛSongoku,32924248,77625668,1418818,947363,718037,1206878,6700487,208387,9781152,6908874,0,3820545267,755945265,15742,[LV21]Lords of Valinor
189154415,ᵸᵒMDKMB,32767068,62084424,746016,2572471,865337,727479,4807590,442672,9415549,5250262,0,2080700846,2596649234,19589,[LV21]Lords of Valinor
188970345,PitBlue,32700845,95170269,796762,1120668,1623522,1658543,7742756,381868,12527357,8124624,0,3942973907,1077393392,22471,[LV21]Lords of Valinor
186841127,Anossss,32679411,75127932,1111554,1178544,154269,102769,6613707,401777,8451066,7015484,0,4194519428,4253401,14107,[LV21]Lords of Valinor
188501467,direraven,32522224,91059970,743222,5167383,2365199,2777679,6651342,383598,17345201,7034940,0,4748479194,4551820,26504,[LV21]Lords of Valinor
187029935,HolySpirit,32469164,126877414,1399813,1236470,1343710,1577860,11020654,371236,15549930,11391890,0,2684497634,1104079437,18218,[LV21]Lords of Valinor
188837916,Silent Kakashi,32382677,105876915,889638,839969,754922,750377,9809221,155268,12309757,9964489,0,1730534801,103761097,13961,[LV21]Lords of Valinor
188544046,G4mine,32283277,26479448,851895,262602,631545,296942,2060539,168534,3420162,2229073,0,4313122023,247760315,20168,[LV21]Lords of Valinor
188581465,ᴸᵛSpSmeagle,32230323,54306450,771305,1264343,1093916,361345,4747301,147368,7614273,4894669,0,4086975508,150346971,19906,-
185037763,ᵛBEARDY,32209931,51437912,2227119,28222212,2319488,801981,2906415,444121,34694217,3350536,0,4915480303,554484409,19489,[LV21]Lords of Valinor
186765655,KönigsKlãsse,32206359,161810515,872121,1985538,1337845,1833427,13420645,859878,19437333,14280523,0,3522956983,407789115,7687,[LV21]Lords of Valinor
188651684,Milo San,32200758,7126633,256838,5998,5637,18715,651518,26206,708074,677724,0,2913462995,349753808,11600,[LV21]Lords of Valinor
188362493,亗MrDuck ツ,32113818,48024624,1161416,1502313,2043320,1145043,3710477,97629,8498782,3808106,0,2774301656,869611190,16259,[LV21]Lords of Valinor
188242643,hoahaizz,32088331,93484832,824203,3461592,968129,560439,7711804,574823,13276787,8286627,0,3659306476,567041937,28875,[LV21]Lords of Valinor
188352541,ᴾᴿ Mèoッ,32057092,119273967,1163354,7159677,1696839,1293856,9936665,495314,20582351,10431979,0,6092660126,0,14263,[LV21]Lords of Valinor
188368264,funne,32056885,27814931,1265037,834275,642636,595616,2088506,154764,4315797,2243270,0,3739787956,61698120,16497,[LV21]Lords of Valinor
182713036,쵸ﾒMØTÃSÊMツ쵸,32044247,18088832,613608,107410,237719,446943,1541354,19530,2352956,1560884,0,4948546521,123301386,19867,[LV21]Lords of Valinor
185724517,Feldgraŭ,31984180,143895654,1749110,439323,3849630,1436815,10846195,1094966,17666929,11941161,0,4247055717,178066760,33166,[LV21]Lords of Valinor
187559873,ｱ尺ﾉ丂ᄃﾉﾚﾚﾑ,31966388,62577567,524842,786256,540194,444292,5234590,360843,7366175,5595433,0,2621929037,626443180,15350,[LV21]Lords of Valinor
185612447,Chaudary Zain,31960331,118678568,1396547,4933513,1590757,914083,10180504,452449,18071306,10632953,0,4392317511,1323892732,24704,[LV21]Lords of Valinor
188451175,ᵸᵒTerra,31661641,52190528,870910,3422823,860871,534113,4469807,147485,9435099,4617292,0,4013833144,92432122,22204,[LV21]Lords of Valinor
188736727,Alex9003,31656274,32892720,1660154,2964172,704741,765686,2278198,252284,6965081,2530482,0,4121431194,38138060,14133,[LV21]Lords of Valinor
188797972,21LuviVilu21,31422828,15178974,1118455,579951,518648,328487,1180620,45277,2652983,1225897,0,4257469020,34539709,15602,[LV21]Lords of Valinor
188833519,JulieLaTueuse쵸,31357900,23030526,592288,127764,346846,94148,2000359,96555,2665672,2096914,0,3497555268,37720000,19428,[LV21]Lords of Valinor
188335709,Rebel Rogue,31262262,72509497,813602,1040029,700124,771386,6222402,279584,9013525,6501986,0,3440753536,34205137,33633,[LR21]Lords of Rohan
188225231,ᴾᴿSko0p,31025086,31518334,348694,168570,89071,72567,2953453,74084,3357745,3027537,0,4475395172,0,26884,[LV21]Lords of Valinor
189045190,Azura21,30893418,28813819,1079446,528436,682624,3020226,1479906,23146,5734338,1503052,0,2771222363,423984134,8043,[LV21]Lords of Valinor
188847278,ᴸᵛQuang,30642219,113389014,1080822,1187642,1431516,1271631,9963037,278578,14132404,10241615,0,4008955828,1554824614,32628,[LV21]Lords of Valinor
190407807,동탄불주먹,30330068,20419720,1056289,489264,330666,695184,1561556,63212,3139882,1624768,0,5248277479,433522789,14805,[LV21]Lords of Valinor
177013392,ᴸᵛ UCC15,29941231,35152726,2594771,1191251,936367,880578,2637169,157387,5802752,2794556,0,5283849880,192271545,15977,[LV21]Lords of Valinor
188836483,YenifferDeRivia,29867955,38806179,1193983,1781128,2318341,1691838,2651180,26706,8469193,2677886,0,3395185064,140738085,4868,[LG21]Lords of Gondor
188598120,ᶻSharineko〤,29776999,47769309,715969,737358,1456432,799706,3749261,200877,6943634,3950138,0,2338006682,51185747,15310,[LV21]Lords of Valinor
188316323,ᴸᵛ SAKURA,29567312,94015517,1265838,2331148,1067900,1852937,8081600,159287,13492872,8240887,0,4076621502,539454569,25858,[LV21]Lords of Valinor
188262339,Kitty27,29468294,3525315,58669,36465,178359,33306,226824,37992,512946,264816,0,3690927982,23588840,10297,[LG21]Lords of Gondor
188961098,Chocolalat,29468218,2573117,220977,51569,65233,15462,226397,5326,363987,231723,0,4096001149,21199999,3557,[LG21]Lords of Gondor
185651937,ᴳᵃʸGrizzy,29422301,387070968,1523784,11881112,5832998,11662675,31779649,429078,61585512,32208727,0,3744084354,952357579,20271,[LV21]Lords of Valinor
185923730,JFDLCA,29405334,264392552,416817,5131053,3803977,6044217,22535938,311107,37826292,22847045,0,4681904770,386336005,36325,[LV21]Lords of Valinor
184882401,Ферма а,29340625,88279805,1681086,22831138,3000621,3316704,6065464,189544,35403471,6255008,0,2642381639,3538154179,17238,[LV21]Lords of Valinor
181581608,Fledermauz DB,29264005,32237433,694585,248895,300074,511759,2915789,19129,3995646,2934918,0,3566952821,377676127,7682,[LV21]Lords of Valinor
188364390,ᴸᵛLeonPoi,29044670,127247371,1129448,442986,394534,630054,11137009,623970,13228553,11760979,0,3696650447,108004980,35555,[LV21]Lords of Valinor
188876886,ᴸᵛTheanh,28979250,101629132,1174523,404443,283572,561635,9495490,188983,10934123,9684473,0,5494737623,107966937,32396,[LV21]Lords of Valinor
182338045,亗ƧHiꟻT亗,28881914,117329830,1002395,2594641,1006234,1309156,7422215,1766983,14099229,9189198,0,5452689377,2515586970,31762,[LV21]Lords of Valinor
188543996,ᴸᴳﾒNØHOPEツ,28766611,17344954,647308,307714,74582,171382,1562494,41189,2157361,1603683,0,3355307775,31608954,11151,[LV21]Lords of Valinor
185538462,UMAYKIZ,28690111,68592876,1079556,2427561,751580,861151,6059020,128470,10227782,6187490,0,4043851449,8566632,6341,[LV21]Lords of Valinor
188789684,ᴿᵃtMadson,28666027,16277227,457839,77019,121638,152532,1391456,74693,1817338,1466149,0,3833776256,72421016,39283,[LV21]Lords of Valinor
186295211,ᶠˡVENDETTA,28617392,98747660,2585264,4042021,1080655,510744,7734483,819507,14187410,8553990,0,3885646386,1050356942,19668,[LV21]Lords of Valinor
188830020,ᴸᴳVersized,28540387,42467091,629241,595876,937153,410015,3547763,167796,5658603,3715559,0,3610669549,36055668,10002,[LV21]Lords of Valinor
188293704,ᴸᵛDrMusaab,28503195,35719690,1499523,186182,427716,173058,3157445,128017,4072418,3285462,0,3655871580,84578452,14169,[LV21]Lords of Valinor
186709522,ᴸᵛ SHERY,28382314,61557158,1562880,609853,401512,544566,5186216,329587,7071734,5515803,0,3398084380,99489407,9514,[LV21]Lords of Valinor
185282573,ᴸᵛ3621 BANK,28344977,62632106,771884,668111,1267167,649115,4855577,440596,7880566,5296173,0,1355169005,923285969,8656,[LV21]Lords of Valinor
188853241,Алёнаа,28336839,22447779,741245,236275,344883,856812,1506079,161136,3105185,1667215,0,4412818768,45525540,12691,[LV21]Lords of Valinor
189001955,ᴸᵛTruNguyen,28279447,13043494,707395,361084,139142,226871,1087099,45726,1859922,1132825,0,4332258830,67678867,15908,[LV21]Lords of Valinor
182720562,ᶜᴹᵈSkyy,28092367,19752884,2388318,291902,77615,310791,1289299,270156,2239763,1559455,0,3999667646,685652689,12498,-
188944242,Đạt Feet,28083097,19579018,699227,769072,733958,1500022,1053224,71248,4127524,1124472,0,4503601381,16457231,8972,[LV21]Lords of Valinor
188819438,ᴸᴳLuca,28069617,46044144,573803,296542,432636,250296,4088058,161890,5229422,4249948,0,4212862986,286280200,24187,[LG21]Lords of Gondor
186043643,卂几Ҝ卂,28021544,49587159,1027897,877386,299895,373253,4427966,151961,6130461,4579927,0,3277615197,501165307,28977,[LV21]Lords of Valinor
188788713,Sam smith,27942619,27402922,732711,582024,331614,177955,2445373,72887,3609853,2518260,0,3849485312,33958258,12432,[LV21]Lords of Valinor
188785575,ᴵᶜ Cairo xx,27765720,22263445,718609,343839,319881,399109,1877180,59334,2999343,1936514,0,3313749039,8507066,17115,[LG21]Lords of Gondor
188852900,Scorpionking乂,27827563,74356571,1825968,692459,535193,1654576,6423603,114668,9420499,6538271,0,2178020447,58256706,31033,[LV21]Lords of Valinor
188285810,ᴵᴰJupanu,27070827,43749874,949826,859503,1573717,504705,3450782,195195,6583902,3645977,0,4634896619,57408174,19832,[LV21]Lords of Valinor
188806334,Emrah 51,26971037,3751158,1312229,1012,10602,4008,371372,0,386994,371372,0,4126810750,0,4417,[LR21]Lords of Rohan
188547640,Kitty8152,26911258,1630693,12032,78078,153637,150776,70470,0,452961,70470,0,6115854188,2547000,7495,[LG21]Lords of Gondor
188294260,CЦEПИOH,26824332,10421111,1855157,581297,556310,288078,772954,15519,2214158,788473,0,2703473745,173206292,7507,[LG21]Lords of Gondor
188880546,Graf000007,26683871,3908846,1602923,195112,206722,115320,259030,20240,796424,279270,0,3385528996,0,3928,[LG21]Lords of Gondor
185905587,Ze Boshman,26638325,3821207,404399,309125,97861,13805,316140,17352,754283,333492,0,2770839083,41584565,2619,-
188575943,BATUMSKİ08,26634444,119766533,2518476,8713459,9991171,6956425,6868944,76318,32606317,6945262,0,2762230430,529137921,20465,[LG21]Lords of Gondor
188192835,SвулканS,26556190,19628934,388225,2031363,306088,979874,1414359,27370,4759054,1441729,0,3353571742,52162299,8836,[LV21]Lords of Valinor
189040679,ㄴHORIZONㄱ,26448811,74776471,764075,947828,1035889,885967,6855262,20932,9745878,6876194,0,4541244792,188105599,14258,[LG21]Lords of Gondor
188453555,Puyols,26416652,42051069,884766,405117,350807,191573,3711424,169395,4828316,3880819,0,6545845265,127173124,23182,[LV21]Lords of Valinor
188364525,ᴵᴾEmrys II,26412458,3119874,218964,53070,30135,8285,294045,3770,389305,297815,0,2091717356,0,2715,-
188319889,亗ChancellorT,26292095,19038322,395290,392020,290920,381817,1561679,61701,2688137,1623380,0,2876805661,1085215,13309,[LG21]Lords of Gondor
188877484,ᴵᵀBLOOM,26217679,73412319,1615750,429658,286070,678042,6496736,253736,8144242,6750472,0,1847010287,111895750,28920,[LV21]Lords of Valinor
189141193,ᴸᵛJankels,26179063,46947588,771106,2358084,1924323,2323779,3141045,96088,9843319,3237133,0,3269918005,28726902,15786,[LV21]Lords of Valinor
188793086,GANDAlF EL GRIS,25816572,6393451,180602,29227,83125,35629,549478,29203,726662,578681,0,2742675239,132716687,7283,[LG21]Lords of Gondor
188872694,DELİ ÜSTAD,25898346,5962066,716649,208561,290491,524323,257508,33350,1314233,290858,0,4134208316,39905983,2078,[LG21]Lords of Gondor
188806124,ᴵᴾAltar,25682493,111614407,1481141,3177848,4192360,2583327,8685363,270359,18909257,8955722,0,2531022967,7742830,26734,[LG21]Lords of Gondor
189939798,ʰᵒDestructor,25618014,18469100,52616,21684,68111,82633,1799801,0,1972229,1799801,0,2779904103,11281500,843,[LG21]Lords of Gondor
188818127,ᴿᶝ风华,25485802,2158531,1064759,62955,74067,33164,157987,14264,342437,172251,0,4078642313,64472747,3787,[LG21]Lords of Gondor
188835262,vinzsou,25412611,12637205,214092,27067,92071,38810,1153127,38057,1349132,1191184,0,2272120189,0,12560,[LV21]Lords of Valinor
188939030,TBILISI,25384837,7839528,1253222,516102,1297487,330601,372081,4906,2521177,376987,0,2995897114,460258,11610,[LG21]Lords of Gondor
188891048,7BeLa,25329382,57642914,872000,370252,777201,2820258,4394591,39376,8401678,4433967,0,3249200119,137794496,5867,[LG21]Lords of Gondor
188365363,diegokristy,25323401,39877309,464864,421018,640200,714224,3212053,176764,5164259,3388817,0,3716619819,246281206,15226,[LV21]Lords of Valinor
186010544,Mehmet027,24942804,54179766,1527522,1745924,1605736,1984975,4248639,9641,9594915,4258280,0,2938190751,173638054,8238,[LV21]Lords of Valinor
188320476,ᴿᵃЛиса,24611533,31018243,1072781,367405,506339,542846,2576488,99791,4092869,2676279,0,4697387059,362428945,38798,[LV21]Lords of Valinor
184845080,ᴸᵛSCAR德,24607857,41324847,456710,183367,313471,199948,3682172,151986,4530944,3834158,0,3716415397,46674299,27401,[LV21]Lords of Valinor
188880486,Kỳ tiktok,24555955,5802536,619653,67544,30446,79744,472776,34070,684580,506846,0,3736857022,0,3054,[LV21]Lords of Valinor
188319008,ᴸᵛКэп21,24429304,10075514,29597,216150,128394,92909,914970,12708,1365131,927678,0,2233408969,0,10985,[LG21]Lords of Gondor
188324838,ХОНДА,24355553,7990779,1618420,319927,430706,215833,601619,9293,1577378,610912,0,2514329809,122738819,6012,[LR21]Lords of Rohan
188836051,Cheops Pyramide,24349646,59388391,948851,622968,284182,456136,5381927,152581,6897794,5534508,0,4332998130,627419892,34302,[LV21]Lords of Valinor
188855274,GOLTEB,24118019,122887773,1320797,1201875,175391,426239,11397814,330676,13531995,11728490,0,3350239884,35237187,41293,[LV21]Lords of Valinor
188840841,ᴸᵛNotZach,24051305,23339740,350982,581170,825920,442354,1818119,81053,3748616,1899172,0,1545694750,107725390,4332,[LV21]Lords of Valinor
146179581,lupepvp,24044536,9415320,586781,153221,114638,34970,776064,62744,1141637,838808,0,5169281457,108915418,14379,[LV21]Lords of Valinor
188912287,ᴸʳgCoelho,23964265,25780002,790395,471781,802707,1014738,1865090,68519,4222835,1933609,0,2376290531,113818904,6588,[LV21]Lords of Valinor
84905552,Schwazzier,23958606,7688436,494014,147563,86882,62010,655758,33977,986190,689735,0,3164861811,60672597,7603,[LV21]Lords of Valinor
181974650,IDEM City,23791400,2030305,1163258,142285,141908,58538,141798,3295,487824,145093,0,3776027518,86095121,2071,[LG21]Lords of Gondor
184872506,ᴾᴿF A J A R,23766513,81330450,1396757,2282220,2097345,3030279,6197714,129053,13736611,6326767,0,3250277163,28252952,13422,[LG21]Lords of Gondor
188870613,xXVincinetteXx,23703461,8098429,1287558,867867,503902,29008,646440,16831,2064048,663271,0,4699104174,5876311,23600,-
185602720,ˢᵉAbdallah,23672437,34799061,148870,749527,727093,952970,2705155,116577,5251322,2821732,0,1686896307,13071304,9159,[LV21]Lords of Valinor
189236516,ᴿᶝ年华,23632230,2290337,936926,56107,169818,48265,162204,6219,442613,168423,0,3663685278,48671853,2869,[LG21]Lords of Gondor
188793523,FerAmaya,23599572,6606441,404492,129947,223590,105868,560476,5252,1025133,565728,0,3586111146,43532335,5050,[LV21]Lords of Valinor
188937309,Velikiy Govard,23549141,4831224,638326,125640,141509,280242,340211,0,887602,340211,0,2561559788,85678023,5151,[LG21]Lords of Gondor
188390528,ᶦᶠAkrosh,23277756,14179254,358164,80861,884019,546131,1021052,0,2532063,1021052,0,1404024361,139317710,2243,[21If]Immortal Falcons
188842111,ᴵᶜAntoJJ00,23242447,10112937,281104,13757,120082,40863,890439,40109,1105250,930548,0,2562047360,3999999,3567,[LV21]Lords of Valinor
188376202,ᴵᴾ云霄,23098799,5016232,1187495,141572,159153,80118,421990,6462,809295,428452,0,2559902550,17020000,4196,[LV21]Lords of Valinor
191454845,ᴸᵛTueAnh,22950514,15880031,609408,33336,102636,279568,1382732,36125,1834397,1418857,0,5449627166,997408023,11139,[LV21]Lords of Valinor
189057248,Cekko23,22902504,20164594,595985,139302,267141,394238,1679928,61311,2541920,1741239,0,3488770994,76002446,11073,[LV21]Lords of Valinor
185094982,Phi Dương F2P,22889544,37183572,1932282,2842133,5213473,4076945,865436,61303,13059290,926739,0,2097002749,117926355,4939,[LV21]Lords of Valinor
188994494,Snowplow,22869171,1094552,236306,8504,103749,19351,80795,0,212399,80795,0,2824501412,0,3432,[LR21]Lords of Rohan
188937116,ᴵᶜTom,22847232,4798418,78668,26543,281358,25756,401873,5432,740962,407305,0,2254933220,6485919,12148,-
189324168,인절미,22772318,11044249,1368116,65146,304808,90751,963836,21012,1445553,984848,0,3411419703,7500000,15231,-
188661481,Kängurufarm,22654346,2847269,781585,208965,117034,10247,253042,0,589288,253042,0,2402378186,1128542199,4143,[LG21]Lords of Gondor
144563085,ᴵᶜPARANOIA,22635581,4730553,1770534,15817,22531,23272,408292,25316,495228,433608,0,2803132977,1021382,4802,[LG21]Lords of Gondor
185134660,PetitDr,22413048,3101404,85261,63894,67172,12418,288305,1078,432867,289383,0,1499181335,17979430,10865,[21if]farm 21If
184817793,meto 313,22140329,2138351,1572170,176676,118771,63196,34729,63270,456642,97999,0,2917327211,1827622,1787,[OP1]OP CLAN
188234979,iGRECfarm,22094413,15844038,286311,273003,46153,43158,1490992,30729,1884035,1521721,0,2703807026,315563112,10635,[LV21]Lords of Valinor
188846843,BoboFranek,21704370,1436892,86860,96434,230127,133623,42286,0,502470,42286,0,1842439115,45731253,5585,[LG21]Lords of Gondor
188899189,QuantSist,21690263,1720056,385409,11624,68715,76283,127517,0,284139,127517,0,1964267618,296458,5448,[LG21]Lords of Gondor
184859052,ᴸᵛamadxd1,21684678,6824130,685037,150092,454668,303159,423224,21995,1353138,445219,0,2162926635,175992716,6567,[LV21]Lords of Valinor
186016235,卂丂卂千,21673200,4359462,159223,142922,151729,14030,367686,14722,691089,382408,0,1852300131,12932669,3736,[LV21]Lords of Valinor
188255601,Ant Man21,21587050,21740037,261646,303216,192688,238972,1939567,47123,2721566,1986690,0,3143089623,0,3958,[LG21]Lords of Gondor
188639928,The亗SCARFACE,21522078,2476955,64606,145589,285116,162864,116131,3242,712942,119373,0,3201996276,44040000,4256,[LG21]Lords of Gondor
188830522,ᴸʳTylnmrl,21434288,1670861,37663,32839,20609,4164,155652,2495,215759,158147,0,2230774527,16585000,4620,[LG21]Lords of Gondor
188878743,Jetare,21338618,13297600,982070,914090,1759002,1062897,503537,15491,4255017,519028,0,3125004530,91210728,2872,[LV21]Lords of Valinor
188851823,ᴸʳMent001,21271278,706360,45963,213744,185983,43829,11633,0,455189,11633,0,1856079274,0,2670,[LR21]Lords of Rohan
188818238,PoTaPyh,21157536,17664038,830439,488230,854873,981299,1145843,23651,3493896,1169494,0,3095818179,301072527,13039,-
187503097,Romulus1991,21157089,22857748,179434,141002,70341,268434,1990479,85517,2555773,2075996,0,3667162174,82802390,16475,[LV21]Lords of Valinor
188337674,ᴵᴸAxan,21120084,13852737,908861,382486,81728,81286,1314956,6904,1867360,1321860,0,2607751196,376836150,9598,[OP1]OP CLAN
188889549,СЦEПИОН,20926077,2997871,1241527,21675,25683,72660,248333,8410,376761,256743,0,1923428853,102567597,3693,[LR21]Lords of Rohan
186018265,yıldırımsefa,20905412,12642300,258459,159713,850626,471324,812371,45005,2339039,857376,0,3091634481,50620184,8851,[LV21]Lords of Valinor
188443825,йкйцк,20721165,48743894,1313992,1943111,2457331,1223280,2839555,507597,8970874,3347152,0,2532968576,1971457076,21172,-
188856715,ᴸᴳJackie,20556635,13833750,284873,80252,30041,24787,1256279,54784,1446143,1311063,0,1235418621,20000000,4025,[LV21]Lords of Valinor
188819819,fox77778,20476521,3782562,738594,75581,204618,428450,164441,0,873090,164441,0,3271199432,1037349,4647,[LG21]Lords of Gondor
183360513,ᵀᴸмønoメ,20415868,26110591,478300,186118,247673,221163,2277659,95839,3028452,2373498,0,2125813241,85509847,6981,[LG21]Lords of Gondor
188884272,ZHIANZD,20398835,1216090,246973,127800,150740,29760,77001,0,385301,77001,0,2488342395,0,2033,[LR21]Lords of Rohan
189036655,Vitia back 1990,20380601,9551108,2056000,172660,105414,21917,821704,50052,1171747,871756,0,2577374274,9800000,8538,[LR21]Lords of Rohan
184819319,joe200,20302331,2022401,1197317,130789,249677,21520,45323,47879,495188,93202,0,1616925065,91263980,5847,[LG21]Lords of Gondor
188838640,Presidente CIAO,20244208,3248958,61803,13150,115426,83389,268192,0,480157,268192,0,1594537619,23800000,4443,[LG21]Lords of Gondor
188790227,СУЛИМАH,20234807,2937806,1265520,69552,52214,89972,230812,7573,450123,238385,0,1837825253,102878721,3411,[LR21]Lords of Rohan
188325495,쵸 See La Meet 쵸,20218723,26136473,714725,1038428,1614240,1553702,1521512,63519,5791401,1585031,0,3512199870,0,7931,-
188903920,JoshuaSeil,20162883,3944310,804072,57530,197583,34872,321289,9263,620537,330552,0,2880979938,301497,3838,[LV21]Lords of Valinor
188847403,Vali188847403,20133468,1805843,502942,88125,113717,240436,59904,0,502182,59904,0,1173495329,0,641,[_NDM]New Jersey Nol
188876948,Ruberoid,20049922,1308095,30041,24678,63862,55794,95226,0,239560,95226,0,1435252424,3846529,4594,[21If]Immortal Falcons
188836639,Ndiaye,19747859,5853377,660696,352077,491543,747064,181162,0,1771846,181162,0,2917504623,383503,1605,[LLA]Lost legion academia
188898779,kral jon snow,19687727,113087,6227,15339,20427,859,6573,0,43198,6573,0,2723039270,8327554,2896,[21If]Immortal Falcons
189075824,NooByZ,19621709,8523920,1530004,77034,121760,128921,748617,13157,1089489,761774,0,3365718003,99259891,19016,-
188806434,ᴸᴳ Bimz,19610991,4037011,658635,38885,29786,6973,351993,21092,448729,373085,0,2884569071,29458520,9376,[LV21]Lords of Valinor
145631489,BABA SON,19624315,3735351,255023,136076,494296,267396,162298,1349,1061415,163647,0,2049544787,4400000,4408,[LV21]Lords of Valinor
188232993,AKON311,19539969,17474104,658995,571073,531874,842388,1182997,54831,3183163,1237828,0,1766071867,850687088,12259,[LG21]Lords of Gondor
188857113,GritNGravy,19459644,1953070,46395,39362,14347,20181,183578,0,257468,183578,0,2890441210,3200971,3702,[LG21]Lords of Gondor
188261313,freezebee 21,19358613,2027071,234347,244875,375237,108803,79241,0,808156,79241,0,1742483591,5187959,14509,[LG21]Lords of Gondor
188430882,JapayuKingBILAT,19177227,13159982,558247,244614,718820,347450,977902,25230,2314016,1003132,0,2741504531,142262581,15054,[LV21]Lords of Valinor
191530671,ᶦᶠtMadsonn,19091927,1846035,34099,69047,86817,200703,85578,0,442145,85578,0,2551741129,910375198,4539,[LR21]Lords of Rohan
188282297,MinasTirith秋,19050064,67391767,1935936,4739757,348069,495597,5982319,197105,11762847,6179424,0,2949663138,2562027272,30485,-
188853064,TerrorBlade98,18974193,4698786,941546,120572,115534,39441,414286,7149,696982,421435,0,3267253955,0,1325,[LG21]Lords of Gondor
188838663,ERON,18940027,7419903,732610,190505,250716,72425,647213,5927,1166786,653140,0,1980908422,20081022,12053,[LG21]Lords of Gondor
188845810,BARBALIAS,18899874,5080729,1177937,167048,291925,201260,352189,6827,1019249,359016,0,1731230822,0,5851,-
188814205,SUBUTAİ 38,18891205,1466044,274608,292102,181430,22696,95398,0,591626,95398,0,1860187426,3080000,2283,[LG21]Lords of Gondor
188869412,dân chơi đá,18877333,8228309,246570,288205,739830,1185717,194814,0,2408566,194814,0,2106256471,1154652,1641,-
186613612,Inigo Montoya1,18945229,4781554,1455414,349831,116242,28761,403220,16593,914647,419813,0,2563178322,103076547,8413,[LV21]Lords of Valinor
188884453,dm152,18791077,261473,0,20838,55033,4660,12860,0,93391,12860,0,2612964600,0,4274,[LG21]Lords of Gondor
188539042,Chieu F2p,18740166,18982040,439205,844273,1727037,651403,1031474,121938,4376125,1153412,0,2033809047,35342934,10594,[LV21]Lords of Valinor
188776545,ᴳᵒᵈ Ingle,18684407,1048600,93501,85140,135892,24107,66336,0,311475,66336,0,1662883622,3404666,5100,[LG21]Lords of Gondor
190329472,F1Quang,18599152,12303871,725173,76015,288128,303523,1034038,7897,1709601,1041935,0,3813906531,2654670795,8441,[LG21]Lords of Gondor
188806199,Op khan,18530947,4301539,616590,240925,827408,507637,54829,985,1631784,55814,0,2784380897,4253716,3110,[OP1]OP CLAN
188836606,Black AngEL,18316975,8655975,1937740,908418,995278,553139,422312,2403,2881550,424715,0,2137121812,18536152,1820,[LG21]Lords of Gondor
188360951,SATORUGOJO1,18275049,8701415,472927,508838,996498,575503,408396,11034,2500269,419430,0,1598312752,317828071,6526,[LV21]Lords of Valinor
188827507,Dug1man,18193515,106428,5346,18103,18794,0,6522,0,43419,6522,0,2449187517,0,2468,[LG21]Lords of Gondor
188336750,SKY EAGLE,18136313,7121747,985124,330019,49903,45477,677403,0,1102802,677403,0,1931799839,213802552,9588,-
150165925,ᴸᴳken arok,18092674,5760443,585518,105507,278014,108601,458545,8173,958840,466718,0,2378150931,26909895,9997,[LV21]Lords of Valinor
187197359,Demir Bilek,18074717,9273471,779097,120768,235808,174193,781889,13102,1325760,794991,0,2112856202,30192868,11038,[LG21]Lords of Gondor
189014302,magister,18009193,11593788,947900,205152,1188782,528161,695989,5133,2623217,701122,0,1327725746,15363819,7383,[LG21]Lords of Gondor
188490339,Eudaimonia,17946929,3305051,193739,41805,36785,12770,295668,10768,397796,306436,0,3071104167,30962500,5277,[LG21]Lords of Gondor
188865329,Việt hoang 07,17811984,607097,64769,419495,234049,900,5150,0,659594,5150,0,2208837302,1833721,887,[21M]Immortal Myrmidons
188844580,RedHoodJT,17914377,3724748,210774,117223,615129,546669,28437,0,1307458,28437,0,1617109614,0,1434,[LR21]Lords of Rohan
189231766,darkkiller666,17669854,3746982,286312,236683,195194,50737,294065,8283,784962,302348,0,2533244060,20289481,14046,[LG21]Lords of Gondor
188787622,MalandrageX,17412557,20690,0,2434,1687,245,1585,0,5951,1585,0,2494498655,0,3266,[LG21]Lords of Gondor
188368666,Derik 災,17193465,17311218,78795,189202,156137,96806,1633226,12081,2087452,1645307,0,1504456225,57910439,4670,-
188487100,Kir8,17158863,744292,46498,47082,45400,57564,41382,0,191428,41382,0,604975853,0,4402,[LG21]Lords of Gondor
188904786,Shadow vahalla,17081635,951871,236630,6845,11062,4462,91053,0,113422,91053,0,2775008962,0,2993,[LG21]Lords of Gondor
190852683,BossAlien FARM,17065346,6771910,168409,19244,81805,135783,606132,0,842964,606132,0,4121910224,1694123182,2578,[LR21]Lords of Rohan
188884243,HiagoLira,17024004,1285899,1,5567,1871,82946,94926,0,185310,94926,0,1592696248,0,2353,[21If]Immortal Falcons
188879533,Qertt7,16967088,188791,322,8039,23990,816,10230,1682,44757,11912,0,4024678872,38000000,2106,[LG21]Lords of Gondor
187016834,ƐƘÁ,16903886,5969476,107689,89142,174787,122716,511121,0,897766,511121,0,2676459110,1489060086,4764,[LG21]Lords of Gondor
188823442,VIP shooter,16871062,3305125,846887,132688,41914,75500,277768,5754,533624,283522,0,1592242526,41800001,5151,[LG21]Lords of Gondor
188367613,ᶦᶠKinkyTail,16813305,23647320,545758,410743,750063,717499,1765777,76864,3720946,1842641,0,894011998,42186939,10632,[LV21]Lords of Valinor
188824641,Sabesaur312,16783039,178017,72,61605,21023,10955,7983,0,101566,7983,0,717328751,0,1962,[LR21]Lords of Rohan
189068044,Hsotits7,16638274,12200310,995230,966771,1440390,1040579,491964,2211,3941915,494175,0,2038645936,16241240,3380,[LG21]Lords of Gondor
196566747,Codrin4Valhalla,16627503,4548981,171119,259177,157063,124705,346050,11185,898180,357235,0,653908880,89594454,5910,[LV21]Lords of Valinor
189579148,стратег,16475452,2439007,1269763,90576,272116,146355,125592,1766,636405,127358,0,2309890690,1378833,2187,-
188833114,Quent2,16423786,19383932,329806,270123,76329,367435,1641535,64608,2420030,1706143,0,1389356569,14298007,9847,[LV21]Lords of Valinor
189181702,222mb222,16243353,2096107,769471,199359,63662,40288,176776,0,480085,176776,0,2974368420,225401626,1708,[LR21]Lords of Rohan
188928573,Thànhteo,16180422,1269484,231737,5214,47138,152454,56435,0,261241,56435,0,1503008285,0,3085,[21M]Immortal Myrmidons
188585266,メDragønメ,16173256,6200803,260935,13008,75292,24207,548489,23295,684291,571784,0,1565973095,73489482,19339,-
188852196,DarkExecutioner,16132302,1452447,100617,60616,84044,164244,61526,0,370430,61526,0,1216662089,28060602,1834,[TFS:]The Forsaken Souls
188823187,AZERBAIJAN90,16127248,891992,1273713,78632,32607,42323,49764,7206,210532,56970,0,2188918647,3040,1275,[~AKT]BR AKATSUKI
164927516,iven0007,16039236,10077159,800589,584997,950594,899393,404788,20676,2860448,425464,0,1058169628,29829009,5842,[LG21]Lords of Gondor
188868206,Quocbao05032012,16087669,1765350,652703,140343,12908,5049,169127,0,327427,169127,0,1666556629,6000000,1992,[LR21]Lords of Rohan
187880560,wcwc,16017764,230115722,1527635,19485000,18674475,23053443,9591814,36893,70841625,9628707,0,3214040764,596448438,13547,[21if]farm 21If
188432088,BandAid,15964516,6291099,303434,23738,88926,146960,503492,24287,787403,527779,0,2892232893,308659606,8269,[LG21]Lords of Gondor
188861925,blackbandito,15962649,3203886,432177,181283,407143,143151,121328,28373,881278,149701,0,1396091414,24105565,1941,[LG21]Lords of Gondor
188513738,MooSáke,15925441,198927,96089,15385,14235,12870,11590,0,54080,11590,0,1780276892,0,1221,[RC21]ROYAL CROWN
188845980,Azadi,15918290,2414584,591878,280392,474111,105066,99002,0,958571,99002,0,1847489422,3366983,1069,[I-am]RoyalLoyalMembers
188894198,Tomioka senpai,15828178,379272,52185,4153,47557,61967,3546,0,117223,3546,0,2527773697,0,1797,[21If]Immortal Falcons
188376429,ᴵᶜmySoul,15771305,447638,94861,165290,199177,4054,1,0,368522,1,0,1304212012,7488905,8462,[LR21]Lords of Rohan
188436016,KiLLedYouhaha,15617380,4666342,180571,186673,224968,166558,341772,4756,924727,346528,0,2519592916,79055118,9477,[LV21]Lords of Valinor
187078010,Dr4gonsFarmerツ,15450978,22163921,1316246,641729,1799365,1256244,1338903,1142,5037383,1340045,0,2602487365,1725005764,7885,-
188825941,S0SKA,15447745,1189854,237525,181770,115056,123932,42766,0,463524,42766,0,1573181792,17191302,2471,[21M]Immortal Myrmidons
188809474,Edgar15,15275743,46285,13168,43659,11087,2650,478,0,57874,478,0,2116886110,0,1245,[21M]Immortal Myrmidons
188879219,Akglate,15231878,247677,40137,19567,121882,0,0,0,141449,0,0,2071709078,1758755,592,[LR21]Lords of Rohan
188878343,Cheiron City,15111134,2006372,65708,76640,299335,127026,88427,0,591428,88427,0,1322839078,0,1645,[21if]farm 21If
188134384,ˢ carlossainz,14985271,6601011,1300774,21788,65922,52235,498539,63524,702008,562063,0,1190118090,25406959,3992,[LG21]Lords of Gondor
188781490,Fra1d,14941512,1187031,100258,39857,116341,94712,56753,0,307663,56753,0,1220961083,5509155,3143,[LG21]Lords of Gondor
187560016,Kyubi Farm1,14905729,43242083,1156562,1634869,1976614,1528733,3245429,19633,8405278,3265062,0,1346795918,409430369,6742,[LG21]Lords of Gondor
188857667,Apoathou,14864616,1322660,1124764,128214,19733,13903,120194,0,282044,120194,0,230139173,156690,1077,[LG21]Lords of Gondor
188365295,ᴿᵃTsumiki,14849316,2089406,0,8924,38778,19749,193107,0,260558,193107,0,1063300942,3762398,6032,-
150775231,Lind21,14802402,7690885,484858,498285,954081,721214,266273,6774,2446627,273047,0,1823420717,3048989,2494,-
188963486,GÖZTEPELİ35,14745890,131575,0,26938,85,5222,10513,0,42758,10513,0,1956299993,230887100,3805,-
188858878,lisabella,14734483,237752,277117,67710,112105,0,0,0,179815,0,0,564098530,0,1598,[21M]Immortal Myrmidons
189036275,TheBlackDragon,14685362,163506,24134,22964,32186,14353,3713,0,73216,3713,0,2009936397,0,1760,[LG21]Lords of Gondor
188281290,1GuiltyCrown1,14684527,19247655,1007323,1096697,1425467,992963,1183957,18298,4717382,1202255,0,3338991462,1802857517,17048,[LG21]Lords of Gondor
188785649,priam,14663414,1018374,776393,44812,14478,5529,95834,0,160653,95834,0,1438025525,18007168,324,[tgqm1]amarl
183848200,Ei Farm,14628754,38195393,1298931,2526718,1320489,1044558,2973860,56612,7922237,3030472,0,3104627390,519374881,13481,[LG21]Lords of Gondor
188877463,Se Tuath De,14599857,1904865,811661,93157,158781,182383,83914,0,518235,83914,0,2500484754,5600000,2395,[LG21]Lords of Gondor
188825002,Namiq Cebrayilo,14592202,3934535,1259596,213707,290110,151386,270603,0,925806,270603,0,2054340511,0,722,[21MA]Myrmidons Academy
186073361,卂尺丂Farm,14533826,3469427,345837,39537,204145,32135,292469,0,568286,292469,0,2285339662,489706596,1512,[LG21]Lords of Gondor
186035363,Klgi20,14530180,1079100,1084576,54111,135908,7883,18115,29189,245206,47304,0,1760407171,1200000,3113,[21If]Immortal Falcons
188802524,Mickodem,14470876,193221,131028,1699,7453,9839,13862,0,32853,13862,0,1197961668,13257436,2966,[LG21]Lords of Gondor
188863496,dark8582,14419995,408222,113485,9062,63839,37988,12678,0,123567,12678,0,1840445582,0,700,[jk10]jk 3621
188885079,ᴵᶜnoobhuhu,14359074,4468313,44006,263679,640053,58918,289366,307,1252323,289673,0,1694858992,26599999,5002,-
188885945,whyreall,14191004,1427513,1410059,61686,45602,10688,128122,0,246098,128122,0,1497367838,862617,2035,-
188796842,Menda2137,14183968,321687,136804,21106,48638,8855,18477,0,97076,18477,0,1116877840,0,1463,[LR21]Lords of Rohan
188986083,KyoHN,14306330,58505,16806,10125,15173,711,2329,0,28338,2329,0,2290303910,69,2850,[LG21]Lords of Gondor
12113325,Elena23EV,14119615,1297746,131418,8451,10921,55191,102057,1644,178264,103701,0,1082602637,24431024,5626,[LG21]Lords of Gondor
188287771,ᅟᅠᅠᅠᅠᅟᅠᅠᅠᅠ ᅟᅠᅠ,14068228,55138144,428726,330732,673936,319444,5244635,0,6568747,5244635,0,4950223494,2064968833,28815,[LG21]Lords of Gondor
188858305,Palestine313,13929996,3028033,1334422,129577,527939,188640,119168,0,965324,119168,0,1352690663,0,4,[Alg]Palestine313
170835406,ᴵᶜ Has,13928147,1445859,679890,46009,32626,7559,101847,16135,204176,117982,0,687055286,298517,2939,[21If]Immortal Falcons
188800436,LilPiglet,13922495,769658,220953,34240,152043,47076,27042,0,260401,27042,0,1356803706,0,1283,[LR21]Lords of Rohan
188873290,FarmЛиса,13907205,2607974,596991,64191,23711,6956,237079,7455,339392,244534,0,1402791857,122800001,4107,[LG21]Lords of Gondor
188896546,БорисBao,13857624,1182765,168254,14668,118405,170863,25957,0,329893,25957,0,1761224189,22966398,1423,[LR21]Lords of Rohan
188847086,Dimiboy,13810706,75311,0,179,37638,0,0,0,37817,0,0,1157986098,0,17,[Tick]Tick tack
188953179,SarahVinyard017,13756390,5795264,260817,103502,87804,304494,438098,0,933898,438098,0,1388844714,31860199,3832,[LG21]Lords of Gondor
188806889,Gouverneur188806889,13755515,785370,316714,61610,182543,80923,8427,0,333503,8427,0,1079193412,0,1024,[21MS]Myrmidons Farm
188235523,Asinki,13723238,339363,48213,2387,25328,6875,26073,0,60663,26073,0,1692751389,0,2508,-
188856535,HOIANA,13569210,1190153,693357,435295,160981,54643,43890,6183,700992,50073,0,1708913985,400000,1139,[21if]farm 21If
44936497,젝스킹,15991483,6996924,923387,39204,54846,41378,523118,74135,732681,597253,0,2183506756,0,9052,-
188931757,ᴸʳANTHRAX,13379560,659165,84307,164935,187652,32931,11915,0,397433,11915,0,1368451784,0,2094,-
191069538,Shinnygamyy,13259416,3037148,499817,235031,755080,228183,56725,0,1275019,56725,0,1083252012,5089962,691,-
188832666,ChifOJ,13258711,2361104,125471,94442,41533,55215,203829,0,395019,203829,0,2465486257,0,520,[21IR] Corral
187795145,SOTER,13279932,8447735,539910,529189,65018,309343,652149,22650,1578349,674799,0,1281515387,112215799,15221,[LG21]Lords of Gondor
188836866,zlucifer,13134321,2684582,271491,220751,328964,145856,139908,0,835479,139908,0,1701695970,0,1524,-
188787790,You  andl,13067664,920284,416012,51124,134014,82128,31352,0,298618,31352,0,1280376609,4084888,1912,[LR21]Lords of Rohan
188981583,Calep2012,13028091,5854580,972385,252824,915423,175225,313923,6652,1664047,320575,0,1371560025,704256,4512,[K~R~]3621 Utility Box
191177358,RtthyrFarm,13005278,52258,8925,14892,0,0,4928,0,19820,4928,0,3381867008,1594265331,1108,[LG21]Lords of Gondor
193596249,Korkusuz 51,12958052,239160,358859,12402,0,0,23668,0,36070,23668,0,1401609699,60357336,943,[LR21]Lords of Rohan
187257305,HolySpirits,12934800,4186335,271743,116035,83670,59317,375642,105,634769,375747,0,1152390563,477259605,5802,[21If]Immortal Falcons
188291209,ROCKS  D  XEBEC,12853105,3694092,969555,42334,42629,46712,328702,6325,466702,335027,0,1822462533,37349860,9225,[jk10]jk 3621
188845348,ᴸʳLUNICTUS,12776912,104914,26926,6884,16888,8978,3385,0,36135,3385,0,1525032979,0,451,[LR21]Lords of Rohan
188292201,쵸Bear,12762411,3636617,863462,127956,652623,13205,183272,21012,998068,204284,0,1398516677,0,8400,-
190539451,puyolF,12571448,972686,309560,2673,66571,105265,41795,0,216304,41795,0,4482122565,1818372170,1994,[LR21]Lords of Rohan
188887466,Jensamtresen,12529683,2851467,834974,287219,392239,254799,99035,0,1033292,99035,0,872502186,10799999,840,[I-am]RoyalLoyalMembers
188837379,안정아남자,12498744,885792,199719,262430,137821,8581,52334,0,461166,52334,0,1790673289,0,1075,[LG21]Lords of Gondor
189266244,ᴵᴾRágnär,12376390,2424921,681640,338989,350984,104124,70352,26757,891206,97109,0,245500638,11642489,7444,-
142371438,NokedliF11,12302691,3005981,754566,516818,830716,67154,61715,17771,1494174,79486,0,1496304971,2400001,10465,[21M]Immortal Myrmidons
178904209,MorFarm2,12182432,243458,0,0,0,3117,23099,0,26216,23099,0,1692919713,335244116,803,-
188880051,qftydhunvfezbjj,12100235,18338939,1337013,1249255,1030656,1111224,1086802,35743,4513680,1122545,0,1422326310,88951930,7822,-
188816893,WARRIOR FARM 10,11991223,242793,17769,22009,47558,10254,10226,0,90047,10226,0,1306471434,0,1890,[21If]Immortal Falcons
188217778,ᴵᴰKing Nemo,11974922,1852509,716667,684238,272077,322,117022,0,1073659,117022,0,1857331281,0,12936,-
192581999,LilitЛиса,11972459,1758597,2586,4079,12074,27936,162189,0,206278,162189,0,2007807878,377325710,3522,[LG21]Lords of Gondor
188900034,Rajpoots,11877066,854381,223016,55556,81433,13291,62724,0,213004,62724,0,1837134235,0,3097,[LG21]Lords of Gondor
188899884,hanaaaa230,11913790,3656113,993138,112016,538707,284659,141766,0,1077148,141766,0,1405623621,3785937,1096,[K~R~]3621 Utility Box
190430624,IMPERADOR FARM,11807275,449281,436505,3716,0,322,44725,0,48763,44725,0,4562803856,1810735206,1517,[LR21]Lords of Rohan
185259121,Lets go Os,11804914,913938,1168728,282,16846,7330,13445,35821,73724,49266,0,1375527451,4800000,1565,[LG21]Lords of Gondor
188946350,BaabyyKiller,11764448,45777543,823248,1480408,3397133,2896319,2635750,37221,10446831,2672971,0,1760569996,20189360,9196,-
187384799,C H A D 3 3 3,11746674,5025006,638494,336794,550030,58137,356220,3142,1304323,359362,0,942780690,0,4530,[LG21]Lords of Gondor
188952266,ErDegui,11704483,7108681,230822,125436,58773,125367,620570,12944,943090,633514,0,1166685836,13045768,5395,-
188838338,boble 79,11700752,306757,46338,1697,52760,41937,3315,0,99709,3315,0,1268137620,0,2117,[21MA]Myrmidons Academy
123456386,Igoryan,11694898,4148092,193112,1303020,222892,143876,286620,0,1956408,286620,0,1237006382,11392165,1253,[LG21]Lords of Gondor
60584385,silverlion9,11596083,7926707,936250,516238,906635,1186930,126153,47,2736003,126200,0,1472425909,5041847,1012,-
188819203,Cominogr,11595827,347521,71452,268238,123679,11074,222,0,403213,222,0,1621617087,0,850,[ANTB]ANnti Banned Club
188887462,Dunks,11514670,1538565,760926,36818,198678,122594,64347,0,422437,64347,0,1107672787,0,1032,[LR21]Lords of Rohan
188479340,ㅡᅟᅟF2P 8      ㅡ,11505459,9974813,173571,883535,766581,262971,721306,0,2634393,721306,0,2683335321,956471741,8839,[LG21]Lords of Gondor
188801943,Brunk100,11490847,938220,200395,171290,279130,31043,22153,0,503616,22153,0,1330342807,2513093,2827,[21If]Immortal Falcons
188363322,쵸Belmont,11394210,726781,18931,225245,250029,43961,583,0,519818,583,0,1181365988,1410552,11058,-
185877603,ㄴ Aurelio ㄱ,11366004,3426162,734268,194294,519109,17374,220713,3623,955113,224336,0,891518433,1758080,3475,[LG21]Lords of Gondor
187155907,Yuzhi,11347461,5032590,1641848,115533,189407,294655,290433,27386,917414,317819,0,1987523106,257605,1997,[LR21]Lords of Rohan
188892262,Udi lopez,11318748,286475,30519,120358,27289,7419,17815,0,172881,17815,0,256340902,3001045,1830,[21If]Immortal Falcons
188307234,ᴵᵀJessyS2,11159564,3418968,138406,130180,168640,9783,301652,0,610255,301652,0,1509177777,180913621,6306,-
174523518,ㅡᅟᅟF2P 5      ㅡ,11138040,3700033,325966,825415,1309771,123637,42086,0,2300909,42086,0,2211849745,808382628,2410,[LG21]Lords of Gondor
188900167,Charles grand 3,11130964,4207791,779277,591939,722430,168606,197012,0,1679987,197012,0,1699589449,8400000,912,[Tick]Tick tack
188840892,AlbertO,11026319,415004,15277,47370,78237,8794,21388,0,155789,21388,0,1666596987,0,1894,[21If]Immortal Falcons
184327666,ツاحمدᴰᴮ,10962277,2081120,510564,680474,487997,101508,56300,0,1326279,56300,0,1376937463,72130,2126,[LG21]Lords of Gondor
189443468,Hubey,10948714,2171604,462536,189562,257421,35910,147521,0,630414,147521,0,918945909,0,1967,-
188818543,GodAnubis,10939200,3265470,842158,347813,333503,280538,140675,0,1102529,140675,0,1194971456,473118,740,[21IR] Corral
188309795,ᴵᶜ TAZIEX,10844048,8618161,951227,435439,559362,399095,559725,10936,1964557,570661,0,1632163083,0,8839,-
188856725,Uranusuki,10800751,268914,32838,25630,66282,25841,2786,0,120539,2786,0,745390242,0,692,[LR21]Lords of Rohan
188840453,La pampara,10738446,3201722,940369,135652,353642,305562,124506,0,919362,124506,0,1361687708,0,275,[21if]farm 21If
188818957,alonsoisma,10719135,2300239,762386,25316,47973,75270,189815,0,338374,189815,0,1463107576,4826393,1373,[LR21]Lords of Rohan
189182502,ᴵᶜVatson67F,10716113,137197,213594,1669,4693,617,12501,0,19480,12501,0,3375349820,1724148322,1587,[LR21]Lords of Rohan
188840730,FurkiTolki,10713408,1839593,1140153,3217,12856,72657,143339,4461,236530,147800,0,1633298724,3600000,2008,[21M]Immortal Myrmidons
188320795,Fïshböy F1,10704803,863662,410313,146172,398,5918,78330,1333,232151,79663,0,1455949983,75426551,1070,[LR21]Lords of Rohan
188790900,Dom Daddy,10568049,3300666,900720,27914,83403,91562,276203,0,479082,276203,0,1726575546,0,1436,[OP1]OP CLAN
188839518,Zaragoza,10563193,1181120,88062,120100,376712,100919,0,0,597731,0,0,1381711559,0,1072,[LR21]Lords of Rohan
188847841,Lj1208,10517902,314850,314434,984,0,1961,30681,0,33626,30681,0,1163764928,0,901,[21If]Immortal Falcons
188817859,oktaev,10501368,401425,359467,33669,31021,2770,32157,0,99617,32157,0,1053669288,0,100,[DD21])Dragon of Death
117517315,ᴵᶜBOTAN,10360428,13712356,945529,506093,1444925,965222,611992,37024,3565256,649016,0,1235813199,498018246,20006,-
188522411,Ваn,10341550,1095208,3365,36724,120447,26500,74097,0,257768,74097,0,727419882,1,2218,[21If]Immortal Falcons
189182788,Vatson67f3,10244331,260412,485136,2684,4031,13106,19939,0,39760,19939,0,3366631887,1133268751,1336,[LR21]Lords of Rohan
188889920,Carolk,10206491,642390,541227,49383,96269,35954,29616,0,211222,29616,0,1132287410,1349311,322,[fagr]alpha table
188295840,ッ Yakuza ッ 6,10205094,395204,0,3871,70818,40591,9043,0,124323,9043,0,992758872,82882904,4847,[21if]farm 21If
189442766,Gubernur189442766,10193668,77204,41779,1313,9937,12737,612,0,24599,612,0,2385015991,1656650136,693,[21IR] Corral
188906315,ᴵᶜИвaн,10115924,1248369,45240,148765,274837,58418,43527,0,525547,43527,0,943901017,16348226,12804,-
188840603,andyrendy,10073872,1722850,894100,10373,99042,247058,53446,0,409919,53446,0,1032365452,0,459,[Slon]Slonii
195403312,môngcổ,10051155,1446809,783623,85946,65345,87040,95077,0,333408,95077,0,1256472656,0,1035,-
188857096,Di 1,9982935,909985,10470,103819,160058,85834,22577,0,372288,22577,0,934774982,1843151,2952,-
188898591,Dthomas,9838220,468487,81006,125157,122286,22516,10882,0,280841,10882,0,434478065,0,1343,[LR21]Lords of Rohan
188899095,Minuz,9812603,1614469,364375,167345,306671,102167,55899,0,632082,55899,0,713176492,0,1678,[LR21]Lords of Rohan
188471943,NoCoboY,9790738,413116,95171,64153,54918,15880,22693,0,157644,22693,0,1074224406,0,3617,[LG21]Lords of Gondor
188838106,lordwick2,9778316,1099592,578684,106742,80625,58521,68291,0,314179,68291,0,695873248,44224,1674,[LR21]Lords of Rohan
194265891,쵸MØTÃSÊMツ쵸 2,9719627,1456012,0,0,0,2233,144708,0,146941,144708,0,1315761204,125453620,1341,[LG21]Lords of Gondor
188300029,Hoàng Saa,9656790,5137975,463048,87026,120041,279872,368510,3795,859244,372305,0,1200137918,9873378,8100,[LR21]Lords of Rohan
189869613,Алёнааа,9642598,3146615,691598,31047,82951,360086,153416,0,627500,153416,0,1457300043,503089664,1093,[GW21]GOATED WARRIORS
191785327,ᴿᵃQueen,9625702,3017237,247312,228656,300820,10824,232657,0,772957,232657,0,2123392947,813781963,1187,[LR21]Lords of Rohan
186988267,Panda ᴸᴺ,9616784,2766515,1120377,7927,2980,11995,264463,3318,290683,267781,0,3082740466,512115698,1981,-
188846435,psilva3,9583049,1390439,255473,331056,379662,122656,7428,0,840802,7428,0,922728548,0,580,[21IR] Corral
188844387,Dark omen,9537255,3440562,757307,393182,695255,208669,113674,0,1410780,113674,0,1006196711,188732373,3911,[TFS:]The Forsaken Souls
188815675,KōbøLord,9517898,145859,16647,15805,9235,19277,4712,0,49029,4712,0,843374303,0,1696,[LR21]Lords of Rohan
189915380,BJXXX,9491146,4168395,1002299,38629,16464,369203,265093,0,689389,265093,0,1376708133,0,1615,[LR21]Lords of Rohan
