ID,Name,Power,Killpoints,Deads,T1 Kills,T2 Kills,T3 Kills,T4 Kills,T5 Kills,Total Kills,T45 Kills,Ranged,Rss Gathered,Rss Assistance,Helps,Alliance
179940560,ᴸᵛ ink,101634471,640987760,4332796,2556731,868211,971623,36843214,13321068,54560847,50164282,0,6111099506,1873979817,81436,[LV21]Lords of Valinor
188540500,TakeMe2Valhalla,86066280,1450691759,5160258,12511616,5652155,10639829,106979181,16226700,152009481,123205881,0,2834278325,7061247251,44652,[LV21]Lords of Valinor
186145908,ʳᵉʸEscanor,83627351,1529355190,3712561,4655002,915441,1734412,126358994,12803286,146467135,139162280,0,3527282017,4498233340,22503,[LV21]Lords of Valinor
180304933,LilLƴ,78775914,320630592,3361737,2782862,2764385,3236435,17771761,6194095,32749538,23965856,0,1165190205,5020554697,22241,[LV21]Lords of Valinor
188858506,Cúchulainn 쵸,76640229,248008604,1946106,713072,273416,425482,21707625,1427049,24546644,23134674,0,5017656691,512651627,37432,[LV21]Lords of Valinor
179655012,ᴸᵛDØØPER,76250763,546239286,2483117,2616693,973544,1254625,34872984,9501026,49218872,44374010,0,8442457191,1451282008,38157,[LV21]Lords of Valinor
178695066,SokoDrake,69458016,110764976,2739209,966390,105667,147411,7890524,1543274,10653266,9433798,0,7874355787,115903540,17504,[LV21]Lords of Valinor
180560115,TripEhh,62839350,401422644,1420469,2616534,813884,294450,24694543,7557417,35976828,32251960,0,6670142676,1225250480,11312,[LV21]Lords of Valinor
184964288,ᴾᴿFïshböy,62379199,269177291,2100314,2057085,4656295,3958131,20604044,1879016,33154571,22483060,0,3473604285,632742525,38653,[LV21]Lords of Valinor
179977300,ᴸᵛTmulla,62170196,775621279,1802231,3860548,417684,1492228,43428983,16687753,65887196,60116736,0,6973872452,5600679937,17678,[LV21]Lords of Valinor
188839265,A 10 Warthog,57610387,12330470,230642,42253,74269,128873,999555,83122,1328072,1082677,0,3718500782,724780894,10985,[LV21]Lords of Valinor
186009654,Dooby ᴼᴺᴱ,56849330,291055795,699771,2460788,347817,487446,26344666,1223578,30864295,27568244,0,7558501832,137216122,35386,[LV21]Lords of Valinor
188341936,ᴸᵛ Vatson67,55320232,268839308,1694949,1326311,557828,595665,23068111,1719461,27267376,24787572,0,6515349199,384720155,42111,[LV21]Lords of Valinor
178814644,ᵁʷᵘØtòt,55014659,444858744,3140400,18550973,3385819,2356133,31505688,5494775,61293388,37000463,0,2295222519,2329433716,15876,[LV21]Lords of Valinor
188918989,ᴼᴸ Kaymo,54954072,125177460,1092879,2484352,1386449,2529103,10279320,449904,17129128,10729224,0,3790896455,1075163587,41598,[LV21]Lords of Valinor
185836736,ᴸᵛMasonFTW,50738829,469453533,2378902,5724465,2214818,4769431,38472042,3004043,54184799,41476085,0,3356207047,2802859223,28676,[LV21]Lords of Valinor
186985518,HornyAPOLLOS,50543658,230981032,1464459,2892482,1515750,3176209,19498836,983892,28067169,20482728,0,2762353510,594947984,18088,[LV21]Lords of Valinor
182514982,ᴸoᵛeSalmon,50267816,402462962,2976384,17816580,655039,737772,27169916,6146966,52526273,33316882,0,5474784573,1060488180,52688,[LV21]Lords of Valinor
180060983,ᴸᵛRumRamsey,48316675,365956215,2220332,95115478,5048028,991336,26994036,3146568,131295446,30140604,0,6054561846,417518493,93632,[LV21]Lords of Valinor
184871937,ScazBigLion,47509180,1217022721,4527691,56591135,23364142,26120855,94350903,5549188,205976223,99900091,0,5925433539,13704268108,20846,[LV21]Lords of Valinor
142628224,Dae jang goon,47134877,162550305,2387504,1946869,718048,367829,12883812,1520770,17437328,14404582,0,4912804891,102794418,16865,[LV21]Lords of Valinor
181308342,ᴸᵛRockSolid,46634741,186966633,2676014,2673547,709463,1391557,12483593,2730542,19988702,15214135,0,3441554811,5902949920,40583,[LV21]Lords of Valinor
181825355,ᴸoᵛePUMA,46343624,224481913,1342478,1450618,359419,531778,15955680,3089452,21386947,19045132,0,3290245647,3599759382,35291,[LV21]Lords of Valinor
176994964,Cpl Rage,45792298,114314788,476872,2377013,1506916,2122761,8943153,645149,15594992,9588302,0,1897067015,63265830,17111,[LV21]Lords of Valinor
185808036,Ze Bosh,45657049,324557669,903869,8598579,2626646,3862918,28938009,637645,44663797,29575654,0,5524831742,631820319,29935,[LV21]Lords of Valinor
179750493,GuiltyMahiru,44722218,170017490,976622,2932954,770432,1180564,14459134,928822,20271906,15387956,0,1482257976,2025360302,40151,[LV21]Lords of Valinor
188920797,FreyaFullBosom,44086664,88752090,1751730,1764654,953550,1150730,7085750,551582,11506266,7637332,0,3579210764,1323334617,24091,[LV21]Lords of Valinor
184826667,ᴸᵛAHERUS勇,43276602,513672701,1416939,12789309,5927578,11125761,44119962,677851,74640461,44797813,0,5887208668,1396853955,24982,[LV21]Lords of Valinor
182423962,シValkyrieCillaﾒ,42566396,115841513,1859073,5641345,822285,707431,8900521,1061687,17133269,9962208,0,5097951393,1265202822,15083,[LV21]Lords of Valinor
179813923,ㄴ Bless ㄱ,42320356,236773429,2185386,7761519,5947505,5144214,18830978,721974,38406190,19552952,0,2461122531,978016636,23444,[LV21]Lords of Valinor
181739549,kylinn,41829522,97526701,3321903,2389177,278410,278364,6880327,1328766,11155044,8209093,0,5128390117,10337862643,31310,[SFIS]Sky Fighters
185690465,Dictator  Goat,41763660,350310517,2053726,6070059,2159337,1277583,31857908,1054421,42419308,32912329,0,6094153991,1005155698,34969,[LV21]Lords of Valinor
187247613,Queen Padmé,41554018,206445398,3171048,4415860,2992217,3977513,16277592,1044591,28707773,17322183,0,7608077461,4648542203,86686,[LV21]Lords of Valinor
188976136,ᴸᵛ MUSE,41018183,96051520,1184156,2079562,2348513,921788,7386667,669238,13405768,8055905,0,5168990110,365719425,47782,[LV21]Lords of Valinor
188241812,Gilgamesh2323,40904830,107477152,858128,24115744,200187,260810,9191245,464897,34232883,9656142,0,5076192530,62620586,25047,[LV21]Lords of Valinor
188969478,ᴰᴹMePaul,40403920,88066801,983206,1953068,3290337,2573561,6148169,465979,14431114,6614148,0,3662431378,278578838,3534,[LV21]Lords of Valinor
188483360,ᴼᴸTryxan,40159670,200408316,1209835,21229570,2837205,2706913,15624592,1170721,43569001,16795313,0,6067536903,2169436768,40324,[LV21]Lords of Valinor
186199010,Daphneᴵᴿ,39550899,197186545,1701241,1778105,1269505,3330126,15060209,1518466,22956411,16578675,0,4169489182,1498857670,55130,[LV21]Lords of Valinor
187423027,ᴸᴳPandaFr3d,39404193,187064700,2048263,1957321,794040,914974,14509374,1816576,19992285,16325950,0,2836499160,6820681844,26206,[LV21]Lords of Valinor
188785515,Johnvin,39343424,169648419,1692593,738996,467737,1071559,14597259,915316,17790867,15512575,0,4947841952,93446315,56799,[LR21]Lords of Rohan
185282531,Jëster,38407289,45496988,2695521,469962,132883,175975,4001273,221030,5001123,4222303,0,3451908286,592793562,26235,[LV21]Lords of Valinor
188485523,ᴸᵛIMPERADOR,38330878,194318576,1007660,600362,31074,81329,15846910,1767097,18326772,17614007,0,6211068215,281752989,36787,[LV21]Lords of Valinor
185457048,Cman9918,38231477,133602129,1160939,3704156,1184975,873737,11641776,528932,17933576,12170708,0,1996001700,126071365,16769,[LV21]Lords of Valinor
188882878,Rtthyr,37910297,97058353,842990,232908,106385,116963,8286205,673455,9415916,8959660,0,7400184670,93046400,19233,[LV21]Lords of Valinor
188880730,ᴸᵛMarlone,37681571,140317721,1911316,485948,371025,197873,11777629,1045535,13878010,12823164,0,5918483522,136720000,44761,[LV21]Lords of Valinor
187726069,ᵀᴿvSpryth,37632049,65857461,731133,1327439,163988,333442,5630975,381024,7836868,6011999,0,5455960213,15763287,23169,[LV21]Lords of Valinor
188651683,Sol Aliyaa,37480924,12427327,140221,119895,49805,35722,1146505,34790,1386717,1181295,0,3953446448,201676244,15530,[LV21]Lords of Valinor
180368631,ᴸᵛWinfields,37384305,165249366,4670313,23224274,189123,611409,12141439,1818312,37984557,13959751,0,5207497811,1877834074,13678,[LV21]Lords of Valinor
179816952,Hell CAT GTR,37342331,59619348,2896557,79058810,1765741,1889101,2592212,339879,85645743,2932091,0,5487585383,1636698071,10834,[LV21]Lords of Valinor
188569749,ᴵᴾEndoloris,37018743,135932617,1872172,1390988,2616276,1563397,10769220,823804,17163685,11593024,0,1822151378,163440000,5369,-
189060019,Tušiš,36723084,82068235,775218,722106,635078,1036387,7051037,299887,9744495,7350924,0,2930614984,552362596,20246,[LV21]Lords of Valinor
178213242,ᶦˢLOCOOZ,37464982,138855735,3850546,2141345,957035,1554554,8305688,2361915,15320537,10667603,0,4368166294,1274602396,21962,[LV21]Lords of Valinor
188648613,Känguruᴵᴰ,36524158,25538784,340214,377701,272323,171077,2091875,165777,3078753,2257652,0,2953884233,286935074,13509,[LV21]Lords of Valinor
188789133,MiniMe,36389701,37392567,340034,258586,224998,167551,3406889,107588,4165612,3514477,0,4957790395,34179151,11718,[LV21]Lords of Valinor
189072394,ᴵᴾLaura,36340359,46674165,1312098,7341019,383206,780510,3626089,252831,12383655,3878920,0,6274884193,362529904,27215,[LV21]Lords of Valinor
188805469,BossAlienᴾᴴ,36262221,69988131,1237994,250538,604492,927660,5961084,270378,8014152,6231462,0,4975009974,134750966,39625,[LV21]Lords of Valinor
182338045,亗ƧHiꟻT亗,36122720,134754048,1095353,2640524,1006449,1310254,8852061,1922571,15731859,10774632,0,5513712033,2515586970,32305,[LV21]Lords of Valinor
185048534,Han Sansan,35822384,135645165,816325,909706,342096,539228,12049948,606132,14447110,12656080,0,6077734463,357367305,31781,[LV21]Lords of Valinor
188276623,ᴸᵛArork,35704518,85975102,934057,7261071,1265703,1364258,7111817,270814,17273663,7382631,0,3787986291,360935366,16516,[LV21]Lords of Valinor
189065897,W3llsFargo,35666185,36866964,662685,1191313,898257,213767,3194692,101510,5599539,3296202,0,3910180558,2754424297,18955,[LV21]Lords of Valinor
188303104,HokieHighlander,35390615,70320448,1304590,344971,109840,53066,5775756,602790,6886423,6378546,0,1068111678,84975248,13428,[LV21]Lords of Valinor
186444772,Dr4gonツ,35278980,266246916,3165022,5679943,3502249,3856115,23101065,583566,36722938,23684631,0,5328493553,4177255259,38783,[LV21]Lords of Valinor
188333348,ᴷᴺLinh,35262074,69039233,935539,1902695,1645656,5139453,3825611,327673,12841088,4153284,0,4890230561,550111352,11029,[LV21]Lords of Valinor
185341770,ᶜᵘRalfish,34895578,56607561,2488511,836048,394052,497142,4209832,578268,6515342,4788100,0,2680200774,25760000,15825,[LV21]Lords of Valinor
181534760,ᴸᵛSongoku,34582131,78665598,1418818,947363,718037,1206878,6736752,242251,9851281,6979003,0,3880202927,755945265,15890,[LV21]Lords of Valinor
185089489,ᴼᴾZOROGRANJ,34332185,89977952,1885507,550571,355159,737615,7809122,405792,9858259,8214914,0,5703855206,2083599610,21232,[LG21]Lords of Gondor
188969981,ᵸᵒWand0,34237976,65383304,1286067,2054730,706949,524275,5320812,412662,9019428,5733474,0,4292634395,306699275,22604,[LV21]Lords of Valinor
185986678,卂尺丂,34135998,85165499,1209220,680685,1395198,1286689,7045359,331931,10739862,7377290,0,3322053349,1193919485,14883,[LV21]Lords of Valinor
189017405,ᵸᵒWizzy,33866118,36300354,1128087,812593,975948,1093260,2745400,117945,5745146,2863345,0,2748067298,170159151,14320,[LV21]Lords of Valinor
188336265,ᴸᵛiGREC,33844795,34730580,354919,533661,195122,279696,3016008,147737,4172224,3163745,0,2450337076,175934276,17264,[LV21]Lords of Valinor
188826595,Saf1974,33510907,107758814,1400434,1284520,555245,574540,8591850,908738,11914893,9500588,0,5167747965,230946040,49603,[LV21]Lords of Valinor
188970345,PitBlue,33513773,100803181,862627,1120668,1623539,1658595,8170621,449569,13022992,8620190,0,4021351491,1077393393,22911,[LV21]Lords of Valinor
188501467,direraven,33432511,97524912,744306,5169512,2366933,2785371,7053194,504186,17879196,7557380,0,4895005353,4551820,27019,[LV21]Lords of Valinor
182317160,G  O  P  A  Rr,33298200,165961188,1939750,3134912,2312668,2727770,14047011,466384,22688745,14513395,0,4147758283,738465485,28424,[LV21]Lords of Valinor
188794709,ᶦᵗˢᵘRYU,33268425,108101914,993557,1318150,2549412,2529700,8622740,319663,15339665,8942403,0,3669264737,94094214,35649,[LV21]Lords of Valinor
189154415,ᵸᵒMDKMB,33267020,64025434,785334,2572471,865337,727479,4950755,468140,9584182,5418895,0,2167004626,2596649243,19985,[LV21]Lords of Valinor
190252265,Jamong,33057909,47896421,986556,240286,331111,224508,4124413,252199,5172517,4376612,0,5244288719,81003240,23521,[LV21]Lords of Valinor
188651684,Milo San,32928061,7521953,256838,5998,5637,18715,663262,40100,733712,703362,0,2973774593,359753808,11937,[LV21]Lords of Valinor
187029935,HolySpirit,32902546,130508859,1420772,1243047,1343710,1577860,11281393,422373,15868383,11703766,0,2699626296,1104079437,18498,[LV21]Lords of Valinor
182713036,쵸ﾒMØTÃSÊMツ쵸,32729439,24386338,662283,107410,239091,451161,2136407,35898,2969967,2172305,0,5096908443,123301386,20372,[LV21]Lords of Valinor
188837916,Silent Kakashi,32624677,105876915,889638,839969,754922,750377,9809221,155268,12309757,9964489,0,1779086350,103761097,14006,[LV21]Lords of Valinor
188544046,G4mine,32447417,26635738,854807,262602,631545,296942,2070874,171181,3433144,2242055,0,4317317823,247760315,20193,[LV21]Lords of Valinor
185037763,ᵛBEARDY,32277187,51437912,2227119,28222212,2319488,801981,2906415,444121,34694217,3350536,0,4921911553,554484409,19513,-
188368264,funne,32270403,29061061,1265037,834275,642636,595616,2141909,190369,4404805,2332278,0,3763880137,61698120,16553,[LV21]Lords of Valinor
185612447,Chaudary Zain,32264971,144415515,1440237,9266996,1590757,914083,12372583,599922,24744341,12972505,0,4494914087,1323892732,25249,[LV21]Lords of Valinor
188736727,Alex9003,32177916,36546250,1660154,2964172,704741,765686,2519127,314496,7268222,2833623,0,4191027666,38138060,14304,[LV21]Lords of Valinor
188362493,亗MrDuck ツ,32162298,54077183,1162431,14223855,2043574,1147191,3984118,135766,21534504,4119884,0,2839273860,909611190,16802,[LV21]Lords of Valinor
187559873,ｱ尺ﾉ丂ᄃﾉﾚﾚﾑ,31983704,62577567,524842,786256,540194,444292,5234590,360843,7366175,5595433,0,2629725287,626443180,15365,[LV21]Lords of Valinor
188352541,ᴾᴿ Mèoッ,31837806,127518876,1258710,7188100,1700314,1303642,10538936,603835,21334827,11142771,0,6155018627,0,14364,[LV21]Lords of Valinor
188451175,ᵸᵒTerra,31597633,59456104,870910,3422823,860914,534113,4795714,347806,9961370,5143520,0,4033854923,92432122,22409,[LV21]Lords of Valinor
186765655,KönigsKlãsse,31538313,191446432,930323,2111571,1361404,1848800,15841417,1124597,22287789,16966014,0,3561610171,407789115,8164,[LV21]Lords of Valinor
188833519,JulieLaTueuse쵸,31518267,26083364,621039,141152,346846,94148,2242289,128098,2952533,2370387,0,3563842711,37720000,19825,[LV21]Lords of Valinor
188225231,ᴾᴿSko0p,31174638,32524184,356756,168570,89071,72567,3026488,87859,3444555,3114347,0,4545798280,0,27140,[LV21]Lords of Valinor
185724517,Feldgraŭ,31151705,146940777,1759421,439339,3849630,1436815,11099577,1120531,17945892,12220108,0,4251264117,178066760,33337,[LV21]Lords of Valinor
189045190,Azura21,31097936,28813819,1079446,528436,682624,3020226,1479906,23146,5734338,1503052,0,2787495027,423984134,8058,[LV21]Lords of Valinor
186841127,Anossss,30975306,96568563,1396074,5831747,161764,119554,8329768,564848,15007681,8894616,0,4227453465,4253401,14570,[LV21]Lords of Valinor
190407807,동탄불주먹,30951825,26808448,1056665,693230,330666,695585,2029013,146800,3895294,2175813,0,5314248039,433522789,15409,[LV21]Lords of Valinor
188242643,hoahaizz,30861698,116702129,931394,3648605,968129,568030,9517984,829095,15531843,10347079,0,3768402189,567041937,29829,[LV21]Lords of Valinor
188598120,ᶻSharineko〤,30641844,82378445,830245,875997,1456432,803718,6199089,704231,10039467,6903320,0,2372667043,51185747,16708,[LV21]Lords of Valinor
184882401,Ферма а,30474226,92188321,1751779,22831138,3000621,3316968,6264480,285409,35698616,6549889,0,2669728364,3538154179,17474,[LV21]Lords of Valinor
188847278,ᴸᵛQuang,30318155,148753503,1217495,1245616,1436737,1289374,13109603,468869,17550199,13578472,0,4098685688,1610824614,33835,[LV21]Lords of Valinor
188961098,Chocolalat,29975575,2573117,220977,51569,65233,15462,226397,5326,363987,231723,0,4184133012,21199999,3583,[LG21]Lords of Gondor
177013392,ᴸᵛ UCC15,29722791,39005363,2664930,1200338,936753,880990,2885533,225625,6129239,3111158,0,5340331348,192271545,16145,[LV21]Lords of Valinor
188789684,ᴿᵃtMadson,29585771,22982260,542169,1177460,162620,152532,1959718,110711,3563041,2070429,0,3927935299,72421016,40592,[LV21]Lords of Valinor
188316323,ᴸᵛ SAKURA,29524592,101571696,1378468,2386732,1137444,2024123,8627321,222488,14398108,8849809,0,4136763841,539454569,26523,[LV21]Lords of Valinor
188262339,Kitty27,29430840,7212243,100178,54908,178359,33366,453638,108735,829006,562373,0,3820979147,23588840,10699,[LV21]Lords of Valinor
188797972,21LuviVilu21,29428684,19399984,1222428,579952,518648,328487,1463837,114719,3005643,1578556,0,4362786354,34539709,15818,[LV21]Lords of Valinor
188293704,ᴸᵛDrMusaab,29417649,42059156,1576702,191214,427716,173783,3595411,225812,4613936,3821223,0,3785495548,84578452,14520,[LV21]Lords of Valinor
181581608,Fledermauz DB,29277765,32274033,694585,248895,300074,511759,2919449,19129,3999306,2938578,0,3577184021,377676127,7743,[LV21]Lords of Valinor
185923730,JFDLCA,28993234,270726632,434687,5131053,3803977,6044357,22995362,398071,38372820,23393433,0,4724363620,386336005,36507,[LV21]Lords of Valinor
185651937,ᴳᵃʸGrizzy,28827761,394704092,1530202,11881112,5833583,11664631,32492852,453683,62325861,32946535,0,3744084354,952357579,20305,-
189001955,ᴸᵛTruNguyen,28732473,23592016,718506,844954,157659,366262,2007146,78560,3454581,2085706,0,4440145817,231678867,16403,[LV21]Lords of Valinor
188853241,Алёнаа,28658489,26362229,749181,246727,344883,856812,1737317,241135,3426874,1978452,0,4490727156,45525540,12949,[LV21]Lords of Valinor
188876886,ᴸᵛTheanh,28564420,126687079,1326532,1972819,306133,579340,11558871,388709,14805872,11947580,0,5558614383,107966937,34531,[LV21]Lords of Valinor
188364390,ᴸᵛLeonPoi,28485148,150364056,1317830,495443,399103,640818,13039892,824994,15400250,13864886,0,3770245997,108004980,36482,[LV21]Lords of Valinor
186295211,ᶠˡVENDETTA,28473342,115576250,2742984,4081984,1084740,528626,9229579,909004,15833933,10138583,0,3885646386,1050356942,20072,[LV21]Lords of Valinor
188819438,ᴸᴳLuca,28424513,46044144,573803,296542,432636,250296,4088058,161890,5229422,4249948,0,4226971836,286280200,24190,[LG21]Lords of Gondor
185282573,ᴸᵛ3621 BANK,28344977,62632106,771884,668111,1267167,649115,4855577,440596,7880566,5296173,0,1360685180,923285969,8657,[LV21]Lords of Valinor
188543996,ᴸᴳﾒNØHOPEツ,28307687,22368772,750300,321061,76882,175524,1916358,114256,2604081,2030614,0,3386899463,31608954,11673,[LV21]Lords of Valinor
182720562,ᶜᴹᵈSkyy,28092367,19752884,2388318,291902,77615,310791,1289299,270156,2239763,1559455,0,3999667646,685652689,12498,-
186709522,ᴸᵛ SHERY,28006430,62181428,1562880,609853,401512,544566,5212383,347717,7116031,5560100,0,3407463504,99489407,9533,[LV21]Lords of Valinor
188830020,ᴸᴳVersized,27875731,58654173,842032,636445,938250,417681,4783700,357133,7133209,5140833,0,3751935748,46055668,10528,[LV21]Lords of Valinor
186043643,卂几Ҝ卂,27641858,56856941,1181956,888325,301712,375673,4847804,304756,6718270,5152560,0,3289280040,501165307,29972,[LV21]Lords of Valinor
188944242,Đạt Feet,27612422,20137588,758416,769072,733958,1500022,1065457,93060,4161569,1158517,0,4576721820,16457231,9087,[LV21]Lords of Valinor
185538462,UMAYKIZ,27576723,81705586,1210994,2427602,751593,861735,7005038,310978,11356946,7316016,0,4064131149,8566632,6423,[LV21]Lords of Valinor
188335709,Rebel Rogue,27575415,73969387,1366902,1040029,700124,771386,6274509,326525,9112573,6601034,0,3451581802,34205137,33716,[LV21]Lords of Valinor
188547640,Kitty8152,27409522,1630693,12032,78078,153637,150776,70470,0,452961,70470,0,6253049957,2547000,7593,[LG21]Lords of Gondor
188880546,Graf000007,27329155,4086246,1602923,195112,206722,115320,276770,20240,814164,297010,0,3477399514,0,4021,[LG21]Lords of Gondor
188294260,CЦEПИOH,26992293,10421111,1855157,581297,556310,288078,772954,15519,2214158,788473,0,2731696545,173206292,7525,[LG21]Lords of Gondor
188806334,Emrah 51,26971037,3751158,1312229,1012,10602,4008,371372,0,386994,371372,0,4126810750,0,4417,[LR21]Lords of Rohan
188852900,Scorpionking乂,26852854,81554677,2564465,698557,536746,1654576,6937107,217605,10044591,7154712,0,2212905829,58256706,32039,[LV21]Lords of Valinor
188192835,SвулканS,26794951,19947464,388225,2031363,306088,979874,1431780,34586,4783691,1466366,0,3364532541,52162299,9068,[LV21]Lords of Valinor
188453555,Puyols,26653954,53926779,1090161,414135,352520,193153,4642930,296850,5899588,4939780,0,6740080815,127173124,24020,[LV21]Lords of Valinor
188575943,BATUMSKİ08,26634066,122429813,2518476,8713459,9991171,6956425,6958424,164742,32784221,7123166,0,2795070563,529137921,20660,[LV21]Lords of Valinor
188788713,Sam smith,26543015,33664469,760222,594797,331614,179458,2873137,171654,4150660,3044791,0,3889931849,33958258,12578,[LV21]Lords of Valinor
188872694,DELİ ÜSTAD,26515321,5962066,716649,208561,290491,524323,257508,33350,1314233,290858,0,4271516949,39905983,2115,[LG21]Lords of Gondor
188285810,ᴵᴰJupanu,26507693,47189990,1043044,864684,1573717,521185,3714482,232003,6906071,3946485,0,4803345202,57408174,20025,[LV21]Lords of Valinor
189040679,ㄴHORIZONㄱ,26480811,74776471,764075,947828,1035889,885967,6855262,20932,9745878,6876194,0,4541245002,188105599,14265,[LG21]Lords of Gondor
188364525,ᴵᴾEmrys II,26412458,3119874,218964,53070,30135,8285,294045,3770,389305,297815,0,2091717356,0,2715,-
188836483,YenifferDeRivia,26290054,41563930,1633040,1784534,2318341,1691838,2852355,63972,8711040,2916327,0,3408936737,140738085,4884,-
188877484,ᴵᵀBLOOM,26240463,73412319,1615750,429658,286070,678042,6496736,253736,8144242,6750472,0,1847010287,111895750,28933,-
189141193,ᴸᵛJankels,25978802,54329109,819486,2368695,1924928,2323951,3777349,146811,10541734,3924160,0,3300444942,28726902,16240,[LV21]Lords of Valinor
186010544,Mehmet027,25934532,55990992,1540749,1745924,1605817,1988711,4394543,26495,9761490,4421038,0,3013925263,173638054,8758,[LV21]Lords of Valinor
188365363,diegokristy,25931677,42915909,464864,421018,640200,815724,3350701,239070,5466713,3589771,0,3724189269,246281206,15434,[LV21]Lords of Valinor
188818127,ᴿᶝ风华,25879894,2158531,1064759,62955,74067,33164,157987,14264,342437,172251,0,4133209605,64472747,3860,[LG21]Lords of Gondor
188939030,TBILISI,25876927,7839558,1253222,516250,1297487,330601,372081,4906,2521325,376987,0,3040166411,460258,11683,[LG21]Lords of Gondor
189939798,ʰᵒDestructor,25820014,18469100,52616,21684,68111,82633,1799801,0,1972229,1799801,0,2833941168,11281500,855,[LG21]Lords of Gondor
188806124,ᴵᴾAltar,25682493,111614407,1481141,3177848,4192360,2583327,8685363,270359,18909257,8955722,0,2531022967,7742830,26734,[LG21]Lords of Gondor
188836051,Cheops Pyramide,25542158,69241955,1096532,644865,285017,461502,6262634,203530,7857548,6466164,0,4441060429,751419894,36604,[LV21]Lords of Valinor
188835262,vinzsou,25481568,16544753,334531,46309,92071,38810,1490113,64749,1732052,1554862,0,2293899163,0,12986,[LV21]Lords of Valinor
188891048,7BeLa,25337382,57642914,872000,370252,777201,2820258,4394591,39376,8401678,4433967,0,3249200119,137794496,5868,[LG21]Lords of Gondor
188320476,ᴿᵃЛиса,24991436,40750946,1141689,367832,506674,543458,3453792,147614,5019370,3601406,0,4797801128,362428945,39687,[LV21]Lords of Valinor
188855274,GOLTEB,24939325,128214224,1327294,1219432,175391,426239,11747670,421895,13990627,12169565,0,3389128868,35237187,41836,[LV21]Lords of Valinor
146179581,lupepvp,24712181,11494645,602010,166315,115101,34970,956166,76482,1349034,1032648,0,5363525823,108915418,14992,[LV21]Lords of Valinor
188319008,ᴸᵛКэп21,24483757,10075514,29597,216150,128394,92909,914970,12708,1365131,927678,0,2233408969,0,10985,[LG21]Lords of Gondor
188324838,ХОНДА,24399153,7990779,1618420,319927,430706,215833,601619,9293,1577378,610912,0,2514329809,122738819,6015,[LR21]Lords of Rohan
188912287,ᴸʳgCoelho,24374600,32589223,820622,1419717,814999,1014738,2429903,115865,5795222,2545768,0,2458135163,113818904,7006,[LV21]Lords of Valinor
84905552,Schwazzier,24363573,10701276,506526,147563,86882,62010,838244,93376,1228075,931620,0,3189110689,60672597,8022,[LV21]Lords of Valinor
188937309,Velikiy Govard,24212488,9823194,638326,125640,141509,280242,795672,21868,1364931,817540,0,2669768944,85678023,5232,[LG21]Lords of Gondor
189236516,ᴿᶝ年华,24141429,2290337,936926,56107,169818,48265,162204,6219,442613,168423,0,3748301308,48671853,2933,[LG21]Lords of Gondor
184845080,ᴸᵛSCAR德,24071683,56328240,645537,214040,313729,200941,4970433,257494,5956637,5227927,0,3826807675,46674299,28179,[LV21]Lords of Valinor
185602720,ˢᵉAbdallah,23875417,37680310,200395,749910,727131,953454,2914261,155982,5500738,3070243,0,1707106341,127071312,9573,[LV21]Lords of Valinor
181974650,IDEM City,23791400,2030305,1163258,142285,141908,58538,141798,3295,487824,145093,0,3776027518,86095121,2071,[LG21]Lords of Gondor
184872506,ᴾᴿF A J A R,23766513,81330450,1396757,2282220,2097345,3030279,6197714,129053,13736611,6326767,0,3250277163,28252952,13422,[LG21]Lords of Gondor
188840841,ᴸᵛNotZach,23579521,30110904,506333,591643,826092,444463,2318528,168863,4349589,2487391,0,1610330294,107725390,4487,[LV21]Lords of Valinor
188793523,FerAmaya,23568250,12010601,506442,129947,223590,105868,817780,146808,1423993,964588,0,3610487668,43532335,5255,[LV21]Lords of Valinor
185094982,Phi Dương F2P,23542175,38331232,1940175,2842133,5213473,4079345,964930,68459,13168340,1033389,0,2109637550,147926355,5354,[LV21]Lords of Valinor
188376202,ᴵᴾ云霄,23513229,6413730,1214571,147461,159504,83670,504869,34093,929597,538962,0,2593018500,17020000,4268,[LV21]Lords of Valinor
188390528,ᶦᶠAkrosh,23277756,14179254,358164,80861,884019,546131,1021052,0,2532063,1021052,0,1408491622,139317710,2243,[21If]Immortal Falcons
188994494,Snowplow,23267982,1094552,236306,8504,103749,19351,80795,0,212399,80795,0,2893011449,0,3454,[LR21]Lords of Rohan
188880486,Kỳ tiktok,22910127,8487802,1062340,68271,30446,79884,622510,93431,894542,715941,0,3921732062,0,3153,[LV21]Lords of Valinor
144563085,ᴵᶜPARANOIA,22878266,4730553,1770534,15817,22531,23272,408292,25316,495228,433608,0,2831381744,1021382,4811,[LG21]Lords of Gondor
188937116,ᴵᶜTom,22847232,4798418,78668,26543,281358,25756,401873,5432,740962,407305,0,2254933220,6485919,12148,-
188899189,QuantSist,22695383,1720056,385409,11624,68715,76283,127517,0,284139,127517,0,2061881959,296458,5532,[LG21]Lords of Gondor
188661481,Kängurufarm,22685146,2847269,781585,208965,117034,10247,253042,0,589288,253042,0,2409834236,1128542199,4146,[LG21]Lords of Gondor
188842111,JJ00,22498335,12581657,546042,13757,120082,40863,1073927,71801,1320430,1145728,0,2619609251,3999999,3647,[LV21]Lords of Valinor
185134660,PetitDr,22413048,3101404,85261,63894,67172,12418,288305,1078,432867,289383,0,1499181335,17979430,10865,-
188234979,iGRECfarm,22319661,15844038,286311,273003,46153,43158,1490992,30729,1884035,1521721,0,2703807026,315563112,10672,-
191454845,ᴸᵛTueAnh,22288694,21625833,664298,6082249,104981,279588,1661303,123402,8251523,1784705,0,5607331180,1009408023,11898,[LV21]Lords of Valinor
189057248,Cekko23,22247705,21896824,595985,139303,267141,394238,1785995,94889,2681566,1880884,0,3617312457,76002446,11287,[LV21]Lords of Valinor
188851823,ᴸʳMent001,22123271,706360,45963,213744,185983,43829,11633,0,455189,11633,0,1970670946,0,2749,[LR21]Lords of Rohan
186016235,卂丂卂千,21994818,5455072,172363,142922,151729,14030,395527,55582,759790,451109,0,1918510434,12932669,3828,[LV21]Lords of Valinor
188830522,ᴸʳTylnmrl,21931190,1670861,37663,32839,20609,4164,155652,2495,215759,158147,0,2274652236,16585000,4644,[LG21]Lords of Gondor
185905587,Ze Boshman,21929998,4802837,1158706,309125,97861,13805,369719,39644,830154,409363,0,2770839083,41584565,2619,-
188870613,xXVincinetteXx,21868756,8307709,1851059,867867,503902,29008,656394,22318,2079489,678712,0,4699104174,5876311,23600,-
188639928,The亗SCARFACE,21787174,2476955,64606,145589,285116,162864,116131,3242,712942,119373,0,3218718778,44040000,4309,[LG21]Lords of Gondor
188846843,BoboFranek,21704370,1436892,86860,96434,230127,133623,42286,0,502470,42286,0,1842439115,45731253,5585,[LG21]Lords of Gondor
188255601,Ant Man21,21587050,21740037,261646,303216,192688,238972,1939567,47123,2721566,1986690,0,3143089623,0,3958,[LG21]Lords of Gondor
188878743,Jetare,21506095,15140296,984262,914090,1762279,1205895,603568,28683,4514515,632251,0,3220916043,91210728,3017,[LV21]Lords of Valinor
188337674,ᴵᴸAxan,21341002,13852737,908861,382486,81728,81286,1314956,6904,1867360,1321860,0,2630380192,376836150,9606,[OP1]OP CLAN
184817793,meto 313,21317837,2940073,2001835,184629,125724,112750,75554,72258,570915,147812,0,2979371442,1827622,1796,[LR21]Lords of Rohan
188838640,Presidente CIAO,21311194,3248958,61803,13150,115426,83389,268192,0,480157,268192,0,1641145618,23800000,4514,[LG21]Lords of Gondor
186018265,yıldırımsefa,20960432,12642300,258459,159713,850626,471324,812371,45005,2339039,857376,0,3107778481,50620184,8856,[LR21]Lords of Rohan
188889549,СЦEПИОН,20926077,2997871,1241527,21675,25683,72660,248333,8410,376761,256743,0,1923428853,102567597,3693,[LR21]Lords of Rohan
188819819,fox77778,20828700,3782562,738594,75581,204618,428450,164441,0,873090,164441,0,3320812202,1037349,4692,[LG21]Lords of Gondor
188856715,ᴸᴳJackie,20824463,14164490,284873,80252,30041,24787,1277627,60647,1473354,1338274,0,1251412249,20000000,4079,[LV21]Lords of Valinor
189036655,Vitia back 1990,20779043,9551108,2056000,172660,105414,21917,821704,50052,1171747,871756,0,2680145814,9800000,8581,[LR21]Lords of Rohan
188443825,йкйцк,20721165,48743894,1313992,1943111,2457331,1223280,2839555,507597,8970874,3347152,0,2532968576,1971457076,21172,-
187503097,Romulus1991,20696661,29678593,179996,189776,70341,268479,2454662,193971,3177229,2648633,0,3837247187,82802392,17288,[LV21]Lords of Valinor
188876948,Ruberoid,20518997,1308095,30041,24678,63862,55794,95226,0,239560,95226,0,1481823105,3846529,4614,[21If]Immortal Falcons
184819319,joe200,20426646,2022401,1197317,130789,249677,21520,45323,47879,495188,93202,0,1631673131,91263980,5852,[LG21]Lords of Gondor
183360513,ᵀᴸмønoメ,20415868,26110591,478300,186118,247673,221163,2277659,95839,3028452,2373498,0,2125813241,85509847,6981,[LG21]Lords of Gondor
188884272,ZHIANZD,20398835,1216090,246973,127800,150740,29760,77001,0,385301,77001,0,2488342395,0,2033,[LR21]Lords of Rohan
184859052,ᴸᵛamadxd1,20294782,10023642,1080886,167940,454668,303192,677143,54826,1657769,731969,0,2203449470,315992716,7093,[LV21]Lords of Valinor
188847403,Vali188847403,20267668,1805843,502942,88125,113717,240436,59904,0,502182,59904,0,1174440329,0,641,[_NDM]New Jersey Nol
188884453,dm152,20243575,261473,0,20838,55033,4660,12860,0,93391,12860,0,2685656319,0,4341,[LG21]Lords of Gondor
188790227,СУЛИМАH,20234807,2937806,1265520,69552,52214,89972,230812,7573,450123,238385,0,1837825253,102878721,3411,[LR21]Lords of Rohan
188325495,쵸 See La Meet 쵸,20218723,26136473,714725,1038428,1614240,1553702,1521512,63519,5791401,1585031,0,3512199870,0,7931,-
145631489,BABA SON,20099681,6791782,290848,136434,494296,267396,335994,67319,1301439,403313,0,2176799640,4400000,4892,[LV21]Lords of Valinor
188806434,ᴸᴳ Bimz,20082311,4958433,658635,38897,29786,6973,379801,53259,508716,433060,0,2964005765,29458520,9790,[LV21]Lords of Valinor
188836639,Ndiaye,20047982,5853377,660696,352077,491543,747064,181162,0,1771846,181162,0,2981242641,383503,1620,[LLA]Lost legion academia
188903920,JoshuaSeil,20027365,5466182,817155,57531,197583,100305,423075,21377,799871,444452,0,2962429442,301497,4040,[LV21]Lords of Valinor
188857113,GritNGravy,19836602,1953070,46395,39362,14347,20181,183578,0,257468,183578,0,2950709690,3200971,3737,[LG21]Lords of Gondor
188898779,kral jon snow,19738727,113087,6227,15339,20427,859,6573,0,43198,6573,0,2753058077,8327554,2899,[21If]Immortal Falcons
189075824,NooByZ,19621709,8523920,1530004,77034,121760,128921,748617,13157,1089489,761774,0,3365718003,99259891,19016,-
188261313,freezebee 21,19587371,2027071,234347,244875,375237,108803,79241,0,808156,79241,0,1759282121,5187959,14551,[LG21]Lords of Gondor
188232993,AKON311,19570367,17474104,658995,571073,531874,842388,1182997,54831,3183163,1237828,0,1770213436,850687088,12260,[LG21]Lords of Gondor
188539042,Chieu F2p,19562831,23706450,464904,857871,1727252,652023,1402402,172413,4811961,1574815,0,2135723107,185342934,11056,[LV21]Lords of Valinor
186613612,Inigo Montoya1,19562079,4781554,1455414,349831,116242,28761,403220,16593,914647,419813,0,2642696922,103076547,8561,[LV21]Lords of Valinor
191530671,ᶦᶠtMadsonn,19539554,1846035,34099,69047,86817,200703,85578,0,442145,85578,0,2641543224,910375198,4596,[LR21]Lords of Rohan
188814205,SUBUTAİ 38,19349422,1466044,274608,292102,181430,22696,95398,0,591626,95398,0,1962129755,3080000,2306,[LG21]Lords of Gondor
188430882,JapayuKingBILAT,19353349,13661282,558328,244614,718820,347450,1008612,34940,2354436,1043552,0,2858661772,142262581,15536,[LV21]Lords of Valinor
188838663,ERON,19151310,7419903,732610,190505,250716,72425,647213,5927,1166786,653140,0,2009368022,20081022,12080,[LG21]Lords of Gondor
188853064,TerrorBlade98,19117626,4698786,941546,120572,115534,39441,414286,7149,696982,421435,0,3342269105,0,1350,[LG21]Lords of Gondor
188818238,PoTaPyh,19113761,17945708,847850,488230,854873,981299,1155520,32896,3512818,1188416,0,3095818179,301072527,13039,-
188776545,ᴳᵒᵈ Ingle,19023968,1048600,93501,85140,135892,24107,66336,0,311475,66336,0,1700822632,3404666,5145,[LR21]Lords of Rohan
188845810,BARBALIAS,18899874,5080729,1177937,167048,291925,201260,352189,6827,1019249,359016,0,1731230822,0,5851,-
188869412,dân chơi đá,18877333,8228309,246570,288205,739830,1185717,194814,0,2408566,194814,0,2106256471,1154652,1641,-
188827507,Dug1man,18769163,106428,5346,18103,18794,0,6522,0,43419,6522,0,2547277791,0,2489,[LG21]Lords of Gondor
188360951,SATORUGOJO1,18483733,9398145,472927,508838,996498,575503,431459,34339,2546637,465798,0,1605356212,317828071,6695,[LV21]Lords of Valinor
188844580,RedHoodJT,18421245,3724748,210774,117223,615129,546669,28437,0,1307458,28437,0,1672945686,0,1460,[LR21]Lords of Rohan
187197359,Demir Bilek,18416515,9273471,779097,120768,235808,174193,781889,13102,1325760,794991,0,2218437994,30192868,11164,[LG21]Lords of Gondor
188836606,Black AngEL,18316975,8655975,1937740,908418,995278,553139,422312,2403,2881550,424715,0,2137121812,18536152,1820,[LG21]Lords of Gondor
188490339,Eudaimonia,18226727,5238222,227320,56910,36785,12770,453803,28208,588476,482011,0,3261248192,30962500,5627,[LG21]Lords of Gondor
150165925,ᴸᴳken arok,18164679,20174751,614040,4481149,278014,115931,1646083,89897,6611074,1735980,0,2462962577,26909895,11322,[LV21]Lords of Valinor
188336750,SKY EAGLE,18136313,7121747,985124,330019,49903,45477,677403,0,1102802,677403,0,1931799839,213802552,9588,-
188806199,Op khan,18127391,4774879,1311876,240925,827408,507637,83281,10426,1669677,93707,0,2891993589,4253716,3154,[LR21]Lords of Rohan
189014302,magister,18034793,11593788,947900,205152,1188782,528161,695989,5133,2623217,701122,0,1327725746,15363819,7383,[LG21]Lords of Gondor
188865329,Việt hoang 07,17892195,607097,64769,419495,234049,900,5150,0,659594,5150,0,2214217502,1833721,888,[21M]Immortal Myrmidons
188884243,HiagoLira,17859765,1285899,1,5567,1871,82946,94926,0,185310,94926,0,1646654627,0,2367,[21If]Immortal Falcons
188787622,MalandrageX,17820013,20690,0,2434,1687,245,1585,0,5951,1585,0,2520328655,0,3278,[LG21]Lords of Gondor
188367613,ᶦᶠKinkyTail,17670136,28509728,652235,1415633,750063,721224,2139436,121964,5148320,2261400,0,981786994,42186939,11891,[LV21]Lords of Valinor
189231766,darkkiller666,17669854,3746982,286312,236683,195194,50737,294065,8283,784962,302348,0,2533244060,20289481,14046,[LG21]Lords of Gondor
188487100,Kir8,17514261,744292,46498,47082,45400,57564,41382,0,191428,41382,0,604975853,0,4409,[LG21]Lords of Gondor
190852683,BossAlien FARM,17440747,6771910,168409,19244,81805,135783,606132,0,842964,606132,0,4306605448,1694123182,2658,[LR21]Lords of Rohan
188904786,Shadow vahalla,17318753,951871,236630,6845,11062,4462,91053,0,113422,91053,0,2842158464,0,3011,[LG21]Lords of Gondor
196566747,Codrin4Valhalla,17232645,5520141,195307,259178,157063,124705,407542,28997,977485,436539,0,653908880,89594454,6204,[LV21]Lords of Valinor
187016834,ƐƘÁ,17212549,5969476,107689,89142,174787,122716,511121,0,897766,511121,0,2764870624,1489060086,4798,[LR21]Lords of Rohan
188368666,Derik 災,17193465,17311218,78795,189202,156137,96806,1633226,12081,2087452,1645307,0,1504456225,57910439,4670,-
164927516,iven0007,17192551,10077159,800589,584997,950594,899393,404788,20676,2860448,425464,0,1100483821,29829009,6021,[LG21]Lords of Gondor
188879533,Qertt7,17116695,188791,322,8039,23990,816,10230,1682,44757,11912,0,4094902892,38000000,2155,[LG21]Lords of Gondor
188823442,VIP shooter,17056637,3305125,846887,132688,41914,75500,277768,5754,533624,283522,0,1619671259,41800001,5164,[LG21]Lords of Gondor
188585266,メDragønメ,17046256,6200803,260935,13008,75292,24207,548489,23295,684291,571784,0,1565973095,73489482,19339,-
188503741,SİYAH KAZ,16994656,2745204,35926,148261,185391,246920,121345,7182,709099,128527,0,1557000457,38351774,6878,-
188928573,Thànhteo,16834657,1269484,231737,5214,47138,152454,56435,0,261241,56435,0,1518718910,0,3090,[21M]Immortal Myrmidons
189068044,Hsotits7,16832032,13123610,995230,966771,1440390,1040579,499742,44487,3991969,544229,0,2126223169,16241240,3430,[LG21]Lords of Gondor
188824641,Sabesaur312,16783039,178017,72,61605,21023,10955,7983,0,101566,7983,0,717328751,0,1962,[LR21]Lords of Rohan
189181702,222mb222,16557247,2096107,769471,199359,63662,40288,176776,0,480085,176776,0,3088048438,225401626,1734,[LR21]Lords of Rohan
188845980,Azadi,16555498,2414584,591878,280392,474111,105066,99002,0,958571,99002,0,1862936476,3366983,1070,[I-am]RoyalLoyalMembers
188868206,Quocbao05032012,16513779,1765350,652703,140343,12908,5049,169127,0,327427,169127,0,1739889202,6000000,2029,[LR21]Lords of Rohan
189579148,стратег,16475452,2439007,1269763,90576,272116,146355,125592,1766,636405,127358,0,2309890690,1378833,2187,-
188861925,blackbandito,16445375,3299236,432177,181283,407143,143151,130863,28373,890813,159236,0,1505713466,24105565,1984,[LG21]Lords of Gondor
188833114,Quent2,16411399,22825032,342325,313030,76329,372177,1910364,100871,2772771,2011235,0,1459745074,21298007,10315,[LV21]Lords of Valinor
188432088,BandAid,16365266,6291099,303434,23738,88926,146960,503492,24287,787403,527779,0,3024518996,308659606,8319,[LG21]Lords of Gondor
188513738,MooSáke,16238442,198927,96089,15385,14235,12870,11590,0,54080,11590,0,1795611092,0,1221,[RC21]ROYAL CROWN
188894198,Tomioka senpai,16183240,379272,52185,4153,47557,61967,3546,0,117223,3546,0,2589785647,0,1809,[21If]Immortal Falcons
188852196,DarkExecutioner,16132302,1452447,100617,60616,84044,164244,61526,0,370430,61526,0,1216662089,28060602,1834,[TFS:]The Forsaken Souls
188823187,AZERBAIJAN90,16127248,891992,1273713,78632,32607,42323,49764,7206,210532,56970,0,2188918647,3040,1275,[~AKT]BR AKATSUKI
187880560,wcwc,16017764,230115722,1527635,19485000,18674475,23053443,9591814,36893,70841625,9628707,0,3214040764,596448438,13547,[21if]farm 21If
188876717,DEWO YEAGER,15949922,4619081,1089416,433008,785790,289890,180134,0,1688822,180134,0,2450400809,0,1746,[21if]farm 21If
188376429,ᴵᶜmySoul,15838205,447638,94861,165290,199177,4054,1,0,368522,1,0,1311135078,7488905,8465,[LR21]Lords of Rohan
188436016,KiLLedYouhaha,15719932,6307690,234650,186713,224968,166558,470080,22669,1070988,492749,0,2609528815,115055118,9845,[LV21]Lords of Valinor
187078010,Dr4gonsFarmerツ,15490724,22163921,1316246,641729,1799365,1256244,1338903,1142,5037383,1340045,0,2602487365,1725005764,7887,[LG21]Lords of Gondor
188825941,S0SKA,15447745,1189854,237525,181770,115056,123932,42766,0,463524,42766,0,1573181792,17191302,2471,[21M]Immortal Myrmidons
188134384,ˢ carlossainz,15380671,6601011,1300774,21788,65922,52235,498539,63524,702008,562063,0,1190118090,25406959,4001,[LG21]Lords of Gondor
188878343,Cheiron City,15325813,2006372,65708,76640,299335,127026,88427,0,591428,88427,0,1356102538,0,1660,[21if]farm 21If
188809474,Edgar15,15275743,46285,13168,43659,11087,2650,478,0,57874,478,0,2116886110,0,1245,[21M]Immortal Myrmidons
188879219,Akglate,15231878,247677,40137,19567,121882,0,0,0,141449,0,0,2071709078,1758755,592,[LR21]Lords of Rohan
186073361,卂尺丂Farm,15221962,3668107,345837,39537,204145,32135,312337,0,588154,312337,0,2285339693,489706596,1512,-
188857667,Apoathou,15173813,1322660,1124764,128214,19733,13903,120194,0,282044,120194,0,230139173,156690,1083,[LG21]Lords of Gondor
188877463,Se Tuath De,15056719,1904865,811661,93157,158781,182383,83914,0,518235,83914,0,2519605703,5600000,2406,[LG21]Lords of Gondor
188825002,Namiq Cebrayilo,15026359,3934535,1259596,213707,290110,151386,270603,0,925806,270603,0,2171057957,0,728,[21MA]Myrmidons Academy
188781490,Fra1d,14963604,1187031,100258,39857,116341,94712,56753,0,307663,56753,0,1220961083,5509155,3143,[LG21]Lords of Gondor
190329472,F1Quang,14936427,14222941,1403680,76015,288128,303523,1225945,7897,1901508,1233842,0,3922595691,2734670795,8477,[LR21]Lords of Rohan
186035363,Klgi20,14936333,1079100,1084576,54111,135908,7883,18115,29189,245206,47304,0,1863709223,1200000,3127,[21If]Immortal Falcons
188858878,lisabella,14922438,237752,277117,67710,112105,0,0,0,179815,0,0,573133911,0,1609,[21M]Immortal Myrmidons
187560016,Kyubi Farm1,14903377,43242083,1156562,1634869,1976614,1528733,3245429,19633,8405278,3265062,0,1348799318,409430369,6745,[LG21]Lords of Gondor
188800436,LilPiglet,14862004,769658,220953,34240,152043,47076,27042,0,260401,27042,0,1362486306,0,1293,[LR21]Lords of Rohan
188365295,ᴿᵃTsumiki,14849316,2089406,0,8924,38778,19749,193107,0,260558,193107,0,1063300942,3762398,6032,-
188785649,priam,14836043,1750608,803133,48303,27617,11291,164055,0,251266,164055,0,1478904072,18007168,327,[tgqm1]amarl
189036275,TheBlackDragon,14815376,163506,24134,22964,32186,14353,3713,0,73216,3713,0,2034111597,0,1766,[LG21]Lords of Gondor
188963486,GÖZTEPELİ35,14745890,131575,0,26938,85,5222,10513,0,42758,10513,0,1956299993,230887100,3805,-
183848200,Ei Farm,14731064,38195393,1298931,2526718,1320489,1044558,2973860,56612,7922237,3030472,0,3111047090,519374881,13485,[LG21]Lords of Gondor
188281290,1GuiltyCrown1,14701209,19247655,1007323,1096697,1425467,992963,1183957,18298,4717382,1202255,0,3400998424,1967206382,17069,[LG21]Lords of Gondor
188863496,dark8582,14622394,408222,113485,9062,63839,37988,12678,0,123567,12678,0,1882210488,0,708,[jk10]jk 3621
188802524,Mickodem,14611492,193221,131028,1699,7453,9839,13862,0,32853,13862,0,1204501232,13257436,2987,[LG21]Lords of Gondor
12113325,Elena23EV,14593371,1817847,131418,8455,10921,55191,154067,1644,230278,155711,0,1118673978,24431024,5751,[LG21]Lords of Gondor
188986083,KyoHN,14530550,58505,16806,10125,15173,711,2329,0,28338,2329,0,2327341610,69,2857,[LG21]Lords of Gondor
188796842,Menda2137,14350015,321687,136804,21106,48638,8855,18477,0,97076,18477,0,1116877840,0,1470,[LR21]Lords of Rohan
188873290,FarmЛиса,14328122,5775194,596991,64191,23711,6956,553801,7455,656114,561256,0,1465051949,122800001,4157,[LG21]Lords of Gondor
188287771,ᅟᅠᅠᅠᅠᅟᅠᅠᅠᅠ ᅟᅠᅠ,14201576,55138144,428726,330732,673936,319444,5244635,0,6568747,5244635,0,5007821900,2156968833,28870,[LG21]Lords of Gondor
188885945,whyreall,14191004,1427513,1410059,61686,45602,10688,128122,0,246098,128122,0,1497367838,862617,2035,-
188858305,Palestine313,14154110,3028033,1334422,129577,527939,188640,119168,0,965324,119168,0,1393427869,0,4,[Alg]Palestine313
188806889,Gouverneur188806889,14124347,785370,316714,61610,182543,80923,8427,0,333503,8427,0,1087891811,0,1024,[21MS]Myrmidons Farm
188847086,Dimiboy,14112003,75311,0,179,37638,0,0,0,37817,0,0,1220394423,0,24,[Tick]Tick tack
170835406,ᴵᶜ Has,13955620,1445859,679890,46009,32626,7559,101847,16135,204176,117982,0,687055286,298517,2940,-
188856535,HOIANA,13909052,1190153,693357,435295,160981,54643,43890,6183,700992,50073,0,1771996108,400000,1169,[21if]farm 21If
188931757,ᴸʳANTHRAX,13899726,659165,84307,164935,187652,32931,11915,0,397433,11915,0,1403263221,0,2097,[LR21]Lords of Rohan
188896546,БорисBao,13857624,1182765,168254,14668,118405,170863,25957,0,329893,25957,0,1761224189,22966398,1423,[LR21]Lords of Rohan
188832666,ChifOJ,13790240,2361104,125471,94442,41533,55215,203829,0,395019,203829,0,2536364361,0,535,[21IR] Corral
188953179,SarahVinyard017,13756390,5795264,260817,103502,87804,304494,438098,0,933898,438098,0,1388844714,31860199,3832,[LG21]Lords of Gondor
44936497,젝스킹,15991483,6996924,923387,39204,54846,41378,523118,74135,732681,597253,0,2183506756,0,9052,-
191177358,RtthyrFarm,13478130,52258,8925,14892,0,0,4928,0,19820,4928,0,3533861988,1594265331,1140,[LG21]Lords of Gondor
188787790,You  andl,13441102,920284,416012,51124,134014,82128,31352,0,298618,31352,0,1333695444,4084888,1941,[LR21]Lords of Rohan
187795145,SOTER,13362032,8447735,539910,529189,65018,309343,652149,22650,1578349,674799,0,1281516203,112215799,15245,[LG21]Lords of Gondor
188837379,안정아남자,13284800,885792,199719,262430,137821,8581,52334,0,461166,52334,0,1858253126,0,1108,[LG21]Lords of Gondor
191069538,Shinnygamyy,13259416,3037148,499817,235031,755080,228183,56725,0,1275019,56725,0,1083252012,5089962,691,-
187257305,HolySpirits,13221458,4186335,271743,116035,83670,59317,375642,105,634769,375747,0,1164962213,477259605,5804,[21If]Immortal Falcons
188836866,zlucifer,13134321,2684582,271491,220751,328964,145856,139908,0,835479,139908,0,1701695970,0,1524,-
185484265,Tors228,13083005,7740094,636018,1305674,1878812,627539,120762,178,3932965,120940,0,1312958755,25325363,7376,-
193596249,Korkusuz 51,12958052,239160,358859,12402,0,0,23668,0,36070,23668,0,1401609699,60357336,943,[LR21]Lords of Rohan
188817273,Munmon,12901737,1116310,211912,39551,42589,125343,52185,0,259668,52185,0,2476678488,0,125,-
188845348,ᴸʳLUNICTUS,12867265,104914,26926,6884,16888,8978,3385,0,36135,3385,0,1553487979,0,454,[LR21]Lords of Rohan
188291209,ROCKS  D  XEBEC,12853105,3694092,969555,42334,42629,46712,328702,6325,466702,335027,0,1822462533,37349860,9225,[jk10]jk 3621
190539451,puyolF,12812799,972686,309560,2673,66571,105265,41795,0,216304,41795,0,4663855203,1818372170,2039,[LR21]Lords of Rohan
188292201,쵸Bear,12762411,3636617,863462,127956,652623,13205,183272,21012,998068,204284,0,1398516677,0,8400,-
123456386,Igoryan,12729197,5049921,193112,1352415,222892,143876,374139,838,2094160,374977,0,1367564593,11392165,1329,[LG21]Lords of Gondor
188887466,Jensamtresen,12655435,2851467,834974,287219,392239,254799,99035,0,1033292,99035,0,877409886,10799999,841,[I-am]RoyalLoyalMembers
188899884,hanaaaa230,12589462,3656113,993138,112016,538707,284659,141766,0,1077148,141766,0,1483747990,3785937,1106,[K~R~]3621 Utility Box
192581999,LilitЛиса,12409820,4099267,2586,4079,12074,27936,396256,0,440345,396256,0,2095084381,516525710,3608,[LG21]Lords of Gondor
188986347,Pimpammm,12386241,390745,21517,13926,70135,29655,12907,0,126623,12907,0,1444868924,9172286,4484,[OP1]OP CLAN
189266244,ᴵᴾRágnär,12376390,2424921,681640,338989,350984,104124,70352,26757,891206,97109,0,245500638,11642489,7444,-
142371438,NokedliF11,12302691,3005981,754566,516818,830716,67154,61715,17771,1494174,79486,0,1496304971,2400001,10465,[21M]Immortal Myrmidons
188816893,WARRIOR FARM 10,12298512,242793,17769,22009,47558,10254,10226,0,90047,10226,0,1311205884,0,1891,[21If]Immortal Falcons
178904209,MorFarm2,12182432,243458,0,0,0,3117,23099,0,26216,23099,0,1692919713,335244116,803,-
188829162,Mkジinsane,12152527,911799,856240,15867,56941,24326,65024,2360,164518,67384,0,1543783586,1400000,3486,[LR21]Lords of Rohan
188880051,qftydhunvfezbjj,12100235,18338939,1337013,1249255,1030656,1111224,1086802,35743,4513680,1122545,0,1422326310,88951930,7822,-
190430624,IMPERADOR FARM,12089380,449281,436505,3716,0,322,44725,0,48763,44725,0,4793130197,2527734725,1566,[LR21]Lords of Rohan
188900034,Rajpoots,12004715,854381,223016,55556,81433,13291,62724,0,213004,62724,0,1871229835,0,3110,[LG21]Lords of Gondor
187384799,C H A D 3 3 3,11982637,5025006,638494,336794,550030,58137,356220,3142,1304323,359362,0,949161263,0,4534,[LG21]Lords of Gondor
188217778,ᴵᴰKing Nemo,11974922,1852509,716667,684238,272077,322,117022,0,1073659,117022,0,1857331281,0,12936,-
185259121,Lets go Os,11960614,913938,1168728,282,16846,7330,13445,35821,73724,49266,0,1375527451,4800000,1577,[LG21]Lords of Gondor
188838338,boble 79,11892832,306757,46338,1697,52760,41937,3315,0,99709,3315,0,1273489470,0,2119,[21MA]Myrmidons Academy
188479340,ㅡᅟᅟF2P 8      ㅡ,11891971,9974813,173571,883535,766581,262971,721306,0,2634393,721306,0,2712491721,956471741,8845,[LG21]Lords of Gondor
188952266,ErDegui,11804335,7108681,230822,125436,58773,125367,620570,12944,943090,633514,0,1173596936,13045768,5397,[LG21]Lords of Gondor
188946350,BaabyyKiller,11764448,45777543,823248,1480408,3397133,2896319,2635750,37221,10446831,2672971,0,1760569996,20189360,9196,-
188819203,Cominogr,11691827,347521,71452,268238,123679,11074,222,0,403213,222,0,1675910487,0,850,[ANTB]ANnti Banned Club
188887462,Dunks,11595270,1538565,760926,36818,198678,122594,64347,0,422437,64347,0,1107672787,0,1041,[LR21]Lords of Rohan
187155907,Yuzhi,11594634,5032590,1641848,115533,189407,294655,290433,27386,917414,317819,0,2040451605,257605,2014,[LR21]Lords of Rohan
188801943,Brunk100,11490847,938220,200395,171290,279130,31043,22153,0,503616,22153,0,1330342807,2513093,2827,[21If]Immortal Falcons
188363322,쵸Belmont,11471499,726781,18931,225245,250029,43961,583,0,519818,583,0,1185584888,1410552,11058,-
185877603,ㄴ Aurelio ㄱ,11433632,3426162,734268,194294,519109,17374,220713,3623,955113,224336,0,918025985,1758080,3483,[LG21]Lords of Gondor
188900167,Charles grand 3,11420203,4207791,779277,591939,722430,168606,197012,0,1679987,197012,0,1778391949,8400000,915,[Tick]Tick tack
188892262,Udi lopez,11379308,286475,30519,120358,27289,7419,17815,0,172881,17815,0,259364387,3001045,1838,[21If]Immortal Falcons
188856725,Uranusuki,11325487,268914,32838,25630,66282,25841,2786,0,120539,2786,0,826607927,3859996,724,[LR21]Lords of Rohan
188885079,ᴵᶜnoobhuhu,11287294,4932153,869902,263679,640053,58918,316980,9692,1289322,326672,0,1694858992,26599999,5002,-
188818543,GodAnubis,11339729,3265470,842158,347813,333503,280538,140675,0,1102529,140675,0,1229297399,473118,750,[21IR] Corral
188840453,La pampara,11236614,3361807,943783,169799,430270,305562,124506,0,1030137,124506,0,1482203434,0,311,[21if]farm 21If
174523518,ㅡᅟᅟF2P 5      ㅡ,11192049,3700033,325966,825415,1309771,123637,42086,0,2300909,42086,0,2238561745,808382628,2416,[LG21]Lords of Gondor
188840730,FurkiTolki,11163639,1839593,1140153,3217,12856,72657,143339,4461,236530,147800,0,1679447274,3600000,2035,[21M]Immortal Myrmidons
188307234,ᴵᵀJessyS2,11159564,3418968,138406,130180,168640,9783,301652,0,610255,301652,0,1509177777,180913621,6306,-
188818957,alonsoisma,11070128,2300239,762386,25316,47973,75270,189815,0,338374,189815,0,1529749398,4826393,1399,[LR21]Lords of Rohan
189182502,ᴵᶜVatson67F,11043573,137197,213594,1669,4693,617,12501,0,19480,12501,0,3476179681,1724148322,1604,[LR21]Lords of Rohan
189443468,Hubey,10948714,2171604,462536,189562,257421,35910,147521,0,630414,147521,0,918945909,0,1967,-
188320795,Fïshböy F1,10868517,1130852,410313,146172,398,5918,103727,1994,258209,105721,0,1513631763,649927741,1100,[LR21]Lords of Rohan
184327666,ツاحمدᴰᴮ,10860619,2653497,532046,681079,488185,101508,87684,12902,1371358,100586,0,1435025180,72130,2226,[LV21]Lords of Valinor
189007908,vua đại du,10847143,2010095,594035,32817,68882,36737,135324,18279,292039,153603,0,1664459657,27506603,6095,-
188309795,ᴵᶜ TAZIEX,10844048,8618161,951227,435439,559362,399095,559725,10936,1964557,570661,0,1632163083,0,8839,-
188839518,Zaragoza,10675166,1181120,88062,120100,376712,100919,0,0,597731,0,0,1420414559,0,1132,[LR21]Lords of Rohan
188817859,oktaev,10666395,401425,359467,33669,31021,2770,32157,0,99617,32157,0,1085954555,0,100,[DD21])Dragon of Death
188847841,Lj1208,10594812,314850,314434,984,0,1961,30681,0,33626,30681,0,1172899928,0,904,[21If]Immortal Falcons
188889920,Carolk,10405243,642390,541227,49383,96269,35954,29616,0,211222,29616,0,1157076734,1349311,322,[fagr]alpha table
189182788,Vatson67f3,10369013,260412,485136,2684,4031,13106,19939,0,39760,19939,0,3459611976,1133268751,1353,[LR21]Lords of Rohan
117517315,ᴵᶜBOTAN,10360428,13712356,945529,506093,1444925,965222,611992,37024,3565256,649016,0,1235813199,498018246,20006,-
188522411,Ваn,10346788,1095208,3365,36724,120447,26500,74097,0,257768,74097,0,727419882,1,2219,[21If]Immortal Falcons
189442766,Gubernur189442766,10320274,77204,41779,1313,9937,12737,612,0,24599,612,0,2495731197,1989430704,708,[21IR] Corral
195403312,môngcổ,10318207,1446809,783623,85946,65345,87040,95077,0,333408,95077,0,1263576129,0,1035,[LG21]Lords of Gondor
188295840,ッ Yakuza ッ 6,10205094,395204,0,3871,70818,40591,9043,0,124323,9043,0,992758872,82882904,4847,[21if]farm 21If
188906315,ᴵᶜИвaн,10115924,1248369,45240,148765,274837,58418,43527,0,525547,43527,0,943901017,16348226,12804,-
188721766,ᴵᶜZver225,10092986,5600948,578427,272790,772945,368830,252518,0,1667083,252518,0,1267009307,205403656,7600,[LG21]Lords of Gondor
188899095,Minuz,10077590,1614469,364375,167345,306671,102167,55899,0,632082,55899,0,724726492,0,1694,[LR21]Lords of Rohan
188840603,andyrendy,10073872,1722850,894100,10373,99042,247058,53446,0,409919,53446,0,1032365452,0,459,[Slon]Slonii
188300029,Hoàng Saa,10051495,5137975,463048,87026,120041,279872,368510,3795,859244,372305,0,1266950882,9873378,8149,[LR21]Lords of Rohan
188881481,678907,10043959,4054167,576543,566707,812285,378314,80300,0,1837606,80300,0,1230510461,53227,1514,[LLA]Lost legion academia
188857096,Di 1,10019335,909985,10470,103819,160058,85834,22577,0,372288,22577,0,934774982,1843151,2952,-
189285062,Linh farm 2,10013522,9739359,1413236,1086939,10938,8479,938116,4251,2048723,942367,0,5441972925,3128768761,1818,[LR21]Lords of Rohan
189869613,Алёнааа,9878154,3146615,691598,31047,82951,360086,153416,0,627500,153416,0,1475255043,503089664,1095,[GW21]GOATED WARRIORS
188898591,Dthomas,9838220,468487,81006,125157,122286,22516,10882,0,280841,10882,0,434478065,0,1343,[LR21]Lords of Rohan
188471943,NoCoboY,9816138,413116,95171,64153,54918,15880,22693,0,157644,22693,0,1081418218,0,3619,[LG21]Lords of Gondor
194265891,쵸MØTÃSÊMツ쵸 2,9780362,2185095,0,5126,24684,21098,205031,0,255939,205031,0,1420547099,125453620,1377,[LG21]Lords of Gondor
189915380,BJXXX,9740366,4168395,1002299,38629,16464,369203,265093,0,689389,265093,0,1410737613,0,1630,[LR21]Lords of Rohan
188846435,psilva3,9706543,1390439,255473,331056,379662,122656,7428,0,840802,7428,0,941221431,0,583,[21IR] Corral
191785327,ᴿᵃQueen,9625702,3017237,247312,228656,300820,10824,232657,0,772957,232657,0,2123392947,813781963,1187,[LR21]Lords of Rohan
186988267,Panda ᴸᴺ,9616784,2766515,1120377,7927,2980,11995,264463,3318,290683,267781,0,3082740466,512115698,1981,-
188962647,卂几Ҝ卂2,9578262,2082291,325396,3405,6149,30163,194866,0,234583,194866,0,1618176948,1219440595,2004,[LR21]Lords of Rohan
188815675,KōbøLord,9517898,145859,16647,15805,9235,19277,4712,0,49029,4712,0,843374303,0,1696,[LR21]Lords of Rohan
188790900,Dom Daddy,9512009,3388766,1222043,27914,83403,91562,276497,4258,483634,280755,0,1770490253,0,1445,[OP1]OP CLAN
186065635,MASONFTW WOOD,9501931,1910931,810165,6189,9403,5772,186780,0,208144,186780,0,1676823126,950725213,1283,[LR21]Lords of Rohan
188844276,tori,9424138,213019,54967,3007,1985,1182,20372,0,26546,20372,0,486406302,0,915,[21If]Immortal Falcons
188308863,Rock Farm ll,9385339,10088421,459789,450027,1066779,575927,546551,4782,2644066,551333,0,737133728,45352280,6170,-
