ID,Name,Power,Killpoints,Deads,T1 Kills,T2 Kills,T3 Kills,T4 Kills,T5 Kills,Total Kills,T45 Kills,Ranged,Rss Gathered,Rss Assistance,Helps,Alliance
179940560,ᴸᵛ k,108192822,438956715,3515439,737995,858571,656156,22604177,10421279,35278178,33025456,0,5952887388,1873979817,79811,[LV21]Lords of Valinor
186145908,ʳᵉʸEscanor,86936801,1386398921,3617960,3945705,914540,1661085,116027378,10843129,133391837,126870507,0,3478115012,4338233340,21564,[LV21]Lords of Valinor
188540500,TakeMe2Valhalla,85454390,1372708676,5133677,12405750,5648863,10614805,101029080,15308989,145007487,116338069,0,2813871131,6861247108,44169,[LV21]Lords of Valinor
180304933,ᴼᶻLil reyy,82936365,276519257,3206564,2186387,2764385,3176405,14592279,5596240,28315696,20188519,0,1103394062,4660554697,21005,[LV21]Lords of Valinor
179655012,ᴸᵛDØØPER,78854789,387257120,2165656,1229774,969397,1232048,21978606,8017906,33427731,29996512,0,8286190632,1451282007,36905,[LV21]Lords of Valinor
188858506,Cúchulainn 쵸,75016083,194617548,1721129,556160,261133,417020,17613831,808883,19657027,18422714,0,4807125406,512651627,35962,[LV21]Lords of Valinor
178695066,SokoDrake,70119208,61561847,2511465,451468,102654,145569,4110075,979161,5788927,5089236,0,7571048681,115903540,16810,[LV21]Lords of Valinor
180560115,TripEhh,63417298,299224605,1366497,1534135,808547,280026,16426398,6595830,25644936,23022228,0,6596864328,1225250480,11289,[LV21]Lords of Valinor
179977300,ᴸᵛTmulla,62746032,504791687,1724908,2409495,413380,894297,22376348,13807118,39900638,36183466,0,6890082592,5440679937,17413,[LV21]Lords of Valinor
184964288,ᴾᴿFïshböy,62150768,232834967,2065225,1995145,4656245,3957977,18519642,1104756,30233765,19624398,0,3373502836,632742525,37629,[LV21]Lords of Valinor
186009654,Dooby ᴼᴺᴱ,59438464,226733575,669917,1577826,342124,485548,20987085,696036,24088619,21683121,0,7243114916,137216122,34530,[LV21]Lords of Valinor
178814644,ᵁʷᵘØtòt,56132443,395415835,2902845,18382416,3352869,2295591,27275303,5154911,56461090,32430214,0,2295222519,2229433716,15090,[LV21]Lords of Valinor
188839265,A 10 Warthog,55733888,8485081,177018,40266,74269,128745,665131,58110,966521,723241,0,3546258403,724780894,10314,[LV21]Lords of Valinor
188341936,ᴸᵛ Vatson67,54127143,216310224,1658475,1039003,544821,595628,18855837,1203595,22238884,20059432,0,6263014421,384720155,41124,[LV21]Lords of Valinor
188918989,ᴼᴸ Kaymo,52936946,113024981,1027599,2450325,1386449,2524567,9233055,366660,15961056,9599715,0,3618037465,1075163587,40195,[LV21]Lords of Valinor
184871937,ScazBigLion,51370286,1057597913,3975727,54245068,22592962,23784399,80545096,5048721,186216246,85593817,0,5857024236,13364268108,20604,[LV21]Lords of Valinor
186985518,HornyAPOLLOS,50688540,203844038,1328117,2284490,1512134,3131188,17165898,808957,24902667,17974855,0,2711981102,594947915,17264,[LV21]Lords of Valinor
185836736,ᴸᵛMasonFTW,49694955,438294455,2372746,5603855,2208085,4769431,35830375,2768802,51180548,38599177,0,3255782735,2802859223,28155,[LV21]Lords of Valinor
180060983,ᴸᵛRumRamsey,48971975,326351118,2163165,95038663,5047920,969934,23858741,2739020,127654278,26597761,0,5958999439,417518493,90661,[LV21]Lords of Valinor
182514982,ᴸoᵛeSalmon,48841187,310523328,2776573,17625212,652284,729252,20715077,4781297,44503122,25496374,0,5416738917,1000488180,50913,[LV21]Lords of Valinor
181308342,ᴸᵛRockSolid,46053010,156884758,2426820,2664193,707125,1385050,9928927,2505410,17190705,12434337,0,3418258642,5482949920,38965,[LV21]Lords of Valinor
185808036,Ze Bosh,45487685,324557669,903869,8598579,2626646,3862918,28938009,637645,44663797,29575654,0,5524831513,631820319,29895,[LV21]Lords of Valinor
188920797,FreyaFullBosom,45032351,73915772,1618954,1713022,951963,1141723,6059521,325357,10191586,6384878,0,3410092957,1323334617,23795,[LV21]Lords of Valinor
176994964,Cpl Rage,44576325,93502377,401978,2192506,1505524,2116032,7329702,414584,13558348,7744286,0,1838360560,63265830,16771,[LV21]Lords of Valinor
181825355,ᴸoᵛePUMA,43308981,156778237,1017476,1171836,347822,494479,11041141,2172945,15228223,13214086,0,3234446014,3599759382,33838,[LV21]Lords of Valinor
184826667,ᴸᵛAHERUS勇,42949379,472704916,1238404,12675811,5925857,11098355,40417938,487262,70605223,40905200,0,5623284334,1396853955,24577,[LV21]Lords of Valinor
179750493,GuiltyMahiru,42819388,105751044,940254,2798051,770150,1126071,9120547,397069,14211888,9517616,0,1465858155,1875360302,38416,[LV21]Lords of Valinor
187247613,Sith Padmé,42630725,168605844,2414455,3465372,2992211,3976522,13650502,475862,24560469,14126364,0,7375170930,4298542203,83285,[LV21]Lords of Valinor
182423962,シValkyrieCillaﾒ,41985507,108655086,1842465,5640832,822285,707170,8369803,967782,16507872,9337585,0,5025129925,1265202821,14857,[LV21]Lords of Valinor
181739549,kylinn,41829522,97526701,3321903,2389177,278410,278364,6880327,1328766,11155044,8209093,0,5128390117,10337862643,31310,[SFIS]Sky Fighters
188241812,Gilgamesh2323,41759419,71992509,734147,2437579,200187,257995,6704774,151245,9751780,6856019,0,4885865367,62620586,23261,[LV21]Lords of Valinor
185690465,Dictator  Goat,41727831,331246659,1938979,6061698,2157810,1271305,30165982,948683,40605478,31114665,0,5850344788,985155698,34351,[LV21]Lords of Valinor
142628224,Dae jang goon,41693816,130634720,2352556,1879642,714373,319759,10812135,971483,14697392,11783618,0,4813744550,102794418,16168,[LV21]Lords of Valinor
188976136,ᴸᵛ MUSE,41197670,85064135,1161048,1964008,2348512,917125,6487889,571346,12288880,7059235,0,5073260066,325719425,46465,[LV21]Lords of Valinor
179813923,ㄴ Bless ㄱ,40992793,220699813,2184266,7734825,5947505,5124577,17565497,555228,36927632,18120725,0,2393689694,978016636,23094,[LV21]Lords of Valinor
188483360,ᴼᴸTryxan,40157648,147422454,1033557,4172973,2835314,2675448,11460076,780734,21924545,12240810,0,5876701522,2169436768,38932,[LV21]Lords of Valinor
188969478,ᴰᴹMePaul,40019423,86031221,830319,1953068,3290337,2573561,5970399,453085,14240450,6423484,0,3519376570,278578838,3357,[LV21]Lords of Valinor
188785515,Johnvin,39778508,132578913,1611749,703907,454416,1065340,11897502,414646,14535811,12312148,0,4855620223,93446315,55612,[LV21]Lords of Valinor
188485523,ᴸᵛIMPERADOR,39060904,120021274,897333,405653,28816,60168,10586226,688979,11769842,11275205,0,5996066093,181752989,34967,[LV21]Lords of Valinor
187423027,ᴸᴳPandaFr3d,39026419,164714836,1893655,1871461,791324,911124,13169288,1371026,18114223,14540314,0,2767787136,6820681844,25957,[LV21]Lords of Valinor
186199010,Daphneᴵᴿ,38693134,176157681,1617039,1524876,1269505,3309484,13540272,1233652,20877789,14773924,0,4077872092,1458857670,53642,[LV21]Lords of Valinor
188882878,Rtthyr,38683009,72536184,744753,194923,102500,108215,6407082,389426,7202146,6796508,0,7077331540,93046400,18574,[LV21]Lords of Valinor
185282531,Jëster,37975377,45496988,2695521,469962,132883,175975,4001273,221030,5001123,4222303,0,3451908286,592793562,26190,-
179816952,Hell CAT GTR,37792147,47870265,2646607,54836838,1765720,1888997,1945681,317933,60755169,2263614,0,5353861956,1636698071,10401,[LV21]Lords of Valinor
187726069,ᵀᴿvSpryth,37664996,44024569,615317,1261609,163540,319012,3796266,210323,5750750,4006589,0,5313161469,15763287,21943,[LV21]Lords of Valinor
185457048,Cman9918,37613929,128598399,1146301,3704156,1184975,873737,11230033,484617,17477518,11714650,0,1991413988,126071365,16586,[LV21]Lords of Valinor
180368631,ᴸᵛWinfields,37323621,153071208,4521082,23185411,189020,606014,11165727,1698738,36844910,12864465,0,5034318384,1868634074,13113,[LV21]Lords of Valinor
188315680,ᴵᶜ VXYzzz,37313545,99903871,786586,2876549,2107155,3146783,7644046,304333,16078866,7948379,0,5791378902,34554649,30627,[LV21]Lords of Valinor
178213242,ᶦˢLOCOOZ,37041286,121205681,3688087,2053376,957035,1554554,6929606,2168333,13662904,9097939,0,4338797235,1274602396,21591,[LV21]Lords of Valinor
188569749,ᴵᴾEndoloris,37018743,135932617,1872172,1390988,2616276,1563397,10769220,823804,17163685,11593024,0,1822151378,163440000,5369,-
188651683,Sol Aliyaa,36780348,12035638,109645,119003,49805,35722,1123748,26593,1354871,1150341,0,3845436836,201676244,15227,[LV21]Lords of Valinor
186444772,HornyDr4gonツ,36458244,244579609,2586688,5247209,3482356,3833359,21316520,403341,34282785,21719861,0,5224113590,4177255259,37343,[LV21]Lords of Valinor
188303104,HokieHighlander,36416204,51506187,1258821,163505,109840,34689,4634293,238606,5180933,4872899,0,1045133914,80507159,12734,[LV21]Lords of Valinor
188880730,ᴸᵛMarlone,36387738,117882884,1756178,410310,370088,130184,10228033,712979,11851594,10941012,0,5743022741,136720000,43184,[LV21]Lords of Valinor
188805469,BossAlienᴾᴴ,35743679,63939629,1158071,214067,604492,927433,5552798,172506,7471296,5725304,0,4814719425,134750966,37281,[LV21]Lords of Valinor
189072394,ᴵᴾLaura,35739017,38308315,1303254,7315756,351266,767013,2974366,166546,11574947,3140912,0,6170974565,362529904,26744,[LV21]Lords of Valinor
185048534,Han Sansan,35580502,101489100,743566,376122,342082,415533,9236772,334993,10705502,9571765,0,5875519511,307367305,30167,[LV21]Lords of Valinor
188276623,ᴸᵛArork,35407651,74165396,928755,727440,1265703,1364258,6306855,148146,9812402,6455001,0,3648334866,360935366,16083,[LV21]Lords of Valinor
188333348,ᴷᴺLinh,35314801,63949139,919906,1886379,1645656,5139453,3554252,209011,12434751,3763263,0,4745914719,550111352,10868,[LV21]Lords of Valinor
189060019,Tušiš,35138790,71298403,773174,583219,635078,1036021,6206012,185370,8645700,6391382,0,2804705598,552362591,19429,[LV21]Lords of Valinor
188648613,Känguruᴵᴰ,35054560,25242454,339495,377701,272323,171077,2085000,154398,3060499,2239398,0,2914267394,286935074,13308,[LV21]Lords of Valinor
188789133,MiniMe,35048636,34559322,331090,235413,224998,167551,3200660,69272,3897894,3269932,0,4815990957,28996015,11452,[LV21]Lords of Valinor
189065897,W3llsFargo,34667810,35671090,583000,1039291,898257,213767,3105929,87618,5344862,3193547,0,3743634244,2754424297,18289,[LV21]Lords of Valinor
185341770,ᶜᵘRalfish,34477678,48758965,2488511,825738,380145,497142,3689042,447727,5839794,4136769,0,2627236993,25760000,15404,[LV21]Lords of Valinor
185089489,ᴼᴾZOROGRANJ,34332185,89977952,1885507,550571,355159,737615,7809122,405792,9858259,8214914,0,5703855206,2083599610,21232,[LG21]Lords of Gondor
188794709,ᶦᵗˢᵘRYU,33822483,100902029,978863,1317829,2549412,2529700,8112752,214666,14724359,8327418,0,3454712186,94094214,34813,[LV21]Lords of Valinor
188969981,ᵸᵒWand0,33809340,63531564,1283673,2054730,706949,524275,5222676,369143,8877773,5591819,0,4209812513,156699275,22323,[LV21]Lords of Valinor
185986678,卂尺丂,33754233,78293101,1173531,678506,1395180,1286320,6477374,272401,10109781,6749775,0,3317300834,1093919485,14327,[LV21]Lords of Valinor
188336265,ᴸᵛiGREC,33354856,30341566,354919,474220,194921,277535,2707442,83616,3737734,2791058,0,2450337076,175934276,16911,[LV21]Lords of Valinor
189017405,ᵸᵒWizzy,33066657,32258417,1104851,804005,975948,1093260,2458654,59307,5391174,2517961,0,2682592941,170159151,13817,[LV21]Lords of Valinor
190252265,Jamong,32871137,41215583,945829,240286,331111,223656,3528820,216124,4539997,3744944,0,5074986306,81003240,22981,[LV21]Lords of Valinor
182317160,G O P A Rᴸᵛ,32841181,157680983,1882435,3078776,2312591,2727624,13559485,296735,21975211,13856220,0,3904867956,738465485,27363,[LV21]Lords of Valinor
181534760,ᴸᵛSongoku,32821984,77625668,1418818,947363,718037,1206878,6700487,208387,9781152,6908874,0,3806499942,755945265,157117,[LV21]Lords of Valinor
189154415,ᵸᵒMDKMB,32690088,60581606,746016,2568283,865337,727479,4669190,436773,9267062,5105963,0,2051877603,2596649121,19135,[LV21]Lords of Valinor
186841127,Anossss,32621996,70524052,1111554,1178544,154269,102769,6229679,363597,8028858,6593276,0,4159832643,4253401,13978,[LV21]Lords of Valinor
188826595,Saf1974,32582745,78278399,1331285,721829,553217,574540,6917562,277691,9044839,7195253,0,4936223177,222946040,46904,[LV21]Lords of Valinor
188501467,direraven,32474674,85739114,743222,5160953,2365199,2777679,6219711,333435,16856977,6553146,0,4657388292,4551820,26267,[LV21]Lords of Valinor
188970345,PitBlue,32406151,92946979,796762,1120668,1623522,1658543,7556619,363772,12323124,7920391,0,3905233712,1077393391,22249,[LV21]Lords of Valinor
188837916,Silent Kakashi,32298677,105876915,889638,839969,754922,750377,9809221,155268,12309757,9964489,0,1722874789,103761097,13947,[LV21]Lords of Valinor
187029935,HolySpirit,32242135,126877414,1399813,1236470,1343710,1577860,11020654,371236,15549930,11391890,0,2678626822,1104079437,18181,[LV21]Lords of Valinor
188581465,ᴸᵛSpSmeagle,32230323,54306450,771305,1264343,1093916,361345,4747301,147368,7614273,4894669,0,4086975508,150346971,19906,-
186765655,KönigsKlãsse,32217506,161810515,872121,1985538,1337845,1833427,13420645,859878,19437333,14280523,0,3520783483,407789115,7621,[LV21]Lords of Valinor
188651684,Milo San,32152366,7126633,256838,5998,5637,18715,651518,26206,708074,677724,0,2892323083,349753808,11569,[LV21]Lords of Valinor
185037763,ᵛBEARDY,32141951,51437912,2227119,28222212,2319488,801981,2906415,444121,34694217,3350536,0,4909049053,554484409,19461,[LV21]Lords of Valinor
188544046,G4mine,32065090,26479448,851895,262602,631545,296942,2060539,168534,3420162,2229073,0,4297447623,247760315,20119,[LV21]Lords of Valinor
185724517,Feldgraŭ,31963117,143895654,1749110,439323,3849630,1436815,10846195,1094966,17666929,11941161,0,4247055686,178066760,33143,[LV21]Lords of Valinor
188736727,Alex9003,31961158,32473390,1660154,2964172,704741,765686,2254625,243104,6932328,2497729,0,4101085898,38138060,14056,[LV21]Lords of Valinor
188362493,亗MrDuck ツ,31952846,47364984,1161416,1502313,2043320,1145043,3652427,93672,8436775,3746099,0,2755945051,869611190,16062,[LV21]Lords of Valinor
188368264,funne,31937885,27615211,1265037,834275,642636,595616,2083334,147364,4303225,2230698,0,3729054462,61698120,16403,[LV21]Lords of Valinor
188352541,ᴾᴿ Mèoッ,31925567,115726127,1163354,7159677,1696839,1293856,9684405,444052,20278829,10128457,0,6032312148,0,14197,[LV21]Lords of Valinor
187559873,ｱ尺ﾉ丂ᄃﾉﾚﾚﾑ,31920548,62577567,524842,786256,540194,444292,5234590,360843,7366175,5595433,0,2597198387,616443180,15335,[LV21]Lords of Valinor
182713036,쵸ﾒMØTÃSÊMツ쵸,31711150,18088832,613608,107410,237719,446943,1541354,19530,2352956,1560884,0,4909513754,123301386,19732,[LV21]Lords of Valinor
188242643,hoahaizz,31500233,90995602,824203,3460243,968129,560439,7515858,548348,13053017,8064206,0,3612015692,567041937,28670,[LV21]Lords of Valinor
188451175,ᵸᵒTerra,31415816,52190528,870910,3422823,860871,534113,4469807,147485,9435099,4617292,0,3990188332,92432122,22091,[LV21]Lords of Valinor
188833519,JulieLaTueuse쵸,31225904,23030526,592288,127764,346846,94148,2000359,96555,2665672,2096914,0,3464935141,37720000,19242,[LV21]Lords of Valinor
188335709,Rebel Rogue,31008922,72509497,813602,1040029,700124,771386,6222402,279584,9013525,6501986,0,3395710921,34205137,33625,[LR21]Lords of Rohan
185612447,Chaudary Zain,30925131,117542787,1396547,4931709,1590757,914083,10078504,446678,17961731,10525182,0,4298267961,1203892732,24436,[LV21]Lords of Valinor
188797972,21LuviVilu21,30864502,15178974,1118455,579951,518648,328487,1180620,45277,2652983,1225897,0,4191431795,30539709,15479,[LV21]Lords of Valinor
188225231,ᴾᴿSko0p,30835236,31045734,348694,168570,89071,72567,2919115,67623,3316946,2986738,0,4429450096,0,26792,[LV21]Lords of Valinor
189045190,Azura21,30582011,28813819,1079446,528436,682624,3020226,1479906,23146,5734338,1503052,0,2748218427,423984134,8010,[LV21]Lords of Valinor
188847278,ᴸᵛQuang,30414367,109296396,1080822,981674,1431516,1266405,9580641,268250,13528486,9848891,0,3914882486,1450824614,32136,[LV21]Lords of Valinor
190407807,동탄불주먹,30330379,19935130,1056289,489264,330666,695184,1517559,60981,3093654,1578540,0,5210803989,433522789,14743,[LV21]Lords of Valinor
188836483,YenifferDeRivia,29831755,38806179,1193983,1781128,2318341,1691838,2651180,26706,8469193,2677886,0,3395185064,140738085,4867,[LG21]Lords of Gondor
177013392,ᴸᵛ UCC15,29783051,35015116,2594771,1191251,936367,880578,2626512,155835,5790543,2782347,0,5238657355,192271545,15876,[LV21]Lords of Valinor
188598120,ᶻSharineko〤,29669483,44961689,715969,737358,1456432,799706,3520289,174982,6688767,3695271,0,2311884852,51185747,14886,[LV21]Lords of Valinor
188316323,ᴸᵛ SAKURA,29378012,94015517,1265838,2331148,1067900,1852937,8081600,159287,13492872,8240887,0,4023367602,529454569,25734,[LV21]Lords of Valinor
188262339,Kitty27,29376408,3525315,58669,36465,178359,33306,226824,37992,512946,264816,0,3645561321,23588840,10268,[LG21]Lords of Gondor
184882401,Ферма а,29319561,87611045,1681086,22831138,3000621,3316704,5998588,189544,35336595,6188132,0,2616115528,3538154179,17108,[LV21]Lords of Valinor
185651937,ᴳᵃʸGrizzy,29311082,387070968,1523784,11881112,5832998,11662675,31779649,429078,61585512,32208727,0,3744084354,952357579,20260,-
181581608,Fledermauz DB,29199105,32237433,694585,248895,300074,511759,2915789,19129,3995646,2934918,0,3540451016,377676127,7616,[LV21]Lords of Valinor
188961098,Chocolalat,29129440,2573107,220977,51569,65233,15462,226396,5326,363986,231722,0,4043342682,21199999,3535,[LG21]Lords of Gondor
182338045,亗ƧHiꟻT亗,29095382,112519219,1002395,2592738,1006234,1309156,7019886,1727636,13655650,8747522,0,5393235868,2515586970,31580,[LV21]Lords of Valinor
185923730,JFDLCA,28896536,263507772,416817,5131053,3803977,6044217,22461394,304140,37744781,22765534,0,4663388025,386336005,36237,[LV21]Lords of Valinor
188876886,ᴸᵛTheanh,28801204,101629132,1174523,404443,283572,561635,9495490,188983,10934123,9684473,0,5458039409,107966937,31965,[LV21]Lords of Valinor
186295211,ᶠˡVENDETTA,28756237,95615765,2585264,4040849,1080655,510744,7464839,797746,13894833,8262585,0,3882326796,1038356942,19561,[LV21]Lords of Valinor
188543996,ᴸᴳﾒNØHOPEツ,28629471,17344954,647308,307714,74582,171382,1562494,41189,2157361,1603683,0,3309312411,21608954,11046,[LG21]Lords of Gondor
188789684,ᴿᵃtMadson,28587527,14350177,457839,77019,121638,152532,1255599,46269,1653057,1301868,0,3798218820,72421016,38768,[LV21]Lords of Valinor
185538462,UMAYKIZ,28538159,68592876,1079556,2427561,751580,861151,6059020,128470,10227782,6187490,0,4029827120,8566632,6319,[LV21]Lords of Valinor
188819438,ᴸᴳLuca,28368513,45981924,573803,296542,432636,250296,4081836,161890,5223200,4243726,0,4200108691,286280200,24184,[LG21]Lords of Gondor
188293704,ᴸᵛDrMusaab,28356571,35209170,1499523,186182,427716,173058,3126849,117789,4031594,3244638,0,3601336258,84578452,14042,[LV21]Lords of Valinor
188364390,ᴸᵛLeonPoi,28355341,124135432,1129448,429143,394534,630054,10890124,591954,12935809,11482078,0,3641397177,108004980,35363,[LV21]Lords of Valinor
186709522,ᴸᵛ SHERY,28338762,61557158,1562880,609853,401512,544566,5186216,329587,7071734,5515803,0,3366363094,99489407,9495,[LV21]Lords of Valinor
185282573,ᴸᵛ3621 BANK,28319309,62632106,771884,668111,1267167,649115,4855577,440596,7880566,5296173,0,1355169005,823285969,8650,[LV21]Lords of Valinor
188830020,ᴸᴳVersized,28169915,41594701,629241,595876,937153,410015,3477134,159491,5579669,3636625,0,3522875933,36055668,9893,[LV21]Lords of Valinor
188852900,Scorpionking乂,28155803,73472261,1825968,692459,535193,1654576,6380214,92147,9354589,6472361,0,2157648606,58256706,30505,[LV21]Lords of Valinor
189001955,ᴸᵛTruNguyen,28099727,12238014,707395,361084,139142,226871,1050125,23939,1801161,1074064,0,4266403939,67678867,15691,[LV21]Lords of Valinor
182720562,ᶜᴹᵈSkyy,28092367,19752884,2388318,291902,77615,310791,1289299,270156,2239763,1559455,0,3999667646,685652689,12498,-
188853241,Алёнаа,28063461,22417759,741245,236275,344883,856812,1503077,161136,3102183,1664213,0,4339816895,45525540,12579,[LV21]Lords of Valinor
186043643,卂几Ҝ卂,27938144,48824909,1027897,877386,299895,373253,4363243,146210,6059987,4509453,0,3252088744,501165307,28572,[LV21]Lords of Valinor
188944242,Đạt Feet,27909127,19184268,699227,769072,733958,1500022,1041053,57596,4101701,1098649,0,4424666792,16457231,8843,[LV21]Lords of Valinor
188788713,Sam smith,27828153,27402922,732711,582024,331614,177955,2445373,72887,3609853,2518260,0,3827182520,33958258,12405,[LV21]Lords of Valinor
188785575,ᴵᶜ Cairo xx,27765720,22263445,718609,343839,319881,399109,1877180,59334,2999343,1936514,0,3313749039,8507066,17115,[LG21]Lords of Gondor
188453555,Puyols,27212544,41087669,884766,405117,350807,191573,3636492,158691,4742680,3795183,0,6447043096,127173124,22901,[LV21]Lords of Valinor
188806334,Emrah 51,26971037,3751158,1312229,1012,10602,4008,371372,0,386994,371372,0,4126810750,0,4417,[LR21]Lords of Rohan
188294260,CЦEПИOH,26708863,10421111,1855157,581297,556310,288078,772954,15519,2214158,788473,0,2703473745,173206292,7504,[LG21]Lords of Gondor
188547640,Kitty8152,26689507,1630693,12032,78078,153637,150776,70470,0,452961,70470,0,6018944904,2547000,7438,[LG21]Lords of Gondor
185905587,Ze Boshman,26638325,3821207,404399,309125,97861,13805,316140,17352,754283,333492,0,2770839083,41584565,2619,[LV21]Lords of Valinor
188575943,BATUMSKİ08,26604807,119766533,2518476,8713459,9991171,6956425,6868944,76318,32606317,6945262,0,2740734043,529137921,20449,[LG21]Lords of Gondor
188285810,ᴵᴰJupanu,26596866,42600584,949826,859503,1573717,504705,3360771,182736,6481432,3543507,0,4533559380,40968174,19651,[LV21]Lords of Valinor
188364525,ᴵᴾEmrys II,26412458,3119874,218964,53070,30135,8285,294045,3770,389305,297815,0,2091717356,0,2715,-
189040679,ㄴHORIZONㄱ,26394939,74776471,764075,947828,1035889,885967,6855262,20932,9745878,6876194,0,4541244792,188105599,14254,[LG21]Lords of Gondor
188880546,Graf000007,26362438,3908846,1602923,195112,206722,115320,259030,20240,796424,279270,0,3363810450,0,3885,[LG21]Lords of Gondor
188319889,亗ChancellorT,26292095,19038322,395290,392020,290920,381817,1561679,61701,2688137,1623380,0,2876805661,1085215,13309,[LG21]Lords of Gondor
188192835,SвулканS,26233847,19628934,388225,2031363,306088,979874,1414359,27370,4759054,1441729,0,3325538855,52162299,8799,[LV21]Lords of Valinor
188877484,ᴵᵀBLOOM,26188016,73412319,1615750,429658,286070,678042,6496736,253736,8144242,6750472,0,1847010287,111895750,28919,[LV21]Lords of Valinor
189141193,ᴸᵛJankels,26075650,46947588,771106,2358084,1924323,2323779,3141045,96088,9843319,3237133,0,3204416648,28726902,15667,[LV21]Lords of Valinor
188836051,Cheops Pyramide,25898769,54742583,794851,616096,260480,456136,5005220,111083,6449015,5116303,0,4261838998,627419892,33355,[LV21]Lords of Valinor
188793086,GANDAlF EL GRIS,25816572,6393451,180602,29227,83125,35629,549478,29203,726662,578681,0,2742675239,132716687,7283,[LG21]Lords of Gondor
188806124,ᴵᴾAltar,25682493,111614407,1481141,3177848,4192360,2583327,8685363,270359,18909257,8955722,0,2531022967,7742830,26734,[LG21]Lords of Gondor
189939798,ʰᵒDestructor,25560626,18469100,52616,21684,68111,82633,1799801,0,1972229,1799801,0,2750489405,11281500,839,[LG21]Lords of Gondor
188872694,DELİ ÜSTAD,25554012,5962066,716649,208561,290491,524323,257508,33350,1314233,290858,0,4071601769,39905983,2064,[LG21]Lords of Gondor
188835262,vinzsou,25330151,12637205,214092,27067,92071,38810,1153127,38057,1349132,1191184,0,2244324064,0,12424,[LV21]Lords of Valinor
188891048,7BeLa,25321382,57642914,872000,370252,777201,2820258,4394591,39376,8401678,4433967,0,3249200119,137794496,5865,[LG21]Lords of Gondor
188818127,ᴿᶝ风华,25291152,2158531,1064759,62955,74067,33164,157987,14264,342437,172251,0,4061953808,64472747,3749,[LG21]Lords of Gondor
188365363,diegokristy,25144293,38015759,464864,421018,640200,714224,3058786,160320,4994548,3219106,0,3690300665,246281206,14969,[LV21]Lords of Valinor
186010544,Mehmet027,24815594,54179766,1527522,1745924,1605736,1984975,4248639,9641,9594915,4258280,0,2885933765,173638054,8169,[LV21]Lords of Valinor
188347402,ᴵᶜrusseoner,24695234,28077150,111158,525404,1170573,763521,2072714,92485,4624697,2165199,0,2589655945,66386508,27081,-
188939030,TBILISI,24617861,7839528,1253222,516102,1297487,330601,372081,4906,2521177,376987,0,2975394492,460258,11529,[LG21]Lords of Gondor
184845080,ᴸᵛSCAR德,24510757,40173347,456710,183367,313471,199948,3600586,135204,4432576,3735790,0,3632482079,46674299,27141,[LV21]Lords of Valinor
188324838,ХОНДА,24327153,7990779,1618420,319927,430706,215833,601619,9293,1577378,610912,0,2508269997,122738819,6012,[LR21]Lords of Rohan
188319008,ᴸᵛКэп21,24305349,10075514,29597,216150,128394,92909,914970,12708,1365131,927678,0,2230342969,0,10984,[LG21]Lords of Gondor
185602720,ˢᵉAbdallah,24079789,33556851,148870,749527,727093,952970,2625068,94510,5149168,2719578,0,1661816478,13071304,8919,[LV21]Lords of Valinor
188790084,ᴵᴾZY0N,24074053,33833530,928866,533191,478653,1655764,2386717,113968,5168293,2500685,0,1990099405,11685709,7647,-
188855274,GOLTEB,23987656,122887763,1320797,1201875,175391,426239,11397813,330676,13531994,11728489,0,3334192209,35237187,41162,[LV21]Lords of Valinor
188880486,Kỳ tiktok,23962785,5032186,619653,67544,30446,79744,414153,24864,616751,439017,0,3663727659,0,2982,[LV21]Lords of Valinor
146179581,lupepvp,23945608,7731100,586781,152821,114638,34970,645244,43947,991620,689191,0,5077785510,108915418,13895,[LV21]Lords of Valinor
184872506,ᴾᴿF A J A R,23766513,81330450,1396757,2282220,2097345,3030279,6197714,129053,13736611,6326767,0,3250277163,28252952,13422,[LG21]Lords of Gondor
188840841,ᴸᵛNotZach,23729088,20662260,350982,581170,825920,442354,1607021,52728,3509193,1659749,0,1513007588,107725390,4219,[LV21]Lords of Valinor
188870613,xXVincinetteXx,23703461,8098429,1287558,867867,503902,29008,646440,16831,2064048,663271,0,4699104174,5876311,23600,-
188320476,ᴿᵃЛиса,23625028,30379553,1072781,367405,506339,542846,2534807,88697,4040094,2623504,0,4660655434,362428945,38435,[LV21]Lords of Valinor
188912287,ᴸʳgCoelho,23633011,24920982,790395,471781,802707,1014738,1810622,52802,4152650,1863424,0,2333965114,113818904,6506,[LV21]Lords of Valinor
181974650,IDEM City,23519142,2030305,1163258,142285,141908,58538,141798,3295,487824,145093,0,3772798768,86095121,2069,[LG21]Lords of Gondor
189236516,ᴿᶝ年华,23496456,2290337,936926,56107,169818,48265,162204,6219,442613,168423,0,3618217043,48671853,2839,[LG21]Lords of Gondor
188937309,Velikiy Govard,23459941,4831224,638326,125640,141509,280242,340211,0,887602,340211,0,2497279816,85678023,5121,[LG21]Lords of Gondor
188793523,FerAmaya,23275944,5937051,404492,129947,223590,105868,504041,0,963446,504041,0,3521639460,43532335,4976,[LG21]Lords of Gondor
84905552,Schwazzier,23239639,5729774,494014,146203,86882,62010,509933,8970,813998,518903,0,3123526912,60672597,7337,[LV21]Lords of Valinor
189057248,Cekko23,23077655,19924714,595985,139302,267141,394238,1671444,53559,2525684,1725003,0,3425864047,76002446,10982,[LV21]Lords of Valinor
188390528,ᶦᶠAkrosh,23023859,14179254,358164,80861,884019,546131,1021052,0,2532063,1021052,0,1404024361,139317710,2243,[21If]Immortal Falcons
188842111,ᴵᶜAntoJJ00,22959060,10112937,281104,13757,120082,40863,890439,40109,1105250,930548,0,2516095331,3999999,3526,[LV21]Lords of Valinor
185094982,Phi Dương F2P,22847396,37183572,1932282,2842133,5213473,4076945,865436,61303,13059290,926739,0,2087590950,117926355,4846,[LV21]Lords of Valinor
188937116,ᴵᶜTom,22833952,4798418,78668,26543,281358,25756,401873,5432,740962,407305,0,2254933220,6485919,12148,-
188994494,Snowplow,22816687,1094552,236306,8504,103749,19351,80795,0,212399,80795,0,2801191412,0,3421,[LR21]Lords of Rohan
191454845,ᴸᵛTueAnh,22791922,15880031,609408,33336,102636,279568,1382732,36125,1834397,1418857,0,5355162189,997408023,10867,[LV21]Lords of Valinor
189324168,인절미,22772318,11044249,1368116,65146,304808,90751,963836,21012,1445553,984848,0,3411419703,7500000,15231,-
188376202,ᴵᴾ云霄,22746054,5016232,1187495,141572,159153,80118,421990,6462,809295,428452,0,2512162200,17020000,4167,[LV21]Lords of Valinor
188661481,Kängurufarm,22568617,2847269,781585,208965,117034,10247,253042,0,589288,253042,0,2393850706,1128542199,4137,[LG21]Lords of Gondor
144563085,ᴵᶜPARANOIA,22522687,4730553,1770534,15817,22531,23272,408292,25316,495228,433608,0,2760334979,1021382,4794,[LG21]Lords of Gondor
185134660,PetitDr,22413048,3101404,85261,63894,67172,12418,288305,1078,432867,289383,0,1499181335,17979430,10865,[21if]farm 21If
188234979,iGRECfarm,22067213,15844038,286311,273003,46153,43158,1490992,30729,1884035,1521721,0,2703807026,315563112,10612,-
184817793,meto 313,21806701,2138351,1572170,176676,118771,63196,34729,63270,456642,97999,0,2900910461,1827622,1783,[OP1]OP CLAN
188846843,BoboFranek,21704370,1436892,86860,96434,230127,133623,42286,0,502470,42286,0,1842439115,45731253,5585,[LG21]Lords of Gondor
188255601,Ant Man21,21587050,21740037,261646,303216,192688,238972,1939567,47123,2721566,1986690,0,3143089623,0,3958,[LG21]Lords of Gondor
188639928,The亗SCARFACE,21364160,2476955,64606,145589,285116,162864,116131,3242,712942,119373,0,3184727572,44040000,4238,[LG21]Lords of Gondor
188830522,ᴸʳTylnmrl,21350188,1670861,37663,32839,20609,4164,155652,2495,215759,158147,0,2200732832,16585000,4596,[LG21]Lords of Gondor
184859052,ᴸᵛamadxd1,21343025,6824130,685037,150092,454668,303159,423224,21995,1353138,445219,0,2098805157,175992716,6514,[LV21]Lords of Valinor
186016235,卂丂卂千,21284693,4359462,159223,142922,151729,14030,367686,14722,691089,382408,0,1803091548,12932669,3685,[LV21]Lords of Valinor
188878743,Jetare,21157894,13297600,982070,914090,1759002,1062897,503537,15491,4255017,519028,0,3082062982,91210728,2798,[LV21]Lords of Valinor
188818238,PoTaPyh,21157536,17664038,830439,488230,854873,981299,1145843,23651,3493896,1169494,0,3095818179,301072527,13038,-
188851823,ᴸʳMent001,21298706,424254,32231,166894,116295,10489,11633,0,305311,11633,0,1819003774,0,2653,[LR21]Lords of Rohan
188337674,ᴵᴸAxan,21060934,13852737,908861,382486,81728,81286,1314956,6904,1867360,1321860,0,2589438146,376836150,9596,[OP1]OP CLAN
188899189,QuantSist,21031063,1720056,385409,11624,68715,76283,127517,0,284139,127517,0,1901957873,296458,5405,[LG21]Lords of Gondor
188889549,СЦEПИОН,20926077,2997871,1241527,21675,25683,72660,248333,8410,376761,256743,0,1923428853,102567597,3692,[LR21]Lords of Rohan
188443825,йкйцк,20721165,48743894,1313992,1943111,2457331,1223280,2839555,507597,8970874,3347152,0,2532968576,1971457076,21172,-
186018265,yıldırımsefa,20531142,12642300,258459,159713,850626,471324,812371,45005,2339039,857376,0,3069584421,50620184,8823,[LV21]Lords of Valinor
188856715,ᴸᴳJackie,20438835,13313470,284873,80252,30041,24787,1215687,49066,1399833,1264753,0,1207973545,20000000,3913,[LV21]Lords of Valinor
183360513,ᵀᴸмønoメ,20415868,26110591,478300,186118,247673,221163,2277659,95839,3028452,2373498,0,2125813241,85509847,6981,[LG21]Lords of Gondor
187503097,Romulus1991,20357647,22857748,179434,141002,70341,268434,1990479,85517,2555773,2075996,0,3561745728,82802390,16100,[LV21]Lords of Valinor
188884272,ZHIANZD,20330975,1216090,246973,127800,150740,29760,77001,0,385301,77001,0,2475969195,0,2032,[LR21]Lords of Rohan
188325495,쵸 See La Meet 쵸,20218723,26136473,714725,1038428,1614240,1553702,1521512,63519,5791401,1585031,0,3512199870,0,7931,-
189036655,Vitia back 1990,20250501,9551108,2056000,172660,105414,21917,821704,50052,1171747,871756,0,2515553273,9800000,8511,-
189276543,Subways,20198707,11666383,1464553,107519,177221,229422,998121,19577,1531860,1017698,0,2171195417,0,9260,-
188838640,Presidente CIAO,20158558,3248958,61803,13150,115426,83389,268192,0,480157,268192,0,1576264793,23800000,4408,[LG21]Lords of Gondor
188819819,fox77778,20156919,3782562,738594,75581,204618,428450,164441,0,873090,164441,0,3232349282,1037349,4623,[LG21]Lords of Gondor
188903920,JoshuaSeil,20125951,3944310,804072,57530,197583,34872,321289,9263,620537,330552,0,2856945550,301497,3802,[LV21]Lords of Valinor
188790227,СУЛИМАH,20105099,2937806,1265520,69552,52214,89972,230812,7573,450123,238385,0,1837825253,102878721,3409,[LR21]Lords of Rohan
188847403,Vali188847403,20046432,1805843,502942,88125,113717,240436,59904,0,502182,59904,0,1168930979,0,641,[_NDM]New Jersey Nol
188876948,Ruberoid,19923471,1308095,30041,24678,63862,55794,95226,0,239560,95226,0,1431655124,3846529,4584,[21If]Immortal Falcons
184819319,joe200,19909631,2022401,1197317,130789,249677,21520,45323,47879,495188,93202,0,1604088815,91263980,5832,[LG21]Lords of Gondor
189075824,NooByZ,19621709,8523920,1530004,77034,121760,128921,748617,13157,1089489,761774,0,3365718003,99259891,19016,-
188836639,Ndiaye,19625394,5853377,660696,352077,491543,747064,181162,0,1771846,181162,0,2883484623,383503,1593,[LLA]Lost legion academia
188232993,AKON311,19539969,17474104,658995,571073,531874,842388,1182997,54831,3183163,1237828,0,1766071867,850687088,12259,[LG21]Lords of Gondor
188898779,kral jon snow,19534038,113087,6227,15339,20427,859,6573,0,43198,6573,0,2699112141,8327554,2892,[21If]Immortal Falcons
188806434,ᴸᴳ Bimz,19440908,4037011,658635,38885,29786,6973,351993,21092,448729,373085,0,2830100132,29458520,9207,[LV21]Lords of Valinor
145631489,BABA SON,19441275,3735351,255023,136076,494296,267396,162298,1349,1061415,163647,0,2029856500,4400000,4330,[LV21]Lords of Valinor
188910784,Ictus scorpioni,19205775,17071411,585189,169726,500677,555988,1319890,30663,2576944,1350553,0,1864333741,51888975,15274,[LG21]Lords of Gondor
188261313,freezebee 21,19137457,2027071,234347,244875,375237,108803,79241,0,808156,79241,0,1742483591,5187959,14508,[LG21]Lords of Gondor
188857113,GritNGravy,19129563,1953070,46395,39362,14347,20181,183578,0,257468,183578,0,2857637102,3200971,3674,[LG21]Lords of Gondor
188282297,MinasTirith秋,19050064,67391767,1935936,4739757,348069,495597,5982319,197105,11762847,6179424,0,2949663138,2562027272,30485,-
188430882,JapayuKingBILAT,18981533,13159982,558247,244614,718820,347450,977902,25230,2314016,1003132,0,2712807145,142262581,15008,[LV21]Lords of Valinor
188853064,TerrorBlade98,18920426,4698786,941546,120572,115534,39441,414286,7149,696982,421435,0,3229243955,0,1308,[LG21]Lords of Gondor
188845810,BARBALIAS,18899874,5080729,1177937,167048,291925,201260,352189,6827,1019249,359016,0,1731230822,0,5851,-
188838663,ERON,18840904,7419903,732610,190505,250716,72425,647213,5927,1166786,653140,0,1966161172,20081022,12042,[LG21]Lords of Gondor
186613612,Inigo Montoya1,18798669,4560304,1455414,349831,116242,28761,384715,14783,894332,399498,0,2504915580,103076547,8211,[LV21]Lords of Valinor
188869412,dân chơi đá,18770134,8228309,246570,288205,739830,1185717,194814,0,2408566,194814,0,2106256471,1154652,1641,-
191530671,ᶦᶠtMadsonn,18764700,1846035,34099,69047,86817,200703,85578,0,442145,85578,0,2511603663,910375198,4515,[LR21]Lords of Rohan
188884453,dm152,18666771,261473,0,20838,55033,4660,12860,0,93391,12860,0,2577197413,0,4255,[LG21]Lords of Gondor
188814205,SUBUTAİ 38,18665061,1466044,274608,292102,181430,22696,95398,0,591626,95398,0,1815253960,3080000,2269,[LG21]Lords of Gondor
188776545,ᴳᵒᵈ Ingle,18563332,1048600,93501,85140,135892,24107,66336,0,311475,66336,0,1649940010,3404666,5090,[LG21]Lords of Gondor
188539042,Chieu F2p,18464467,17086830,439205,844273,1727037,651403,906943,89443,4219099,996386,0,1982844652,35342934,10396,[LV21]Lords of Valinor
188806199,Op khan,18431585,4301539,616590,240925,827408,507637,54829,985,1631784,55814,0,2754270404,4253716,3107,[OP1]OP CLAN
190329472,F1Quang,18333526,12303871,725173,76015,288128,303523,1034038,7897,1709601,1041935,0,3721879359,2554670796,8392,[LV21]Lords of Valinor
188836606,Black AngEL,18316975,8655975,1937740,908418,995278,553139,422312,2403,2881550,424715,0,2137121812,18536152,1820,[LG21]Lords of Gondor
188336750,SKY EAGLE,18136313,7121747,985124,330019,49903,45477,677403,0,1102802,677403,0,1931799839,213802552,9588,-
188827507,Dug1man,18023718,106428,5346,18103,18794,0,6522,0,43419,6522,0,2434612467,0,2465,[LG21]Lords of Gondor
189014302,magister,17897194,11593788,947900,205152,1188782,528161,695989,5133,2623217,701122,0,1327725746,15363819,7382,[LG21]Lords of Gondor
188360951,SATORUGOJO1,17877623,8461625,472927,508838,996498,575503,386159,10163,2477161,396322,0,1590917998,317828071,6100,[LV21]Lords of Valinor
188865329,Việt hoang 07,17811984,607097,64769,419495,234049,900,5150,0,659594,5150,0,2208837302,1833721,887,[21M]Immortal Myrmidons
189231766,darkkiller666,17669854,3746982,286312,236683,195194,50737,294065,8283,784962,302348,0,2533244060,20289481,14046,[LG21]Lords of Gondor
188490339,Eudaimonia,17637210,3305051,193739,41805,36785,12770,295668,10768,397796,306436,0,2972378860,30962500,5237,[LG21]Lords of Gondor
150165925,ᴸᴳken arok,17614874,5302053,585518,105507,278014,108601,417888,5582,915592,423470,0,2346383031,26909895,9630,[LV21]Lords of Valinor
187197359,Demir Bilek,17512291,9273471,779097,120768,235808,174193,781889,13102,1325760,794991,0,2053567346,30192868,10977,[LG21]Lords of Gondor
188844580,RedHoodJT,17503408,3724748,210774,117223,615129,546669,28437,0,1307458,28437,0,1599127373,0,1423,[LR21]Lords of Rohan
184950431,DziochuPL,17452768,6006547,807180,345805,687873,679830,184232,0,1897740,184232,0,1402539349,8765862,2940,-
188787622,MalandrageX,17369267,20690,0,2434,1687,245,1585,0,5951,1585,0,2473078655,0,3256,[LG21]Lords of Gondor
188368666,Derik 災,17193465,17311218,78795,189202,156137,96806,1633226,12081,2087452,1645307,0,1504456225,57910439,4670,-
188904786,Shadow vahalla,16996643,920241,236630,6845,11062,4462,87890,0,110259,87890,0,2726033666,0,2975,[LG21]Lords of Gondor
190852683,BossAlien FARM,16976396,6771910,168409,19244,81805,135783,606132,0,842964,606132,0,4057018168,1459623182,2545,[LR21]Lords of Rohan
188879533,Qertt7,16868464,188791,322,8039,23990,816,10230,1682,44757,11912,0,3979964516,38000000,2090,[LG21]Lords of Gondor
188884243,HiagoLira,16860694,1285899,1,5567,1871,82946,94926,0,185310,94926,0,1580412803,0,2347,[21If]Immortal Falcons
188824641,Sabesaur312,16783039,178017,72,61605,21023,10955,7983,0,101566,7983,0,713711239,0,1962,[LR21]Lords of Rohan
187016834,ƐƘÁ,16622526,5969476,107689,89142,174787,122716,511121,0,897766,511121,0,2647896021,1489060086,4748,[LG21]Lords of Gondor
188823442,VIP shooter,16593665,3305125,846887,132688,41914,75500,277768,5754,533624,283522,0,1583028776,41800001,5136,[LG21]Lords of Gondor
196566747,Codrin4Valhalla,16539903,4548981,171119,259177,157063,124705,346050,11185,898180,357235,0,653908880,89594454,5839,[LV21]Lords of Valinor
188367613,ᶦᶠKinkyTail,16532569,22935600,545758,410743,750063,717499,1711885,68224,3658414,1780109,0,868291363,42186939,10290,[LV21]Lords of Valinor
189068044,Hsotits7,16390374,12200310,995230,966771,1440390,1040579,491964,2211,3941915,494175,0,1965513576,16241240,3350,[LG21]Lords of Gondor
188833114,Quent2,16333727,19383932,329806,270123,76329,367435,1641535,64608,2420030,1706143,0,1357541509,14298007,9727,[LV21]Lords of Valinor
189579148,стратег,16239539,2439007,1269763,90576,272116,146355,125592,1766,636405,127358,0,2309890690,1378833,2187,-
188585266,メDragønメ,16173256,6200803,260935,13008,75292,24207,548489,23295,684291,571784,0,1565973095,73489482,19339,-
188823187,AZERBAIJAN90,16127248,891992,1273713,78632,32607,42323,49764,7206,210532,56970,0,2188918647,3040,1275,[~AKT]BR AKATSUKI
188852196,DarkExecutioner,16073753,1452447,100617,60616,84044,164244,61526,0,370430,61526,0,1216662089,28060602,1834,[TFS:]The Forsaken Souls
187880560,wcwc,16017764,230115722,1527635,19485000,18674475,23053443,9591814,36893,70841625,9628707,0,3214040764,596448438,13547,[21if]farm 21If
188487100,Kir8,16001440,744292,46498,47082,45400,57564,41382,0,191428,41382,0,604975853,0,4395,[LG21]Lords of Gondor
164927516,iven0007,15897586,10077159,800589,584997,950594,899393,404788,20676,2860448,425464,0,1004820448,29829009,5733,[LG21]Lords of Gondor
188513738,MooSáke,15887941,198927,96089,15385,14235,12870,11590,0,54080,11590,0,1760041292,0,1221,[RC21]ROYAL CROWN
189181702,222mb222,15852298,2096107,769471,199359,63662,40288,176776,0,480085,176776,0,2917061603,225401626,1700,[LR21]Lords of Rohan
188868206,Quocbao05032012,15844036,1765350,652703,140343,12908,5049,169127,0,327427,169127,0,1628527840,6000000,1968,[LR21]Lords of Rohan
188845980,Azadi,15793090,2414584,591878,280392,474111,105066,99002,0,958571,99002,0,1845284422,3366983,1068,[I-am]RoyalLoyalMembers
188432088,BandAid,15782926,6291099,303434,23738,88926,146960,503492,24287,787403,527779,0,2854064343,308659606,8245,[LG21]Lords of Gondor
188376429,ᴵᶜmySoul,15736105,447638,94861,165290,199177,4054,1,0,368522,1,0,1298786137,7488905,8460,[LR21]Lords of Rohan
188894198,Tomioka senpai,15656632,379272,52185,4153,47557,61967,3546,0,117223,3546,0,2489028697,0,1790,[21If]Immortal Falcons
188300175,ᴵᴾAzrael,15617293,5929943,1085370,1060718,918432,76859,357350,0,2413359,357350,0,1744256473,241776070,16840,-
188861925,blackbandito,15485492,3203886,432177,181283,407143,143151,121328,28373,881278,149701,0,1358170225,24105565,1923,[LG21]Lords of Gondor
187078010,Dr4gonsFarmerツ,15450978,22163921,1316246,641729,1799365,1256244,1338903,1142,5037383,1340045,0,2602487365,1725005764,7885,-
188825941,S0SKA,15447745,1189854,237525,181770,115056,123932,42766,0,463524,42766,0,1573181792,17191302,2471,[21M]Immortal Myrmidons
188436016,KiLLedYouhaha,15442111,4666342,180571,186673,224968,166558,341772,4756,924727,346528,0,2484573398,79055118,9433,[LV21]Lords of Valinor
188809474,Edgar15,15275743,46285,13168,43659,11087,2650,478,0,57874,478,0,2116886110,0,1245,[21M]Immortal Myrmidons
188928573,Thànhteo,15261172,1269484,231737,5214,47138,152454,56435,0,261241,56435,0,1495810392,0,3081,[21M]Immortal Myrmidons
188878343,Cheiron City,14983906,2006372,65708,76640,299335,127026,88427,0,591428,88427,0,1306242018,0,1638,[21if]farm 21If
188134384,ˢ carlossainz,14914871,6601011,1300774,21788,65922,52235,498539,63524,702008,562063,0,1190118090,25406959,3985,[LG21]Lords of Gondor
188781490,Fra1d,14897626,1187031,100258,39857,116341,94712,56753,0,307663,56753,0,1220961083,5509155,3141,[LG21]Lords of Gondor
187560016,Kyubi Farm1,14887617,43242083,1156562,1634869,1976614,1528733,3245429,19633,8405278,3265062,0,1343475818,409430369,6738,[LG21]Lords of Gondor
188365295,ᴿᵃTsumiki,14849316,2089406,0,8924,38778,19749,193107,0,260558,193107,0,1063300942,3762398,6032,-
188879219,Akglate,14816478,247677,40137,19567,121882,0,0,0,141449,0,0,2071709078,1758755,592,[LR21]Lords of Rohan
150775231,Lind21,14802402,7690885,484858,498285,954081,721214,266273,6774,2446627,273047,0,1823420717,3048989,2494,-
188963486,GÖZTEPELİ35,14745890,131575,0,26938,85,5222,10513,0,42758,10513,0,1956299993,230887100,3805,-
188857667,Apoathou,14702434,1322660,1124764,128214,19733,13903,120194,0,282044,120194,0,230139173,156690,1073,[LG21]Lords of Gondor
188858878,lisabella,14684483,237752,277117,67710,112105,0,0,0,179815,0,0,557469536,0,1588,[21M]Immortal Myrmidons
183848200,Ei Farm,14627016,38142723,1298931,2526718,1320489,1044558,2968593,56612,7916970,3025205,0,3098532140,519374881,13479,[LG21]Lords of Gondor
189036275,TheBlackDragon,14625049,163506,24134,22964,32186,14353,3713,0,73216,3713,0,1996364077,0,1756,[LG21]Lords of Gondor
188281290,1GuiltyCrown1,14584307,19247655,1007323,1096697,1425467,992963,1183957,18298,4717382,1202255,0,3269103050,1802857517,17015,[LG21]Lords of Gondor
188785649,priam,14577169,1018374,776393,44812,14478,5529,95834,0,160653,95834,0,1421187948,18007168,323,[tgqm1]amarl
186073361,卂尺丂Farm,14513826,3469427,345837,39537,204145,32135,292469,0,568286,292469,0,2279112112,489706596,1509,[LG21]Lords of Gondor
188877463,Se Tuath De,14478097,1904865,811661,93157,158781,182383,83914,0,518235,83914,0,2488768854,5600000,2390,[LG21]Lords of Gondor
186035363,Klgi20,14419801,1079100,1084576,54111,135908,7883,18115,29189,245206,47304,0,1756627171,1200000,3110,[21If]Immortal Falcons
188802524,Mickodem,14411928,193221,131028,1699,7453,9839,13862,0,32853,13862,0,1192915671,13257436,2956,[LG21]Lords of Gondor
188863496,dark8582,14385845,408222,113485,9062,63839,37988,12678,0,123567,12678,0,1834517225,0,699,[jk10]jk 3621
188825002,Namiq Cebrayilo,14368445,3934535,1259596,213707,290110,151386,270603,0,925806,270603,0,2026660936,0,721,[21MA]Myrmidons Academy
188885079,ᴵᶜnoobhuhu,14359074,4468313,44006,263679,640053,58918,289366,307,1252323,289673,0,1694858992,26599999,5002,-
188885945,whyreall,14191004,1427513,1410059,61686,45602,10688,128122,0,246098,128122,0,1497367838,862617,2035,-
188796842,Menda2137,14183968,321687,136804,21106,48638,8855,18477,0,97076,18477,0,1116877840,0,1463,[LR21]Lords of Rohan
188986083,KyoHN,14136800,58505,16806,10125,15173,711,2329,0,28338,2329,0,2277401510,69,2847,[LG21]Lords of Gondor
12113325,Elena23EV,14058042,1297746,131418,8451,10921,55191,102057,1644,178264,103701,0,1049636205,24431024,5615,[LG21]Lords of Gondor
188287771,ᅟᅠᅠᅠᅠᅟᅠᅠᅠᅠ ᅟᅠᅠ,13961016,53426124,428726,330732,673936,319444,5073433,0,6397545,5073433,0,4896713657,2064968833,28764,[LG21]Lords of Gondor
188800436,LilPiglet,13922495,769658,220953,34240,152043,47076,27042,0,260401,27042,0,1356803706,0,1283,[LR21]Lords of Rohan
188838241,SKORPIONV,13908351,48412,7747,52753,18931,0,0,0,71684,0,0,1412606099,0,2368,[21MA]Myrmidons Academy
170835406,ᴵᶜ Has,13865034,1445859,679890,46009,32626,7559,101847,16135,204176,117982,0,687055286,298517,2938,[21If]Immortal Falcons
188873290,FarmЛиса,13862018,2607974,596991,64191,23711,6956,237079,7455,339392,244534,0,1381659605,122800001,4099,[LG21]Lords of Gondor
188858305,Palestine313,13858201,3028033,1334422,129577,527939,188640,119168,0,965324,119168,0,1352690663,0,4,[Alg]Palestine313
188896546,БорисBao,13857624,1182765,168254,14668,118405,170863,25957,0,329893,25957,0,1761224189,22966398,1423,[LR21]Lords of Rohan
188953179,SarahVinyard017,13756390,5795264,260817,103502,87804,304494,438098,0,933898,438098,0,1388844714,31860199,3832,[LG21]Lords of Gondor
188235523,Asinki,13723238,339363,48213,2387,25328,6875,26073,0,60663,26073,0,1692751389,0,2508,-
188806889,Gouverneur188806889,13651373,785370,316714,61610,182543,80923,8427,0,333503,8427,0,1079193412,0,1024,[21MS]Myrmidons Farm
188847086,Dimiboy,13551573,75311,0,179,37638,0,0,0,37817,0,0,1124339898,0,11,[Tick]Tick tack
44936497,젝스킹,15991483,6996924,923387,39204,54846,41378,523118,74135,732681,597253,0,2183506756,0,9052,-
188856535,HOIANA,13378317,1190153,693357,435295,160981,54643,43890,6183,700992,50073,0,1684160235,400000,1133,[21if]farm 21If
188931757,ᴸʳANTHRAX,13323120,659165,84307,164935,187652,32931,11915,0,397433,11915,0,1355221784,0,2094,-
191069538,Shinnygamyy,13259416,3037148,499817,235031,755080,228183,56725,0,1275019,56725,0,1083252012,5089962,691,-
187795145,SOTER,13182311,8447735,539910,529189,65018,309343,652149,22650,1578349,674799,0,1281513424,112215799,15181,[LG21]Lords of Gondor
188832666,ChifOJ,13161687,2361104,125471,94442,41533,55215,203829,0,395019,203829,0,2395719228,0,509,[21IR] Corral
188836866,zlucifer,13134321,2684582,271491,220751,328964,145856,139908,0,835479,139908,0,1701695970,0,1524,-
188981583,Calep2012,13028091,5854580,972385,252824,915423,175225,313923,6652,1664047,320575,0,1371560025,704256,4512,[K~R~]3621 Utility Box
193596249,Korkusuz 51,12958052,239160,358859,12402,0,0,23668,0,36070,23668,0,1401609699,60357336,943,[LR21]Lords of Rohan
188787790,You  andl,12949734,920284,416012,51124,134014,82128,31352,0,298618,31352,0,1263694209,4084888,1903,[LR21]Lords of Rohan
187257305,HolySpirits,12934800,4186335,271743,116035,83670,59317,375642,105,634769,375747,0,1152390563,477259605,5802,[21If]Immortal Falcons
191177358,RtthyrFarm,12856140,52258,8925,14892,0,0,4928,0,19820,4928,0,3305265308,1594265331,1089,[LG21]Lords of Gondor
188291209,ROCKS  D  XEBEC,12853105,3694092,969555,42334,42629,46712,328702,6325,466702,335027,0,1822462533,37349860,9225,[jk10]jk 3621
188292201,쵸Bear,12762411,3636617,863462,127956,652623,13205,183272,21012,998068,204284,0,1398516677,0,8400,-
188845348,ᴸʳLUNICTUS,12699948,104914,26926,6884,16888,8978,3385,0,36135,3385,0,1490382979,0,449,[LR21]Lords of Rohan
190539451,puyolF,12489801,972686,309560,2673,66571,105265,41795,0,216304,41795,0,4391355324,1818372170,1980,[LR21]Lords of Rohan
188887466,Jensamtresen,12482883,2851467,834974,287219,392239,254799,99035,0,1033292,99035,0,867939411,10799999,839,[I-am]RoyalLoyalMembers
188837379,안정아남자,12424932,885792,199719,262430,137821,8581,52334,0,461166,52334,0,1752007039,0,1056,[LG21]Lords of Gondor
189266244,ᴵᴾRágnär,12376390,2424921,681640,338989,350984,104124,70352,26757,891206,97109,0,245500638,11642489,7444,-
142371438,NokedliF11,12281491,3005981,754566,516818,830716,67154,61715,17771,1494174,79486,0,1490061671,2400001,10464,[21M]Immortal Myrmidons
178904209,MorFarm2,12182432,243458,0,0,0,3117,23099,0,26216,23099,0,1692919713,335244116,803,-
188829162,Mkジinsane,12107997,911799,856240,15867,56941,24326,65024,2360,164518,67384,0,1539799886,1400000,3485,-
188880051,qftydhunvfezbjj,12100235,18338939,1337013,1249255,1030656,1111224,1086802,35743,4513680,1122545,0,1422326310,88951930,7822,-
188217778,ᴵᴰKing Nemo,11974922,1852509,716667,684238,272077,322,117022,0,1073659,117022,0,1857331281,0,12936,-
188816893,WARRIOR FARM 10,11943006,242793,17769,22009,47558,10254,10226,0,90047,10226,0,1299298884,0,1889,[21If]Immortal Falcons
188900034,Rajpoots,11834215,854381,223016,55556,81433,13291,62724,0,213004,62724,0,1814832235,0,3091,[LG21]Lords of Gondor
188479340,ㅡᅟᅟF2P 8      ㅡ,11819139,9914733,173571,883535,766581,262971,715298,0,2628385,715298,0,2668924071,956471741,8836,[LG21]Lords of Gondor
188946350,BaabyyKiller,11764448,45777543,823248,1480408,3397133,2896319,2635750,37221,10446831,2672971,0,1760569996,20189360,9196,-
185259121,Lets go Os,11753714,913938,1168728,282,16846,7330,13445,35821,73724,49266,0,1369910793,4800000,1560,[LG21]Lords of Gondor
187384799,C H A D 3 3 3,11746674,5025006,638494,336794,550030,58137,356220,3142,1304323,359362,0,942780690,0,4530,[LG21]Lords of Gondor
188952266,ErDegui,11704483,7108681,230822,125436,58773,125367,620570,12944,943090,633514,0,1166685836,13045768,5395,-
188899884,hanaaaa230,11703193,3656113,993138,112016,538707,284659,141766,0,1077148,141766,0,1371645687,3785937,1089,[K~R~]3621 Utility Box
188838338,boble 79,11684252,306757,46338,1697,52760,41937,3315,0,99709,3315,0,1260323460,0,2116,[21MA]Myrmidons Academy
190430624,IMPERADOR FARM,11656076,449281,436505,3716,0,322,44725,0,48763,44725,0,4409148447,1810735206,1490,[LR21]Lords of Rohan
60584385,silverlion9,11596083,7926707,936250,516238,906635,1186930,126153,47,2736003,126200,0,1472425909,5041847,1012,-
188819203,Cominogr,11537627,347521,71452,268238,123679,11074,222,0,403213,222,0,1587382887,0,850,[ANTB]ANnti Banned Club
123456386,Igoryan,11548698,4148092,193112,1303020,222892,143876,286620,0,1956408,286620,0,1203697734,11392165,1238,[LG21]Lords of Gondor
188801943,Brunk100,11490847,938220,200395,171290,279130,31043,22153,0,503616,22153,0,1330342807,2513093,2827,[21If]Immortal Falcons
188887462,Dunks,11488670,1538565,760926,36818,198678,122594,64347,0,422437,64347,0,1107672787,0,1028,[LR21]Lords of Rohan
192581999,LilitЛиса,11475283,1758597,2586,4079,12074,27936,162189,0,206278,162189,0,1981526432,377325710,3517,[LG21]Lords of Gondor
188363322,쵸Belmont,11368191,726781,18931,225245,250029,43961,583,0,519818,583,0,1181365988,1410552,11058,-
185877603,ㄴ Aurelio ㄱ,11366004,3426162,734268,194294,519109,17374,220713,3623,955113,224336,0,891518433,1758080,3475,[LG21]Lords of Gondor
188307234,ᴵᵀJessyS2,11159564,3418968,138406,130180,168640,9783,301652,0,610255,301652,0,1509177777,180913621,6306,-
187155907,Yuzhi,11150731,5032590,1641848,115533,189407,294655,290433,27386,917414,317819,0,1975836420,257605,1987,[LR21]Lords of Rohan
174523518,ㅡᅟᅟF2P 5      ㅡ,11103154,3700033,325966,825415,1309771,123637,42086,0,2300909,42086,0,2189311495,808382628,2407,[LG21]Lords of Gondor
188892262,Udi lopez,11050124,286475,30519,120358,27289,7419,17815,0,172881,17815,0,254671755,3001045,1826,[21If]Immortal Falcons
188840892,AlbertO,11026319,415004,15277,47370,78237,8794,21388,0,155789,21388,0,1666596987,0,1894,[21If]Immortal Falcons
189443468,Hubey,10948714,2171604,462536,189562,257421,35910,147521,0,630414,147521,0,918945909,0,1967,-
188309795,ᴵᶜ TAZIEX,10844048,8618161,951227,435439,559362,399095,559725,10936,1964557,570661,0,1632163083,0,8839,-
188818543,GodAnubis,10827930,3265470,842158,347813,333503,280538,140675,0,1102529,140675,0,1176543956,473118,735,[21IR] Corral
188840453,La pampara,10710873,3201722,940369,135652,353642,305562,124506,0,919362,124506,0,1332312570,0,267,[21if]farm 21If
188320795,Fïshböy F1,10659686,863662,410313,146172,398,5918,78330,1333,232151,79663,0,1442622621,75426551,1068,[LR21]Lords of Rohan
188840730,FurkiTolki,10635808,1839593,1140153,3217,12856,72657,143339,4461,236530,147800,0,1617863724,3600000,1995,[21M]Immortal Myrmidons
188900167,Charles grand 3,10605549,4207791,779277,591939,722430,168606,197012,0,1679987,197012,0,1681371949,8400000,909,[Tick]Tick tack
188856725,Uranusuki,10598453,268914,32838,25630,66282,25841,2786,0,120539,2786,0,712600301,0,679,[LR21]Lords of Rohan
188818957,alonsoisma,10592919,2300239,762386,25316,47973,75270,189815,0,338374,189815,0,1421990445,4826393,1357,[LR21]Lords of Rohan
189182502,ᴵᶜVatson67F,10531328,137197,213594,1669,4693,617,12501,0,19480,12501,0,3311419462,1724148322,1573,[LR21]Lords of Rohan
188790900,Dom Daddy,10513049,3300666,900720,27914,83403,91562,276203,0,479082,276203,0,1706994281,0,1434,[OP1]OP CLAN
188839518,Zaragoza,10478516,1181120,88062,120100,376712,100919,0,0,597731,0,0,1348777259,0,1051,[LR21]Lords of Rohan
188847841,Lj1208,10424845,314850,314434,984,0,1961,30681,0,33626,30681,0,1154629928,0,898,[21If]Immortal Falcons
188817859,oktaev,10412858,401425,359467,33669,31021,2770,32157,0,99617,32157,0,1040534344,0,100,[DD21])Dragon of Death
117517315,ᴵᶜBOTAN,10360428,13712356,945529,506093,1444925,965222,611992,37024,3565256,649016,0,1235813199,498018246,20006,-
188522411,Ваn,10341550,1095208,3365,36724,120447,26500,74097,0,257768,74097,0,727419882,1,2218,[21If]Immortal Falcons
188858155,King of persia,10328404,150422,26908,20390,37924,5629,4798,0,68741,4798,0,1196380078,0,486,[21lic]kingdom of warriors
188295840,ッ Yakuza ッ 6,10205094,395204,0,3871,70818,40591,9043,0,124323,9043,0,992758872,82882904,4847,[21if]farm 21If
188889920,Carolk,10202416,642390,541227,49383,96269,35954,29616,0,211222,29616,0,1127614985,1349311,322,[fagr]alpha table
189442766,Gubernur189442766,10134468,77204,41779,1313,9937,12737,612,0,24599,612,0,2329112425,1656650136,687,[21IR] Corral
188906315,ᴵᶜИвaн,10115924,1248369,45240,148765,274837,58418,43527,0,525547,43527,0,943901017,16348226,12804,-
188840603,andyrendy,10073872,1722850,894100,10373,99042,247058,53446,0,409919,53446,0,1032365452,0,459,[Slon]Slonii
195403312,môngcổ,10051155,1446809,783623,85946,65345,87040,95077,0,333408,95077,0,1256472656,0,1035,-
189182788,Vatson67f3,10022298,260412,485136,2684,4031,13106,19939,0,39760,19939,0,3299872694,1133268751,1324,[LR21]Lords of Rohan
184327666,ツاحمدᴰᴮ,9929930,2081120,510564,680474,487997,101508,56300,0,1326279,56300,0,1358162478,72130,2109,[LG21]Lords of Gondor
188857096,Di 1,9886683,909985,10470,103819,160058,85834,22577,0,372288,22577,0,934774982,1843151,2952,-
188898591,Dthomas,9838220,468487,81006,125157,122286,22516,10882,0,280841,10882,0,434478065,0,1343,[LR21]Lords of Rohan
188471943,NoCoboY,9790738,413116,95171,64153,54918,15880,22693,0,157644,22693,0,1074224406,0,3617,[LG21]Lords of Gondor
188899095,Minuz,9777979,865347,326259,116228,134828,3364,55899,0,310319,55899,0,705511492,0,1672,[LR21]Lords of Rohan
186988267,Panda ᴸᴺ,9616784,2766515,1120377,7927,2980,11995,264463,3318,290683,267781,0,3082740466,512115698,1981,-
