ID,Name,Power,Killpoints,Deads,T1 Kills,T2 Kills,T3 Kills,T4 Kills,T5 Kills,Total Kills,T45 Kills,Ranged,Rss Gathered,Rss Assistance,Helps,Alliance
179940560,ᴸᵛ ink,102078041,723002415,4508077,2922079,868214,978068,43839930,13918500,62526791,57758430,0,6213291517,1873979817,82676,[LV21]Lords of Valinor
186145908,ʳᵉʸEscanor,86524742,1588980417,4090753,5354908,1048123,1962400,131436933,13179713,152982077,144616646,0,3566298391,4598233340,23055,[LV21]Lords of Valinor
188540500,TakeMe2Valhalla,80772749,1572756505,5687342,13899415,5759410,11135718,117540653,16925420,165260616,134466073,0,2834283852,7401247251,45111,[LV21]Lords of Valinor
180304933,LilLƴ,76837104,359869716,3777136,3297412,2787733,3277212,20619998,6716297,36698652,27336295,0,1196614476,5020554697,23088,[LV21]Lords of Valinor
188858506,Cúchulainn 쵸,75582389,309535436,2182394,936833,278755,625535,27072552,1778145,30691820,28850697,0,5166068612,562651627,38693,[LV21]Lords of Valinor
179655012,ᴸᵛDØØPER,72843251,647175833,2907301,2840728,974416,1267589,43163578,10397636,58643947,53561214,0,8559391353,1611282008,39458,[LV21]Lords of Valinor
178695066,SokoDrake,67984854,139603048,2945480,1296111,106206,148891,10389225,1732180,13672613,12121405,0,8139411643,115903540,17974,[LV21]Lords of Valinor
180560115,TripEhh,62935119,482993940,1504950,3191022,822023,695405,31083529,8354739,44146718,39438268,0,6769661675,1409777077,11364,[LV21]Lords of Valinor
180060983,ᴸᵛRumRamsey,62126341,466514537,2651593,115891095,5049133,1001138,35104996,3909177,160955539,39014173,0,6211401698,417518493,95903,[LV21]Lords of Valinor
184964288,ᴾᴿFïshböy,59984271,290666990,2495330,2114031,4660047,3960145,22170897,2168727,35073847,24339624,0,3555811173,632742525,39856,[LV21]Lords of Valinor
179977300,ᴸᵛTmulla,59672656,905794577,1845514,5370999,421047,1513186,53948654,17916950,79170836,71865604,0,7014907238,5600679937,17841,[LV21]Lords of Valinor
188839265,A 10 Warthog,59195905,13605420,237086,42253,74269,128873,1069472,111911,1426778,1181383,0,3829282740,784780894,11572,[LV21]Lords of Valinor
186009654,Dooby ᴼᴺᴱ,58369615,351621170,958320,2646333,392289,879934,31444469,1617145,36980170,33061614,0,7673915527,137216122,36324,[LV21]Lords of Valinor
188341936,ᴸᵛ Vatson67,56489102,311310398,1758249,1362222,557836,606793,26212749,2268381,31007981,28481130,0,6706997332,384720155,42930,[LV21]Lords of Valinor
188918989,ᴼᴸ Kaymo,56270701,125177460,1092879,2484352,1386449,2529103,10279320,449904,17129128,10729224,0,3826371448,1075163587,41918,[LV21]Lords of Valinor
178814644,Øtòt x҉ Vail,55255367,444858744,3140400,18550973,3385819,2356133,31505688,5494775,61293388,37000463,0,2295222519,2329433716,15946,[LV21]Lords of Valinor
185836736,ᴸᵛMasonFTW,51031799,519409904,2664938,13762904,2238370,4941301,42895386,3173076,67011037,46068462,0,3432064346,2802859223,29310,[LV21]Lords of Valinor
186199010,Daphneᴵᴿ,50082302,233471958,2042363,2217121,1284533,3398282,18083460,1801587,26784983,19885047,0,4237161612,1913572399,56726,[LV21]Lords of Valinor
184871937,ScazBigLion,49234097,1251099924,4532246,59921311,23364142,26120857,97159533,5815431,212381274,102974964,0,5939774287,13704268108,20975,[LV21]Lords of Valinor
186985518,HornyAPOLLOS,49187365,268728779,1852203,3558316,1749826,3484951,22668016,1194875,32655984,23862891,0,2765945331,614948054,19288,[LV21]Lords of Valinor
185355768,Majaaaaaaa,48589363,577673018,6018425,3773833,2405479,3630391,50168691,2794941,62773335,52963632,0,1749957055,8071265646,20194,[LG21]Lords of Gondor
184826667,ᴸᵛAHERUS勇,48571460,585284460,1685082,13268692,6291630,13058058,50339995,720764,83679139,51060759,0,6054988864,1446853955,25336,[LV21]Lords of Valinor
142628224,Dae jang goon,48359330,205391228,2571470,2106271,732287,391595,16537938,1827982,21596073,18365920,0,5024355519,102794418,17359,[LV21]Lords of Valinor
182514982,ᴸoᵛeSalmon,47823733,551684252,3848011,18839332,2064818,5063050,38758863,6797296,71523359,45556159,0,5541818972,1060488180,54727,[LV21]Lords of Valinor
181308342,ᴸᵛRockSolid,47712368,210408625,2866497,2735175,716448,1593581,14237561,2983938,22266703,17221499,0,3463901301,6282949920,41863,[LV21]Lords of Valinor
181825355,ᴸoᵛePUMA,46984368,270582695,1715043,1617608,371858,550287,19851229,3440101,25831083,23291330,0,3290798684,3599759382,36269,[LV21]Lords of Valinor
176994964,Cpl Rage,45704517,128060914,618447,2430812,1506919,2122761,9977113,814937,16852542,10792050,0,1919595452,63265830,17397,[LV21]Lords of Valinor
185808036,Ze Bosh,45682185,324557669,903869,8598579,2626646,3862918,28938009,637645,44663797,29575654,0,5524831742,631820319,29935,-
188920797,FreyaFullBosom,43877820,135903565,2271264,2285165,1585014,2566131,10643042,779078,17858430,11422120,0,3694718730,1363334617,24825,[LV21]Lords of Valinor
179750493,GuiltyMahiru,43206117,242600598,1387039,3737910,2022199,3431507,20245927,1081166,30518709,21327093,0,1513242691,2025360302,41548,[LV21]Lords of Valinor
188241812,Gilgamesh2323,42725031,142285321,1066661,24534299,240264,461406,12155461,674885,38066315,12830346,0,5221257488,212620586,26661,[LV21]Lords of Valinor
179813923,ㄴ Bless ㄱ,42205273,262773135,2299774,7948187,6194983,5464858,21153320,770045,41531393,21923365,0,2553578309,978016636,23734,[LV21]Lords of Valinor
187423027,ᴸᴳPandaFr3d,42041569,190935207,2055069,1957376,794162,916562,14785690,1871613,20325403,16657303,0,2884943404,6820681844,26545,[LV21]Lords of Valinor
182423962,シValkyrieCillaﾒ,41988895,127170065,1924182,5641405,823181,754108,9727093,1205403,18151190,10932496,0,5122885341,1615202822,15350,[LV21]Lords of Valinor
185690465,Dictator  Goat,41966634,360232584,2170212,6092140,2162244,1321602,32756560,1091883,43424429,33848443,0,6252108752,1005155698,35404,[LV21]Lords of Valinor
188969478,ᴰᴹMePaul,41577440,105818563,1013773,1991609,3290337,2582057,7355162,747986,15967151,8103148,0,3818308315,278578838,3768,[LV21]Lords of Valinor
188483360,ᴼᴸTryxan,41460941,200913899,1210760,21238115,2837274,2706917,15674964,1170721,43627991,16845685,0,6231256097,2169436768,40766,[LV21]Lords of Valinor
187247613,Queen Padmé,40032800,228050601,3610959,4493287,3032102,4098480,18106952,1181215,30912036,19288167,0,7806284280,4718542203,89378,[LV21]Lords of Valinor
188485523,ᴸᵛIMPERADOR,39884217,231397488,1354874,855524,108551,227063,18966109,2021997,22179244,20988106,0,6437881799,281752989,38309,[LV21]Lords of Valinor
188976136,ᴸᵛ MUSE,39668509,116706666,1411454,2169291,2437818,1173468,9169176,750577,15700330,9919753,0,5252097561,405719425,49013,[LV21]Lords of Valinor
188785515,Johnvin,39311417,204436783,2107180,1124006,1265713,2578694,17126422,1005078,23099913,18131500,0,5004598327,93446315,57920,[LV21]Lords of Valinor
179816952,Hell CAT GTR,39008682,62282036,2921173,79058810,1765741,1889333,2800448,368849,85883181,3169297,0,5523244652,1636698071,11196,[LV21]Lords of Valinor
185282531,Annıɛ,38979776,45496988,2695521,469962,132883,175975,4001273,221030,5001123,4222303,0,3456998437,592793562,26323,[LV21]Lords of Valinor
185457048,Cman9918,38231477,133602129,1160939,3704156,1184975,873737,11641776,528932,17933576,12170708,0,1996001700,126071365,16769,-
178213242,ᶦˢLOCOOZ,37985112,142897517,3860481,2142456,957035,1554554,8548914,2442380,15645339,10991294,0,4440676334,1274602396,22301,[LV21]Lords of Valinor
189072394,ᴵᴾLaura,37946994,51126391,1312098,15223045,383206,780510,3891089,264122,20541972,4155211,0,6383875084,362529904,27682,[LV21]Lords of Valinor
180368631,ᴸᵛWinfields,37915292,168670295,4752877,23256287,190665,612282,12372478,1873190,38304902,14245668,0,5328448642,1877834074,14079,[LV21]Lords of Valinor
188303104,HokieHighlander,37847654,95699222,1815055,482383,116164,73422,7788949,859362,9320280,8648311,0,1103135971,84975248,14273,[LV21]Lords of Valinor
186765655,KönigsKlãsse,37813392,240208132,1201359,2443903,1408580,1939543,20333402,1290500,27415928,21623902,0,3670957576,407789115,8877,[LV21]Lords of Valinor
188651683,Sol Aliyaa,37736230,13645781,140221,204288,216649,153294,1152169,51838,1778238,1204007,0,4040641149,201676244,15823,[LV21]Lords of Valinor
189060019,Tušiš,37718543,93247749,892658,793409,636796,1052564,7975910,392306,10850985,8368216,0,3058771554,572362931,20978,[LV21]Lords of Valinor
188882878,Rtthyr,37602951,116538794,1104778,416834,164387,186051,9940881,798682,11506835,10739563,0,7566192847,93046400,20009,[LV21]Lords of Valinor
188880730,ᴸᵛMarlone,37387869,160169403,2240632,619139,375785,278204,13390335,1213892,15877355,14604227,0,6075916868,136720000,45696,[LV21]Lords of Valinor
187726069,ᵀᴿvSpryth,36947657,86210894,933981,1399761,170664,364321,7308417,552408,9795571,7860825,0,5565167729,15763287,24634,[LV21]Lords of Valinor
188648613,Känguruᴵᴰ,36588762,25538784,340214,377701,272323,171077,2091875,165777,3078753,2257652,0,2953884233,286935074,13516,[LV21]Lords of Valinor
188789133,MiniMe,36577405,45652264,379199,267924,256760,240905,4050388,180883,4996860,4231271,0,5120140904,34179151,12070,[LV21]Lords of Valinor
185986678,卂尺丂,36509819,96616452,1248612,681974,1395201,1304339,7984294,431468,11797276,8415762,0,3322879223,1253919485,15311,[LV21]Lords of Valinor
188805469,BossAlienᴾᴴ,36337961,69990201,1238059,250538,604492,927660,5961291,270378,8014359,6231669,0,5020720832,134750966,39904,-
182338045,亗ƧHiꟻT亗,35860693,150628524,1131937,2662150,1006449,1312309,10247812,2017792,17246512,12265604,0,5587398643,2545586970,32901,[LV21]Lords of Valinor
188333348,ᴷᴺLinh,35791288,74683537,942313,1904716,1645656,5139453,4264723,390312,13344860,4655035,0,4969625263,550111352,11150,[LV21]Lords of Valinor
189065897,W3llsFargo,35752802,37205704,668888,1191313,898257,213767,3210360,110613,5624310,3320973,0,3988485577,2754424297,19125,[LV21]Lords of Valinor
188276623,ᴸᵛArork,35748516,99155891,1136023,7400266,1269441,1425134,8170932,386355,18652128,8557287,0,3894441569,360935366,16969,[LV21]Lords of Valinor
186444772,Dr4gonツ,34828138,289750647,3333030,5956288,3581975,4320865,25056516,677341,39592985,25733857,0,5349761829,4917255328,39825,[LV21]Lords of Valinor
185341770,ᶜᵘRalfish,34812018,85986529,2793349,1077569,1155423,2769380,5972409,632928,11607709,6605337,0,2720134792,25760000,16301,[LV21]Lords of Valinor
188969981,ᵸᵒWand0,34522464,65852934,1286067,2054730,706949,524275,5336241,428429,9050624,5764670,0,4299659159,306699275,22650,[LV21]Lords of Valinor
185048534,Han Sansan,34519917,170302894,1196315,1172992,524178,1119270,14997432,728427,18542299,15725859,0,6219777631,357367305,33127,[LV21]Lords of Valinor
185089489,ᴼᴾZOROGRANJ,34432058,89977952,1885507,550571,355159,737615,7809122,405792,9858259,8214914,0,5703855206,2083599610,21234,[LG21]Lords of Gondor
189017405,ᵸᵒWizzy,34415215,40039058,1135650,812593,976175,1127095,3056911,142335,6115109,3199246,0,2785485969,170159151,14814,[LV21]Lords of Valinor
188794709,ᶦᵗˢᵘRYU,34392497,132618748,1165180,1384004,2584482,2804836,10911460,341952,18026734,11253412,0,3810218994,94094214,36430,[LV21]Lords of Valinor
188336265,ᴸᵛiGREC,34314615,42676627,387083,548377,205422,376262,3682100,191503,5003664,3873603,0,2450337118,175934276,17555,[LV21]Lords of Valinor
182713036,쵸ﾒMØTÃSÊMツ쵸,34164765,26368298,662283,107410,239091,451161,2334603,35898,3168163,2370501,0,5255797285,123301386,20858,[LV21]Lords of Valinor
190252265,Jamong,33809597,50405766,1036039,247042,332926,226639,4364139,257128,5427874,4621267,0,5371600726,81003240,23817,[LV21]Lords of Valinor
188501467,direraven,33689546,119241479,755951,5174289,2368802,2788352,8778629,726466,19836538,9505095,0,4954920583,4551820,27874,[LV21]Lords of Valinor
188970345,PitBlue,33492253,112152045,948614,1141287,1623732,1705811,9108056,538626,14117512,9646682,0,4054030514,1077393395,23430,[LV21]Lords of Valinor
181534760,ᴸᵛSongoku,33425383,97458912,1807146,978630,733915,1300734,8363864,347689,11724832,8711553,0,3972395967,855945265,16820,[LV21]Lords of Valinor
189154415,ᵸᵒMDKMB,33353535,83193196,935811,2741530,896041,875937,6688412,523247,11725167,7211659,0,2221394541,2796649393,20836,[LV21]Lords of Valinor
188837916,Silent Kakashi,33302543,111664058,901900,842930,754922,750377,10282314,208049,12838592,10490363,0,1807980471,103761097,14110,[LV21]Lords of Valinor
187029935,HolySpirit,33178690,143974907,1549382,1315319,1496292,1994715,12375944,449048,17631318,12824992,0,2699705942,1104079437,19084,[LV21]Lords of Valinor
188362493,亗MrDuck ツ,33171547,61085659,1277713,14227296,2044148,1147941,4534608,210703,22164696,4745311,0,2847642288,1019611190,17235,[LV21]Lords of Valinor
188651684,Milo San,33080765,8042340,256838,43601,89395,77920,674115,40100,925131,714215,0,2999578072,359753808,12125,[LV21]Lords of Valinor
186841127,Anossss,32818606,97070253,1396074,5831747,161764,119554,8353602,578307,15044974,8931909,0,4355706205,4253401,14807,[LV21]Lords of Valinor
190407807,동탄불주먹,32549136,31808814,1121413,1047850,330899,696549,2490389,162368,4728055,2652757,0,5395960297,433522789,15890,[LV21]Lords of Valinor
185037763,ᵛBEARDY,32277187,51437912,2227119,28222212,2319488,801981,2906415,444121,34694217,3350536,0,4921911553,554484409,19513,-
188736727,Alex9003,32041337,44049191,1708322,3023286,729973,820792,3068058,401042,8043151,3469100,0,4239853895,38138060,14423,[LV21]Lords of Valinor
188826595,Saf1974,32146325,150108708,2012452,1508884,695424,712921,11702996,1426722,16046947,13129718,0,5285582593,230946040,52690,[LV21]Lords of Valinor
188368264,funne,31994422,34842286,1335493,898234,647164,618063,2510260,289673,4963394,2799933,0,3815602377,61698120,17027,[LV21]Lords of Valinor
187559873,ｱ尺ﾉ丂ᄃﾉﾚﾚﾑ,31983704,62577567,524842,786256,540194,444292,5234590,360843,7366175,5595433,0,2629725287,626443180,15368,-
188242643,hoahaizz,31769731,125342482,960344,3664404,983434,590291,10198875,914641,16351645,11113516,0,3851877465,4457191315,30548,[LV21]Lords of Valinor
189045190,Azura21,31720990,29061325,1079446,528436,682624,3020265,1500577,25178,5757080,1525755,0,2814110758,423984134,8207,[LV21]Lords of Valinor
182317160,G  O  P  A R,31652496,197890135,2241373,5357848,2321184,2745552,16861799,628800,27915183,17490599,0,4362996723,754465485,29528,[LV21]Lords of Valinor
185612447,Chaudary Zain,33221460,159361223,1497156,9495996,1625907,1047260,13700133,650992,26520288,14351125,0,4610625711,1323892732,26103,[LV21]Lords of Valinor
188451175,ᵸᵒTerra,31449533,63073264,870910,3422823,860914,534113,5094502,379270,10291622,5473772,0,4080434729,92432122,22619,[LV21]Lords of Valinor
188847278,ᴸᵛQuang,31512406,198762905,1319057,2753137,1763130,2716877,17113431,634210,24980785,17747641,0,4162987514,1794614837,35136,[LV21]Lords of Valinor
188225231,ᴾᴿSko0p,31391426,34213211,383675,178306,89071,72567,3151408,109753,3601105,3261161,0,4582339987,0,27307,[LV21]Lords of Valinor
188833519,JulieLaTueuse쵸,31283621,35224933,783782,317897,414633,216327,3035718,155480,4140055,3191198,0,3613399426,37720000,20283,[LV21]Lords of Valinor
188364390,ᴸᵛLeonPoi,31244366,172060465,1505861,526926,421023,1045551,14935827,878628,17807955,15814455,0,3867799414,108004980,37539,[LV21]Lords of Valinor
188352541,ᴾᴿ Mèoッ,31172607,132247542,1478051,7190642,1700314,1304919,10946283,636314,21778472,11582597,0,6241942857,0,14545,[LV21]Lords of Valinor
188262339,Kitty27,31013016,9535022,180744,58400,178359,37776,653560,123996,1052091,777556,0,3928428598,23588840,11568,[LV21]Lords of Valinor
188316323,ᴸᵛ SAKURA,30921020,108404228,1419474,2387863,1142218,2029245,9181356,285584,15026266,9466940,0,4182779570,579454569,27083,[LV21]Lords of Valinor
185724517,Feldgraŭ,30819720,148772897,1770420,439339,3849630,1436815,11220787,1151532,18098103,12372319,0,4251305527,210066760,33614,[LV21]Lords of Valinor
185923730,JFDLCA,30758780,303254533,625367,5353968,3815555,6080380,25557541,732785,41540229,26290326,0,4792156540,386336005,37314,[LV21]Lords of Valinor
184882401,Ферма а,30689761,92480601,1751855,22831138,3000621,3316968,6293708,285409,35727844,6579117,0,2694259785,3538154179,17505,[LV21]Lords of Valinor
188961098,Chocolalat,30530554,2667617,220977,51569,65233,15462,226419,10040,368723,236459,0,4251722817,21199999,3691,[LV21]Lords of Valinor
181581608,Fledermauz DB,30419585,38142703,702758,248895,300074,511759,3506250,19162,4586140,3525412,0,3616659454,377676127,7894,[LV21]Lords of Valinor
186043643,ƐKA,30392249,66412584,1325466,948183,319988,430578,5706384,339841,7744974,6046225,0,3325408149,501165307,31078,[LV21]Lords of Valinor
189001955,ᴸᵛTruNguyen,30174142,50722633,801992,1246026,233037,717051,4455651,129132,6780897,4584783,0,4518799116,243678867,17251,[LV21]Lords of Valinor
188789684,ᴿᵃtMadson,30160593,28738713,677253,1334956,163484,262916,2331159,189075,4281590,2520234,0,3996678928,102421016,42817,[LV21]Lords of Valinor
188876886,ᴸᵛTheanh,30060299,170551484,1560537,18144544,407178,1087885,14834108,670780,35144495,15504888,0,5601678333,107966937,36786,[LV21]Lords of Valinor
188797972,21LuviVilu21,29843248,28199260,1645872,603892,542868,396074,2198887,170979,3912700,2369866,0,4480661421,44539709,16320,[LV21]Lords of Valinor
186295211,ᶠˡVENDETTA,29818198,115576250,2742984,4081984,1084740,528626,9229579,909004,15833933,10138583,0,3885646386,1050356942,20089,[LV21]Lords of Valinor
188598120,ᶻSharineko〤,29765681,125243788,1433370,959742,1457738,813531,10036954,925635,14193600,10962589,0,2384293787,259185747,18314,[LV21]Lords of Valinor
177013392,ᴸᵛ UCC15,29719565,40903964,2710715,1200432,936754,881360,3043775,241359,6303680,3285134,0,5391691957,192271545,16386,[LV21]Lords of Valinor
188944242,Đạt Feet,29657469,29631009,886755,829795,806084,1576473,1838221,158239,5208812,1996460,0,4754822191,16457231,9665,[LV21]Lords of Valinor
188335709,Rebel Rogue,29487496,74852677,1366902,1040029,700124,771386,6337340,339274,9188153,6676614,0,3481882713,34205137,33827,[LV21]Lords of Valinor
188285810,ᴵᴰJupanu,29369760,65563961,1313760,1004348,1641004,851636,5257880,304787,9059655,5562667,0,4899602464,57408174,20573,[LV21]Lords of Valinor
185538462,UMAYKIZ,29206770,84067112,1234556,2429922,767351,902894,7178359,332563,11611089,7510922,0,4105810517,8566632,6504,[LV21]Lords of Valinor
185651937,ᴳᵃʸGrizzy,28913697,394707496,1530202,11898130,5833583,11664631,32492852,453683,62342879,32946535,0,3744084354,952357579,20305,-
188293704,ᴸᵛDrMusaab,28626061,47159198,1714401,193822,427716,173783,3976563,290212,5062096,4266775,0,3882264376,84578452,14899,[LV21]Lords of Valinor
186709522,ᴸᵛ SHERY,28505414,62185658,1562880,609853,401512,544566,5212806,347717,7116454,5560523,0,3409511725,389489407,9555,-
188819438,ᴸᴳLuca,28371247,46983742,616568,378993,894190,250296,4088058,161890,5773427,4249948,0,4256954061,626280200,24205,[LG21]Lords of Gondor
188543996,ᴸᴳﾒNØHOPEツ,28312290,34401626,931686,478590,187282,677631,2858012,132035,4333550,2990047,0,3421574641,31608954,12397,[LV21]Lords of Valinor
185282573,ᴸᵛ3621 BANK,28209257,65727804,821714,686003,1267167,649115,5157649,444166,8204100,5601815,0,1380539975,3173285969,8714,[LV21]Lords of Valinor
188788713,Sam smith,28148157,36247697,772626,601729,331796,180165,3096282,189014,4398986,3285296,0,3948177922,33958258,12704,[LV21]Lords of Valinor
182720562,ᶜᴹᵈSkyy,28092367,19752884,2388318,291902,77615,310791,1289299,270156,2239763,1559455,0,3999667646,685652689,12498,-
188547640,Kitty8152,28090148,1630693,12032,78078,153637,150776,70470,0,452961,70470,0,6490409969,2547000,7753,[LG21]Lords of Gondor
188872694,DELİ ÜSTAD,27891789,5962066,716649,208561,290491,524323,257508,33350,1314233,290858,0,4400627056,39905983,2149,[LG21]Lords of Gondor
188880546,Graf000007,27860554,4086246,1602923,195112,206722,115320,276770,20240,814164,297010,0,3562957843,0,4164,[LG21]Lords of Gondor
188830020,ᴸᴳVersized,27629168,84590095,1243485,675365,950506,483030,6944273,558958,9612132,7503231,0,3854139273,126055668,11372,[LV21]Lords of Valinor
188806334,Emrah 51,27585947,3751158,1312229,1012,10602,4008,371372,0,386994,371372,0,4150229950,0,4428,[LR21]Lords of Rohan
188294260,CЦEПИOH,27503323,10421111,1855157,581297,556310,288078,772954,15519,2214158,788473,0,2754555570,173206292,7548,[LG21]Lords of Gondor
189939798,ʰᵒDestructor,27399077,19723170,52616,21684,68111,82633,1909078,8065,2089571,1917143,0,2982485246,11281500,918,[LV21]Lords of Valinor
185602720,ˢᵉAbdallah,27108253,37680310,200395,749910,727131,953454,2914261,155982,5500738,3070243,0,1730155469,127071312,10194,[LV21]Lords of Valinor
188853241,Алёнаа,27037250,31302992,900423,247992,344883,856812,2140828,286405,3876920,2427233,0,4599088497,45525540,13125,[LV21]Lords of Valinor
188192835,SвулканS,26998943,19967704,388225,2031363,306088,979874,1431780,35598,4784703,1467378,0,3369791466,52162299,9348,[LV21]Lords of Valinor
189141193,ᴸᵛJankels,26990674,66103829,899417,5409357,1932099,2347605,4745652,215541,14650254,4961193,0,3395736693,28726902,17009,[LV21]Lords of Valinor
188365363,diegokristy,26859730,55983704,504980,434161,640264,816141,4292900,421139,6604605,4714039,0,3732548960,246281206,16024,[LV21]Lords of Valinor
188453555,Puyols,26860554,73546024,1496192,466981,370544,264770,6306536,429355,7838186,6735891,0,6960143424,127173124,25546,[LV21]Lords of Valinor
188939030,TBILISI,26771247,7839558,1253222,516250,1297487,330601,372081,4906,2521325,376987,0,3125450165,460258,11771,[LG21]Lords of Gondor
188818127,ᴿᶝ风华,26744295,2158531,1064759,62955,74067,33164,157987,14264,342437,172251,0,4196381637,64472747,3951,[LG21]Lords of Gondor
188544046,G4mine,26718340,28362778,2022351,262704,631545,296942,2242480,171729,3605400,2414209,0,4317317823,247760315,20193,-
189040679,ㄴHORIZONㄱ,26495211,74776471,764075,947828,1035889,885967,6855262,20932,9745878,6876194,0,4541245002,188105599,14271,[LG21]Lords of Gondor
84905552,Schwazzier,26436047,13911756,621510,167620,94182,73167,1095908,121906,1552783,1217814,0,3259031753,60672597,8483,[LV21]Lords of Valinor
188364525,ᴵᴾEmrys II,26412458,3119874,218964,53070,30135,8285,294045,3770,389305,297815,0,2091717356,0,2715,-
188877484,ᴵᵀBLOOM,26240463,73412319,1615750,429658,286070,678042,6496736,253736,8144242,6750472,0,1847010287,111895750,28933,-
188852900,Scorpionking乂,26235335,91770599,2944165,787298,725800,1727500,7725426,299864,11265888,8025290,0,2270544971,58256706,33239,[LV21]Lords of Valinor
188575943,BATUMSKİ08,26180329,126032238,2604699,8739204,9993384,6958475,7269515,188429,33149007,7457944,0,2842129027,529137921,21026,[LV21]Lords of Valinor
188836483,YenifferDeRivia,26044679,41837660,1714676,1784534,2318341,1691838,2868362,69655,8732730,2938017,0,3409146471,140738085,4889,[LR21]Lords of Rohan
186010544,Mehmet027,25732247,65151158,1626376,1893260,1718352,2118048,5148527,68917,10947104,5217444,0,3088163910,173638054,9491,[LV21]Lords of Valinor
188855274,GOLTEB,25558710,132842714,1336339,1219432,175391,426239,12157913,448198,14427173,12606111,0,3412858078,35237187,42283,[LV21]Lords of Valinor
188277784,ᴵᴾPecimura,25471519,28014853,96045,30115,106786,86982,2470635,137049,2831567,2607684,0,2004901092,30935666,8683,[LG21]Lords of Gondor
188891048,7BeLa,25348582,57642914,872000,370252,777201,2820258,4394591,39376,8401678,4433967,0,3249200119,137794496,5869,[LG21]Lords of Gondor
188320476,ᴿᵃЛиса,25212111,50458909,1182473,367919,507133,552515,4229148,243476,5900191,4472624,0,4870908852,390428945,40516,[LV21]Lords of Valinor
188836051,Cheops Pyramide,25175966,83311143,1323682,709979,285764,469450,7430104,320939,9216236,7751043,0,4552067262,751419894,39576,[LV21]Lords of Valinor
189236516,ᴿᶝ年华,24954777,2290337,936926,56107,169818,48265,162204,6219,442613,168423,0,3831273165,48671853,3004,[LG21]Lords of Gondor
188912287,ᴸʳgCoelho,24913398,44202573,948566,2043756,931311,1116370,3378778,183897,7654112,3562675,0,2494347824,113818904,7678,[LV21]Lords of Valinor
146179581,lupepvp,24791455,17722759,715194,253956,122446,45339,1450942,136815,2009498,1587757,0,5462679406,308915418,16479,[LV21]Lords of Valinor
188899189,QuantSist,24577096,1720057,385409,11628,68715,76283,127517,0,284143,127517,0,2159582171,296458,5621,[LG21]Lords of Gondor
185094982,Phi Dương F2P,24526392,39128186,2000294,2842133,5213473,4099201,1025931,73835,13254573,1099766,0,2125385525,147926355,5614,[LV21]Lords of Valinor
188319008,ᴸᵛКэп21,24483757,10075514,29597,216150,128394,92909,914970,12708,1365131,927678,0,2233408969,0,10987,[LG21]Lords of Gondor
188324838,ХОНДА,24471753,7990779,1618420,319927,430706,215833,601619,9293,1577378,610912,0,2525810483,122738819,6024,[LR21]Lords of Rohan
188937309,Velikiy Govard,24353988,9823194,638326,125640,141509,280242,795672,21868,1364931,817540,0,2774177563,125678023,5287,[LG21]Lords of Gondor
184845080,ᴸᵛSCAR德,23941464,63188444,854502,232083,317473,201813,5508015,330984,6590368,5838999,0,3960150272,46674299,28950,[LV21]Lords of Valinor
188840841,ᴸᵛNotZach,23891599,32967064,548532,661641,826162,444933,2566324,186972,4686032,2753296,0,1695142429,107725390,4683,[LV21]Lords of Valinor
188376202,ᴵᴾ云霄,23850217,6580450,1214571,147461,159504,83670,521541,34093,946269,555634,0,2594984100,17020000,4283,[LV21]Lords of Valinor
181974650,IDEM City,23791400,2030305,1163258,142285,141908,58538,141798,3295,487824,145093,0,3776027518,86095121,2071,[LG21]Lords of Gondor
184872506,ᴾᴿF A J A R,23766513,81330450,1396757,2282220,2097345,3030279,6197714,129053,13736611,6326767,0,3250277163,28252952,13422,[LG21]Lords of Gondor
188835262,vinzsou,23932075,32021514,821289,83223,189081,407792,2839782,79886,3599764,2919668,0,2328022412,0,13630,[LV21]Lords of Valinor
188880486,Kỳ tiktok,23562339,10194513,1169669,70126,30762,93811,740708,116832,1052239,857540,0,4150010704,0,3331,[LV21]Lords of Valinor
188994494,Snowplow,23506787,1094552,236306,8504,103749,19351,80795,0,212399,80795,0,2974137494,0,3485,[LR21]Lords of Rohan
188793523,FerAmaya,23505282,15815068,519621,137201,231910,107247,1067844,210819,1755021,1278663,0,3619061073,83532335,5506,[LV21]Lords of Valinor
191454845,ᴸᵛTueAnh,23500541,24754938,683409,6097691,110426,294887,1948174,132663,8583841,2080837,0,5805887791,1141408023,12598,[LV21]Lords of Valinor
188851823,ᴸʳMent001,23371178,706360,45963,213744,185983,43829,11633,0,455189,11633,0,2082971328,0,2811,[LR21]Lords of Rohan
188390528,ᶦᶠAkrosh,23306956,14179254,358164,80861,884019,546131,1021052,0,2532063,1021052,0,1408491622,139317710,2243,[21If]Immortal Falcons
144563085,ᴵᶜPARANOIA,22997521,4730553,1770534,15817,22531,23272,408292,25316,495228,433608,0,2831381744,1021382,4813,[LG21]Lords of Gondor
188937116,ᴵᶜTom,22847232,4798418,78668,26543,281358,25756,401873,5432,740962,407305,0,2254933220,6485919,12148,-
188661481,Kängurufarm,22685146,2847269,781585,208965,117034,10247,253042,0,589288,253042,0,2409834236,1128542199,4146,[LG21]Lords of Gondor
187503097,Romulus1991,22562414,40204309,393781,245756,84426,288474,3410097,236572,4265325,3646669,0,4004250350,82802460,18429,[LV21]Lords of Valinor
188830522,ᴸʳTylnmrl,22526987,1670861,37663,32839,20609,4164,155652,2495,215759,158147,0,2376034813,16585000,4682,[LG21]Lords of Gondor
188842111,JJ00,22383711,12821657,550923,13757,120082,40863,1088289,76620,1339611,1164909,0,2619609251,3999999,3696,[LV21]Lords of Valinor
188234979,iGRECfarm,22319661,15844038,286311,273003,46153,43158,1490992,30729,1884035,1521721,0,2703807026,315563112,10672,-
188639928,The亗SCARFACE,22249123,2476955,64606,145589,285116,162864,116131,3242,712942,119373,0,3267411795,44040000,4362,[LG21]Lords of Gondor
189057248,Cekko23,22188747,31801732,710643,195672,272850,402577,2603567,178546,3653212,2782113,0,3744565444,76002446,11569,[LV21]Lords of Valinor
188664465,ᴸᵛEren 勇,22074129,49965974,1623051,606890,681174,827892,4278040,119514,6513510,4397554,0,1902975921,650343921,22154,-
186016235,卂丂卂千,22027608,6337713,198555,179575,152860,49387,459527,60163,901512,519690,0,2027619886,12932669,3957,[LV21]Lords of Valinor
185905587,Ze Boshman,21929998,4802837,1158706,309125,97861,13805,369719,39644,830154,409363,0,2770839083,41584565,2619,-
188870613,xXVincinetteXx,21868756,8307709,1851059,867867,503902,29008,656394,22318,2079489,678712,0,4699104174,5876311,23600,-
188878743,Jetare,21766174,15339436,984262,914090,1762279,1205895,617894,31477,4531635,649371,0,3329528652,91210728,3164,[LV21]Lords of Valinor
184817793,meto 313,21723529,2940073,2001835,184629,125724,112750,75554,72258,570915,147812,0,3043833042,1827622,1813,[LR21]Lords of Rohan
188838640,Presidente CIAO,21709538,3248958,61803,13150,115426,83389,268192,0,480157,268192,0,1682473680,23800000,4603,[LG21]Lords of Gondor
188846843,BoboFranek,21704370,1436892,86860,96434,230127,133623,42286,0,502470,42286,0,1842439115,45731253,5585,[LG21]Lords of Gondor
188255601,Ant Man21,21587050,21740037,261646,303216,192688,238972,1939567,47123,2721566,1986690,0,3143089623,0,3958,[LG21]Lords of Gondor
188819819,fox77778,21483275,3782562,738594,75581,204618,428450,164441,0,873090,164441,0,3399146724,1037349,4784,[LG21]Lords of Gondor
188337674,ᴵᴸAxan,21421602,13852737,908861,382486,81728,81286,1314956,6904,1867360,1321860,0,2648080983,376836150,9620,[OP1]OP CLAN
186018265,yıldırımsefa,21276860,12642300,258459,159713,850626,471324,812371,45005,2339039,857376,0,3152665981,50620184,8907,[LV21]Lords of Valinor
188856715,ᴸᴳJackie,21264082,16359643,288793,87889,36040,50729,1427895,89406,1691959,1517301,0,1290194986,20000000,4257,[LV21]Lords of Valinor
189036655,Vitia back 1990,21211001,9551108,2056000,172660,105414,21917,821704,50052,1171747,871756,0,2763892633,9800000,8614,[LR21]Lords of Rohan
188884453,dm152,21085150,261473,0,20838,55033,4660,12860,0,93391,12860,0,2820170129,0,4405,[LG21]Lords of Gondor
188889549,СЦEПИОН,21068401,2997871,1241527,21675,25683,72660,248333,8410,376761,256743,0,1929432752,102567597,3696,[LR21]Lords of Rohan
188876948,Ruberoid,20853451,1308095,30041,24678,63862,55794,95226,0,239560,95226,0,1497173666,3846529,4629,[21If]Immortal Falcons
187197359,Demir Bilek,20778429,9273471,779097,120768,235808,174193,781889,13102,1325760,794991,0,2353812729,30192868,11286,[LG21]Lords of Gondor
188853064,TerrorBlade98,20770288,4698786,941546,120572,115534,39441,414286,7149,696982,421435,0,3425259243,0,1395,[LG21]Lords of Gondor
189075824,NooByZ,20765710,8523920,1530004,77034,121760,128921,748617,13157,1089489,761774,0,3365718003,99259891,19016,-
145631489,BABA SON,20730092,8247432,291044,136434,494296,267396,388269,113964,1400359,502233,0,2355636069,4400000,5414,[LV21]Lords of Valinor
188443825,йкйцк,20721165,48743894,1313992,1943111,2457331,1223280,2839555,507597,8970874,3347152,0,2532968576,1971457076,21172,-
188790227,СУЛИМАH,20689024,2937806,1265520,69552,52214,89972,230812,7573,450123,238385,0,1855508039,102878721,3417,[LR21]Lords of Rohan
188847403,Vali188847403,20542852,1805843,502942,88125,113717,240436,59904,0,502182,59904,0,1180853729,0,641,[_NDM]New Jersey Nol
188836639,Ndiaye,20532253,5853377,660696,352077,491543,747064,181162,0,1771846,181162,0,3064402661,383503,1643,-
184819319,joe200,20426646,2022401,1197317,130789,249677,21520,45323,47879,495188,93202,0,1631673131,91263980,5852,[LG21]Lords of Gondor
183360513,ᵀᴸмønoメ,20415868,26110591,478300,186118,247673,221163,2277659,95839,3028452,2373498,0,2125813241,85509847,6981,[LG21]Lords of Gondor
188884272,ZHIANZD,20398835,1216090,246973,127800,150740,29760,77001,0,385301,77001,0,2488342395,0,2033,[LR21]Lords of Rohan
191530671,ᶦᶠtMadsonn,20282121,1846035,34099,69047,86817,200703,85578,0,442145,85578,0,2706581757,910375198,4646,[LR21]Lords of Rohan
188325495,쵸 See La Meet 쵸,20218723,26136473,714725,1038428,1614240,1553702,1521512,63519,5791401,1585031,0,3512199870,0,7931,-
188857113,GritNGravy,20218378,1953070,46395,39362,14347,20181,183578,0,257468,183578,0,2989776595,3200971,3751,[LG21]Lords of Gondor
188903920,JoshuaSeil,20053970,12607964,970454,120993,333270,245904,971721,60820,1732708,1032541,0,2975895632,301497,4367,[LV21]Lords of Valinor
188814205,SUBUTAİ 38,20038418,1466044,274608,292102,181430,22696,95398,0,591626,95398,0,2075441575,3080000,2336,[LG21]Lords of Gondor
188898779,kral jon snow,20021340,113087,6227,15339,20427,859,6573,0,43198,6573,0,2758203077,8327554,2901,[21If]Immortal Falcons
186613612,Inigo Montoya1,20000602,4819124,1455414,349831,116242,28761,406977,16593,918404,423570,0,2742057449,103076547,8798,[LV21]Lords of Valinor
188644411,IQ777,19951696,10297771,72917,271035,682547,244380,661655,64220,1923837,725875,0,1174120561,127703632,20889,-
188261313,freezebee 21,19642821,2063501,394759,244875,375237,108803,81854,515,811284,82369,0,1790515128,5187959,14803,[LG21]Lords of Gondor
188806434,ᴸᴳ Bimz,19630399,6152359,844385,40869,30149,21752,477546,61071,631387,538617,0,3100350829,29458520,10100,[LV21]Lords of Valinor
188232993,AKON311,19570367,17474104,658995,571073,531874,842388,1182997,54831,3183163,1237828,0,1770213436,850687088,12260,[LG21]Lords of Gondor
150165925,ᴸᴳken arok,19426470,30784203,739254,4518139,278206,119051,2610476,137160,7663032,2747636,0,2527833397,54909895,12739,[LV21]Lords of Valinor
188776545,ᴳᵒᵈ Ingle,19359558,1048600,93501,85140,135892,24107,66336,0,311475,66336,0,1724835691,3404666,5157,[LR21]Lords of Rohan
140534782,ᴵᴾCoCaSNX,19345651,21797010,531203,1203243,267031,348395,1715668,123602,3657939,1839270,0,3530980381,2108538017,6924,[RC21]ROYAL CROWN
186011194,RTHAlek607,19315541,35768985,529513,503086,617804,436955,3146088,61203,4765136,3207291,0,3183084132,271316554,20318,[OP1]OP CLAN
188430882,JapayuKingBILAT,19300343,22699462,682023,274371,733692,410201,1845482,54079,3317825,1899561,0,2952075704,154262581,16488,[LV21]Lords of Valinor
188838663,ERON,19296885,8735808,732610,236513,802016,123451,647213,5927,1815120,653140,0,2032663099,20081022,12101,[LG21]Lords of Gondor
184859052,ᴸᵛamadxd1,19281787,11242441,1696065,175899,454668,303269,793425,57530,1784791,850955,0,2295790179,315992716,7344,[LV21]Lords of Valinor
164927516,Iᴠᴀɴツ07,19284642,10720999,801063,584997,950594,899393,462478,24023,2921485,486501,0,1174448948,29829009,6808,[LV21]Lords of Valinor
188360951,SATORUGOJO1,19258456,9648765,472927,508838,996498,575503,454115,35542,2570496,489657,0,1617482301,317828071,6888,[LV21]Lords of Valinor
188818238,PoTaPyh,19183559,17945708,847850,488230,854873,981299,1155520,32896,3512818,1188416,0,3095818334,301072527,13058,[LV21]Lords of Valinor
188827507,Dug1man,19140717,106428,5346,18103,18794,0,6522,0,43419,6522,0,2622082752,0,2506,[LG21]Lords of Gondor
188539042,Chieu F2p,19046853,43087830,765814,971873,1759990,784479,3025016,299270,6840628,3324286,0,2166843548,185342934,12098,[LV21]Lords of Valinor
188806199,Op khan,19037879,4774879,1311876,240925,827408,507637,83281,10426,1669677,93707,0,3053353442,4253716,3341,[LR21]Lords of Rohan
188367613,ᶦᶠKinkyTail,19031155,42707717,812127,1635976,866824,923936,3422021,136546,6985303,3558567,0,1037214264,58186939,14068,[LV21]Lords of Valinor
188844580,RedHoodJT,18937642,3724748,210774,117223,615129,546669,28437,0,1307458,28437,0,1761402210,0,1514,[LR21]Lords of Rohan
188869412,dân chơi đá,18877333,8228309,246570,288205,739830,1185717,194814,0,2408566,194814,0,2106256471,1154652,1641,-
188836606,Black AngEL,18427835,8655975,1937740,908418,995278,553139,422312,2403,2881550,424715,0,2141610562,18536152,1822,[LG21]Lords of Gondor
188490339,Eudaimonia,18291007,13999142,420859,112613,61950,61830,1251520,54510,1542423,1306030,0,3438680360,30962500,6557,[LV21]Lords of Valinor
188823442,VIP shooter,18289032,3305125,846887,132688,41914,75500,277768,5754,533624,283522,0,1695918514,41800001,5342,[LG21]Lords of Gondor
188336750,SKY EAGLE,18136313,7121747,985124,330019,49903,45477,677403,0,1102802,677403,0,1931799839,213802552,9588,-
189014302,magister,18060393,11593788,947900,205152,1188782,528161,695989,5133,2623217,701122,0,1327725746,15363819,7384,[LG21]Lords of Gondor
188787622,MalandrageX,18045575,20690,0,2434,1687,245,1585,0,5951,1585,0,2562932405,0,3299,[LG21]Lords of Gondor
188884243,HiagoLira,18009982,1402109,1,5567,1871,82946,106547,0,196931,106547,0,1677649141,0,2380,[21If]Immortal Falcons
188865329,Việt hoang 07,17892195,607097,64769,419495,234049,900,5150,0,659594,5150,0,2214217502,1833721,888,[21M]Immortal Myrmidons
196566747,Codrin4Valhalla,17729596,8049734,238960,278433,157181,127114,643091,37016,1242835,680107,0,659889753,105200399,6738,[LV21]Lords of Valinor
188487100,Kir8,17696099,744292,46498,47082,45400,57564,41382,0,191428,41382,0,612457103,0,4414,[LG21]Lords of Gondor
189231766,darkkiller666,17669854,3746982,286312,236683,195194,50737,294065,8283,784962,302348,0,2533244060,20289481,14046,[LG21]Lords of Gondor
190852683,BossAlien FARM,17618699,6771910,168409,19244,81805,135783,606132,0,842964,606132,0,4361562822,1694123182,2709,[LR21]Lords of Rohan
189068044,Hsotits7,17577687,13123610,995230,966771,1440390,1040579,499742,44487,3991969,544229,0,2242460841,16241240,3536,[LG21]Lords of Gondor
188904786,Shadow vahalla,17558737,951871,236630,6845,11062,4462,91053,0,113422,91053,0,2927602214,0,3044,[LG21]Lords of Gondor
187016834,卂几Ҝ卂1,17485369,5969476,107689,89142,174787,122716,511121,0,897766,511121,0,2808116054,1649060086,4842,-
188879533,Qertt7,17401973,188791,322,8039,23990,816,10230,1682,44757,11912,0,4237222400,38000000,2214,[LG21]Lords of Gondor
188368666,Derik 災,17193465,17311218,78795,189202,156137,96806,1633226,12081,2087452,1645307,0,1504456225,57910439,4670,-
188585266,メDragønメ,17046256,6200803,260935,13008,75292,24207,548489,23295,684291,571784,0,1565973095,73489482,19339,-
188876717,DEWO YEAGER,17034911,5955979,1113111,572647,822160,386945,262799,1068,2045619,263867,0,2571134834,0,1816,[21if]farm 21If
188503741,SİYAH KAZ,16994656,2745204,35926,148261,185391,246920,121345,7182,709099,128527,0,1557000457,38351774,6878,-
188432088,BandAid,16965606,7448556,374529,37544,89296,147014,558682,54379,886915,613061,0,3110915955,308659606,8663,[LV21]Lords of Valinor
189181702,222mb222,16880340,2096107,769471,199359,63662,40288,176776,0,480085,176776,0,3200530470,225401626,1766,[LR21]Lords of Rohan
188928573,Thànhteo,16834657,1269484,231737,5214,47138,152454,56435,0,261241,56435,0,1518718910,0,3090,[21M]Immortal Myrmidons
188824641,Sabesaur312,16783039,178017,72,61605,21023,10955,7983,0,101566,7983,0,717328751,0,1962,[LR21]Lords of Rohan
188845980,Azadi,16707316,2414584,591878,280392,474111,105066,99002,0,958571,99002,0,1863882325,3366983,1072,[I-am]RoyalLoyalMembers
188861925,blackbandito,16699007,3299236,432177,181283,407143,143151,130863,28373,890813,159236,0,1597027377,24105565,2011,[LG21]Lords of Gondor
190329472,F1Quang,16616835,14222941,1403680,76015,288128,303523,1225945,7897,1901508,1233842,0,4083290875,2942670794,8528,[LV21]Lords of Valinor
188894198,Tomioka senpai,16580142,379272,52185,4153,47557,61967,3546,0,117223,3546,0,2649215647,0,1822,[21If]Immortal Falcons
188833114,Quent2,16531643,29452238,469626,334512,76938,382240,2415930,177160,3386780,2593090,0,1517509156,21298007,11101,[LV21]Lords of Valinor
188513738,MooSáke,16413779,198927,96089,15385,14235,12870,11590,0,54080,11590,0,1825967691,0,1221,[RC21]ROYAL CROWN
188852196,DarkExecutioner,16177458,1452447,100617,60616,84044,164244,61526,0,370430,61526,0,1216662089,28060602,1834,[TFS:]The Forsaken Souls
188857667,Apoathou,16128427,1322660,1124764,128214,19733,13903,120194,0,282044,120194,0,230139173,156690,1097,[LG21]Lords of Gondor
187880560,wcwc,16017764,230115722,1527635,19485000,18674475,23053443,9591814,36893,70841625,9628707,0,3214040764,596448438,13547,[21if]farm 21If
188868206,Quocbao05032012,15985150,2261620,1027424,140343,12908,5049,202922,7916,369138,210838,0,1818063814,23500000,2259,[LV21]Lords of Valinor
188825002,Namiq Cebrayilo,15899594,3934535,1259596,213707,290110,151386,270603,0,925806,270603,0,2313600160,0,795,[LG21]Lords of Gondor
188436016,KiLLedYouhaha,15883497,14393530,383578,202920,240910,231094,1207177,43749,1925850,1250926,0,2693104070,135055118,10415,[LV21]Lords of Valinor
188376429,ᴵᶜmySoul,15863805,447638,94861,165290,199177,4054,1,0,368522,1,0,1317663453,7488905,8468,[LR21]Lords of Rohan
188134384,ˢ carlossainz,15756484,6601011,1300774,21788,65922,52235,498539,63524,702008,562063,0,1190118090,25406959,4008,[LG21]Lords of Gondor
188878343,Cheiron City,15582319,2006372,65708,76640,299335,127026,88427,0,591428,88427,0,1378992548,0,1670,[21if]farm 21If
186035363,Klgi20,15561039,1079100,1084576,54111,135908,7883,18115,29189,245206,47304,0,1940598262,1200000,3145,[21If]Immortal Falcons
188879219,Akglate,15545956,247677,40137,19567,121882,0,0,0,141449,0,0,2077694078,1758755,593,[LR21]Lords of Rohan
187078010,Dr4gonsFarmerツ,15490724,22163921,1316246,641729,1799365,1256244,1338903,1142,5037383,1340045,0,2602487365,1725005764,7894,[21If]Immortal Falcons
188825941,S0SKA,15447745,1189854,237525,181770,115056,123932,42766,0,463524,42766,0,1573181792,17191302,2471,[21M]Immortal Myrmidons
150775231,Lind21,15387821,7690885,484858,498285,954081,721214,266273,6774,2446627,273047,0,1823420717,3048989,2494,-
188877463,Se Tuath De,15316433,1904865,811661,93157,158781,182383,83914,0,518235,83914,0,2598611811,5600000,2458,[LG21]Lords of Gondor
188809474,Edgar15,15275743,46285,13168,43659,11087,2650,478,0,57874,478,0,2116886110,0,1245,[21M]Immortal Myrmidons
187560016,Kyubi Farm1,15192948,43705703,1159458,1634869,1976614,1528733,3277221,26918,8444355,3304139,0,1368128306,409430369,6783,[LG21]Lords of Gondor
188785649,priam,15131421,1750608,803133,48303,27617,11291,164055,0,251266,164055,0,1502125920,18007168,329,[tgqm1]amarl
188858878,lisabella,15044338,237752,277117,67710,112105,0,0,0,179815,0,0,585602661,0,1625,[21M]Immortal Myrmidons
188800436,LilPiglet,14965868,769658,220953,34240,152043,47076,27042,0,260401,27042,0,1378299306,0,1296,[LR21]Lords of Rohan
188781490,Fra1d,14963604,1187031,100258,39857,116341,94712,56753,0,307663,56753,0,1220961083,5509155,3143,[LG21]Lords of Gondor
189036275,TheBlackDragon,14939728,163506,24134,22964,32186,14353,3713,0,73216,3713,0,2063099997,0,1780,[LG21]Lords of Gondor
12113325,Elena23EV,14877461,1817847,131418,8455,10921,55191,154067,1644,230278,155711,0,1157251231,24431024,5770,[LG21]Lords of Gondor
188365295,ᴿᵃTsumiki,14849316,2089406,0,8924,38778,19749,193107,0,260558,193107,0,1063300942,3762398,6032,-
188863496,dark8582,14822465,408222,113485,9062,63839,37988,12678,0,123567,12678,0,1916361881,0,713,[jk10]jk 3621
188986083,KyoHN,14770298,58505,16806,10125,15173,711,2329,0,28338,2329,0,2349901910,69,2863,[LG21]Lords of Gondor
188963486,GÖZTEPELİ35,14745890,131575,0,26938,85,5222,10513,0,42758,10513,0,1956299993,230887100,3805,-
183848200,Ei Farm,14731064,38195393,1298931,2526718,1320489,1044558,2973860,56612,7922237,3030472,0,3111047090,519374881,13486,[LG21]Lords of Gondor
188802524,Yamato68,14724102,193221,131028,1699,7453,9839,13862,0,32853,13862,0,1224230305,13257436,2993,[LG21]Lords of Gondor
188902184,The Lost Legend,14664931,7058172,203577,72451,84459,10146,662590,10414,840060,673004,0,1204480667,0,6695,[LR21]Lords of Rohan
188847086,Dimiboy,14563077,75311,0,179,37638,0,0,0,37817,0,0,1264514688,0,32,[Tick]Tick tack
188873290,FarmЛиса,14514369,6946714,596991,64191,23711,6956,670953,7455,773266,678408,0,1550307834,122800001,4194,[LG21]Lords of Gondor
188796842,Menda2137,14452715,321687,136804,21106,48638,8855,18477,0,97076,18477,0,1124131552,0,1472,[LR21]Lords of Rohan
188806889,Gouverneur188806889,14400469,785370,316714,61610,182543,80923,8427,0,333503,8427,0,1103702173,0,1024,[21MS]Myrmidons Farm
188858305,Palestine313,14362726,3028033,1334422,129577,527939,188640,119168,0,965324,119168,0,1422223660,0,4,[Alg]Palestine313
188856535,HOIANA,14237581,1190153,693357,435295,160981,54643,43890,6183,700992,50073,0,1853430098,400000,1199,[21if]farm 21If
123456386,Igoryan,14206201,5049921,193112,1352415,222892,143876,374139,838,2094160,374977,0,1490952211,11392165,1407,[LG21]Lords of Gondor
188832666,ChifOJ,14203590,2361104,125471,94442,41533,55215,203829,0,395019,203829,0,2662564443,0,552,[21IR] Corral
188287771,ᅟᅠᅠᅠᅠᅟᅠᅠᅠᅠ ᅟᅠᅠ,14188351,55673152,491916,382510,936262,319444,5244635,0,6882851,5244635,0,5077313881,2464968833,28989,[LG21]Lords of Gondor
191177358,RtthyrFarm,14142747,52258,8925,14892,0,0,4928,0,19820,4928,0,3712217256,1594265331,1175,[LG21]Lords of Gondor
188931757,ᴸʳANTHRAX,14054197,659165,84307,164935,187652,32931,11915,0,397433,11915,0,1443661971,0,2114,[LR21]Lords of Rohan
170835406,ᴵᶜ Has,14053933,1445859,679890,46009,32626,7559,101847,16135,204176,117982,0,687055286,298517,2941,[P21J]PETANI IDAMAN
188787790,You  andl,13954846,920284,416012,51124,134014,82128,31352,0,298618,31352,0,1412946338,4084888,1980,[LR21]Lords of Rohan
188896546,БорисBao,13921093,1182765,168254,14668,118405,170863,25957,0,329893,25957,0,1761224189,22966398,1424,[LR21]Lords of Rohan
188953179,SarahVinyard017,13756390,5795264,260817,103502,87804,304494,438098,0,933898,438098,0,1388844714,31860199,3832,[LG21]Lords of Gondor
44936497,젝스킹,15991483,6996924,923387,39204,54846,41378,523118,74135,732681,597253,0,2183506756,0,9052,-
188837379,안정아남자,13532978,885792,199719,262430,137821,8581,52334,0,461166,52334,0,1920465626,0,1132,[LG21]Lords of Gondor
188527602,ᴵᴰROK 쵸 F2P,13501305,5484083,995214,421857,345578,97039,416904,7568,1288946,424472,0,1569741955,727650,10325,[P21J]PETANI IDAMAN
187795145,SOTER,13468932,8447735,539910,529189,65018,309343,652149,22650,1578349,674799,0,1286481653,112215799,15324,[LG21]Lords of Gondor
188899884,hanaaaa230,13465500,3656113,993138,112016,538707,284659,141766,0,1077148,141766,0,1568287163,3785937,1122,[K~R~]3621 Utility Box
186073361,卂尺丂Farm,13435636,4138657,585035,39537,204145,32135,344752,7320,627889,352072,0,2286157342,489706596,1515,[LG21]Lords of Gondor
190539451,puyolF,13486960,972686,309560,2673,66571,105265,41795,0,216304,41795,0,4884735224,1818372170,2113,[LR21]Lords of Rohan
191069538,Shinnygamyy,13280650,3037148,499817,235031,755080,228183,56725,0,1275019,56725,0,1083252012,5089962,691,-
193596249,Korkusuz 51,13257437,239160,358859,12402,0,0,23668,0,36070,23668,0,1407021399,60357336,945,[LR21]Lords of Rohan
187257305,HolySpirits,13242258,4186335,271743,116035,83670,59317,375642,105,634769,375747,0,1170651113,477259605,5805,[21If]Immortal Falcons
188836866,zlucifer,13134321,2684582,271491,220751,328964,145856,139908,0,835479,139908,0,1701695970,0,1524,-
185484265,Tors228,13083005,7740094,636018,1305674,1878812,627539,120762,178,3932965,120940,0,1312958755,25325363,7376,-
188887466,Jensamtresen,12961460,2851467,834974,287219,392239,254799,99035,0,1033292,99035,0,880825536,10799999,842,[I-am]RoyalLoyalMembers
188845348,ᴸʳLUNICTUS,12911317,104914,26926,6884,16888,8978,3385,0,36135,3385,0,1563462979,0,457,[LR21]Lords of Rohan
188817273,Munmon,12901737,1116310,211912,39551,42589,125343,52185,0,259668,52185,0,2476678488,0,125,-
188292201,쵸Bear,12762411,3636617,863462,127956,652623,13205,183272,21012,998068,204284,0,1398516677,0,8400,-
192581999,LilitЛиса,12617394,4558817,2586,4079,12074,27936,442211,0,486300,442211,0,2152438810,534525710,3630,[LG21]Lords of Gondor
185259121,Lets go Os,12572584,913938,1168728,282,16846,7330,13445,35821,73724,49266,0,1397689907,4800000,1596,[LG21]Lords of Gondor
187384799,C H A D 3 3 3,12538133,5025006,638494,336794,550030,58137,356220,3142,1304323,359362,0,969988533,0,4554,[LG21]Lords of Gondor
188816893,WARRIOR FARM 10,12444018,242793,17769,22009,47558,10254,10226,0,90047,10226,0,1323090834,0,1898,[21If]Immortal Falcons
190430624,IMPERADOR FARM,12438960,449281,436505,3716,0,322,44725,0,48763,44725,0,5102048154,2527734725,1636,[LR21]Lords of Rohan
188986347,Pimpammm,12386241,390745,21517,13926,70135,29655,12907,0,126623,12907,0,1444868924,9172286,4484,[OP1]OP CLAN
189266244,ᴵᴾRágnär,12376390,2424921,681640,338989,350984,104124,70352,26757,891206,97109,0,245500638,11642489,7444,-
142371438,NokedliF11,12328082,3005981,754566,516818,830716,67154,61715,17771,1494174,79486,0,1498984833,2400001,10466,[21M]Immortal Myrmidons
188829162,Mkジinsane,12152527,911799,856240,15867,56941,24326,65024,2360,164518,67384,0,1543783586,1400000,3486,[LR21]Lords of Rohan
188880051,qftydhunvfezbjj,12100235,18338939,1337013,1249255,1030656,1111224,1086802,35743,4513680,1122545,0,1422326310,88951930,7822,-
174523518,ㅡᅟᅟF2P 5      ㅡ,12056380,4068578,375472,858694,1490716,123637,42086,0,2515133,42086,0,2291150995,968382628,2432,[LG21]Lords of Gondor
188900034,Rajpoots,12053765,854381,223016,55556,81433,13291,62724,0,213004,62724,0,1898647435,0,3120,[LG21]Lords of Gondor
187155907,Yuzhi,12047286,5032590,1641848,115533,189407,294655,290433,27386,917414,317819,0,2090220211,257605,2042,[LR21]Lords of Rohan
188838338,boble 79,12033618,306757,46338,1697,52760,41937,3315,0,99709,3315,0,1306375470,0,2122,[21MA]Myrmidons Academy
188479340,ㅡᅟᅟF2P 8      ㅡ,12006938,9974813,173571,883535,766581,262971,721306,0,2634393,721306,0,2771982621,1052471741,8854,[LG21]Lords of Gondor
188217778,ᴵᴰKing Nemo,11974922,1852509,716667,684238,272077,322,117022,0,1073659,117022,0,1857331281,0,12936,-
188856725,Uranusuki,11896486,268924,32838,25630,66282,25841,2787,0,120540,2787,0,922767627,3859996,771,[LR21]Lords of Rohan
188952266,ErDegui,11875134,7108681,230822,125436,58773,125367,620570,12944,943090,633514,0,1173596936,13045768,5398,[LG21]Lords of Gondor
188819203,Cominogr,11807027,347521,71452,268238,123679,11074,222,0,403213,222,0,1729595937,0,850,[ANTB]ANnti Banned Club
188818957,alonsoisma,11794026,2300239,762386,25316,47973,75270,189815,0,338374,189815,0,1624802834,4826393,1454,[LR21]Lords of Rohan
189182502,ᴵᶜVatson67F,11756444,137197,213594,1669,4693,617,12501,0,19480,12501,0,3623482544,1724148322,1626,[LR21]Lords of Rohan
188900167,Charles grand 3,11690176,4207791,779277,591939,722430,168606,197012,0,1679987,197012,0,1836758824,8400000,919,[Tick]Tick tack
188818543,GodAnubis,11673999,3265470,842158,347813,333503,280538,140675,0,1102529,140675,0,1282926149,473118,761,[21IR] Corral
188887462,Dunks,11620870,1538565,760926,36818,198678,122594,64347,0,422437,64347,0,1107672787,0,1042,[LR21]Lords of Rohan
188320795,Fïshböy F1,11551953,1130852,410313,146172,398,5918,103727,1994,258209,105721,0,1596078587,949797406,1162,[LR21]Lords of Rohan
188363322,쵸Belmont,11471499,726781,18931,225245,250029,43961,583,0,519818,583,0,1185584888,1410552,11058,-
188892262,Udi lopez,11468305,286475,30519,120358,27289,7419,17815,0,172881,17815,0,262310618,3001045,1864,[LR21]Lords of Rohan
188840730,FurkiTolki,11408975,1839593,1140153,3217,12856,72657,143339,4461,236530,147800,0,1724886024,3600000,2062,[21M]Immortal Myrmidons
188839518,Zaragoza,11323627,1181120,88062,120100,376712,100919,0,0,597731,0,0,1454966383,0,1189,[LR21]Lords of Rohan
188885079,ᴵᶜnoobhuhu,11287294,4932153,869902,263679,640053,58918,316980,9692,1289322,326672,0,1694858992,26599999,5002,-
189182788,Vatson67f3,11170046,260412,485136,2684,4031,13106,19939,0,39760,19939,0,3623311229,1133268751,1385,[LR21]Lords of Rohan
188307234,ᴵᵀJessyS2,11159564,3418968,138406,130180,168640,9783,301652,0,610255,301652,0,1509177777,180913621,6306,-
185877603,ㄴ Aurelio ㄱ,11091560,4496982,844942,194294,519109,17374,310953,12044,1053774,322997,0,934096849,1758080,3804,[LV21]Lords of Valinor
184327666,ツاحمدᴰᴮ,11029899,3839828,551833,681132,488185,101508,178100,27010,1475935,205110,0,1467445432,72130,2701,[LV21]Lords of Valinor
189443468,Hubey,10948714,2171604,462536,189562,257421,35910,147521,0,630414,147521,0,918945909,0,1967,-
188817859,oktaev,10904518,401425,359467,33669,31021,2770,32157,0,99617,32157,0,1119014947,0,100,[DD21])Dragon of Death
189007908,vua đại du,10847143,2010095,594035,32817,68882,36737,135324,18279,292039,153603,0,1664459657,27506603,6095,-
188309795,ᴵᶜ TAZIEX,10844048,8618161,951227,435439,559362,399095,559725,10936,1964557,570661,0,1632163083,0,8839,-
189227933,Z  Hot Rain  Z,10762707,6460378,866429,52143,3457,47844,612586,6290,722320,618876,0,1457174944,13707113,1796,-
195403312,môngcổ,10729425,1446809,783623,85946,65345,87040,95077,0,333408,95077,0,1308759577,0,1080,[LG21]Lords of Gondor
117517315,ᴵᶜBOTAN,10684766,13712356,945529,506093,1444925,965222,611992,37024,3565256,649016,0,1235813199,498018246,20006,-
188847841,Lj1208,10615508,314850,314434,984,0,1961,30681,0,33626,30681,0,1181089928,0,908,[21If]Immortal Falcons
188881481,678907,10539145,4054167,576543,566707,812285,378314,80300,0,1837606,80300,0,1313532063,53227,1534,[LLA]Lost legion academia
189442766,Gubernur189442766,10451474,77204,41779,1313,9937,12737,612,0,24599,612,0,2629084752,2133430704,728,[21IR] Corral
188889920,Carolk,10419143,642390,541227,49383,96269,35954,29616,0,211222,29616,0,1174456889,1349311,322,[fagr]alpha table
188300029,Hoàng Saa,10376726,5137985,463048,87026,120041,279872,368511,3795,859245,372306,0,1351137250,9873378,8187,[LR21]Lords of Rohan
188522411,Ваn,10346788,1095208,3365,36724,120447,26500,74097,0,257768,74097,0,727419882,1,2219,[21If]Immortal Falcons
188899095,Minuz,10314137,1614469,364375,167345,306671,102167,55899,0,632082,55899,0,734386492,0,1707,[LR21]Lords of Rohan
189285062,Linh farm 2,10282348,9739359,1413236,1086939,10938,8479,938116,4251,2048723,942367,0,5579874010,3128768761,1837,[LR21]Lords of Rohan
188295840,ッ Yakuza ッ 6,10205094,395204,0,3871,70818,40591,9043,0,124323,9043,0,992758872,82882904,4857,[21if]farm 21If
188906315,ᴵᶜИвaн,10194251,1248369,45240,148765,274837,58418,43527,0,525547,43527,0,943901017,16348226,12804,-
194265891,쵸MØTÃSÊMツ쵸 2,10176084,2387465,0,5126,24684,21098,225268,0,276176,225268,0,1525988624,125453620,1412,[LG21]Lords of Gondor
188721766,ᴵᶜZver225,10146168,5600948,578427,272790,772945,368830,252518,0,1667083,252518,0,1282562432,205403656,7602,[LG21]Lords of Gondor
188840603,andyrendy,10073872,1722850,894100,10373,99042,247058,53446,0,409919,53446,0,1032365452,0,459,[Slon]Slonii
188840453,La pampara,10023403,4378816,1599817,200050,433845,478194,131470,12182,1255741,143652,0,1516899680,0,336,[21if]farm 21If
188857096,Di 1,10019335,909985,10470,103819,160058,85834,22577,0,372288,22577,0,934774982,1843151,2952,-
188846435,psilva3,9994672,1390439,255473,331056,379662,122656,7428,0,840802,7428,0,971452955,0,591,[21IR] Corral
189869613,Алёнааа,9918709,3146615,691598,31047,82951,360086,153416,0,627500,153416,0,1480925043,503089664,1096,[GW21]GOATED WARRIORS
188898591,Dthomas,9838220,468487,81006,125157,122286,22516,10882,0,280841,10882,0,434478065,0,1343,[LR21]Lords of Rohan
188471943,NoCoboY,9816138,413116,95171,64153,54918,15880,22693,0,157644,22693,0,1081418218,0,3619,[LG21]Lords of Gondor
188790900,Dom Daddy,9664898,3388766,1222043,27914,83403,91562,276497,4258,483634,280755,0,1797295737,0,1455,[OP1]OP CLAN
186065635,MASONFTW WOOD,9644265,1910931,810165,6189,9403,5772,186780,0,208144,186780,0,1738262826,950725213,1297,[LR21]Lords of Rohan
191785327,ᴿᵃQueen,9625702,3017237,247312,228656,300820,10824,232657,0,772957,232657,0,2123392947,813781963,1187,[LR21]Lords of Rohan
186988267,Panda ᴸᴺ,9616784,2766515,1120377,7927,2980,11995,264463,3318,290683,267781,0,3082740466,512115698,1981,-
188962647,卂几Ҝ卂2,9578262,2082291,325396,3405,6149,30163,194866,0,234583,194866,0,1618176948,1219440595,2004,[LR21]Lords of Rohan
189238085,Christian33,9530156,471496,125768,75854,103315,62424,0,0,241593,0,0,724920746,0,1592,[21LK]legionary knight
188815675,KōbøLord,9517898,145859,16647,15805,9235,19277,4712,0,49029,4712,0,843374303,0,1696,[LR21]Lords of Rohan
188462426,Tysson,9512419,1483696,191746,163161,372581,171003,2189,0,708934,2189,0,647738981,310,4388,[21MA]Myrmidons Academy
188844276,tori,9474748,213019,54967,3007,1985,1182,20372,0,26546,20372,0,489310087,0,916,[21If]Immortal Falcons
188308863,Rock Farm ll,9385339,10088421,459789,450027,1066779,575927,546551,4782,2644066,551333,0,737133728,45352280,6170,-
188560833,Gorgona,9371349,1635913,58059,135968,120817,4039,135093,0,395917,135093,0,379010693,1749999,1348,[LR21]Lords of Rohan
105186699,Musti 13,9364627,647045,252843,43047,75095,24684,38951,0,181777,38951,0,1101186393,2316986,969,[21M]Immortal Myrmidons
