ID,Name,Power,Killpoints,Deads,T1 Kills,T2 Kills,T3 Kills,T4 Kills,T5 Kills,Total Kills,T45 Kills,Ranged,Rss Gathered,Rss Assistance,Helps,Alliance
179940560,ᴸᵛ ink,102699801,641100700,4332796,2556731,868211,971623,36847634,13324505,54568704,50172139,0,6129438873,1873979817,81615,[LV21]Lords of Valinor
188540500,TakeMe2Valhalla,86098280,1450691759,5160258,12511616,5652155,10639829,106979181,16226700,152009481,123205881,0,2834278325,7061247251,44657,[LV21]Lords of Valinor
186145908,ʳᵉʸEscanor,85716881,1529355190,3712561,4655002,915441,1734412,126358994,12803286,146467135,139162280,0,3540055267,4498233340,22545,[LV21]Lords of Valinor
180304933,LilLƴ,78745004,320790462,3361824,2782862,2764385,3236435,17772190,6201874,32757746,23974064,0,1168362255,5020554697,22284,[LV21]Lords of Valinor
188858506,Cúchulainn 쵸,76717899,248038544,1946106,713072,273416,425482,21710619,1427049,24549638,23137668,0,5037470021,552651627,37545,[LV21]Lords of Valinor
179655012,ᴸᵛDØØPER,76252911,546251026,2487869,2616693,973544,1254625,34874158,9501026,49220046,44375184,0,8453315548,1471282008,38257,[LV21]Lords of Valinor
178695066,SokoDrake,69463576,111516376,2739209,966390,105667,147411,7965664,1543274,10728406,9508938,0,7908164616,115903540,17565,[LV21]Lords of Valinor
180560115,TripEhh,62862458,401422644,1420469,2616534,813884,294450,24694543,7557417,35976828,32251960,0,6676653726,1225250480,11313,[LV21]Lords of Valinor
184964288,ᴾᴿFïshböy,62549189,269891971,2100314,2057085,4656295,3958131,20669040,1882252,33222803,22551292,0,3485602694,632742525,38766,[LV21]Lords of Valinor
179977300,ᴸᵛTmulla,62541200,775621279,1802231,3860548,417684,1492228,43428983,16687753,65887196,60116736,0,6984474030,5600679937,17686,[LV21]Lords of Valinor
186009654,Dooby ᴼᴺᴱ,59454524,291055795,699771,2460788,347817,487446,26344666,1223578,30864295,27568244,0,7588262487,137216122,35497,[LV21]Lords of Valinor
188839265,A 10 Warthog,57671237,12330470,230642,42253,74269,128873,999555,83122,1328072,1082677,0,3724518467,724780894,11038,[LV21]Lords of Valinor
188341936,ᴸᵛ Vatson67,55318580,268833908,1694949,1326311,557828,595665,23068111,1719461,27267376,24787572,0,6541445993,384720155,42163,[LV21]Lords of Valinor
178814644,ᵁʷᵘØtòt,55062659,444858744,3140400,18550973,3385819,2356133,31505688,5494775,61293388,37000463,0,2295222519,2329433716,15893,[LV21]Lords of Valinor
188918989,ᴼᴸ Kaymo,54997035,125177460,1092879,2484352,1386449,2529103,10279320,449904,17129128,10729224,0,3798863869,1075163587,41626,[LV21]Lords of Valinor
186985518,HornyAPOLLOS,50376164,231840862,1464459,2892482,1515750,3176209,19584819,983892,28153152,20568711,0,2762383318,594947984,18122,[LV21]Lords of Valinor
182514982,ᴸoᵛeSalmon,50312896,402462962,2976384,17816580,655039,737772,27169916,6146966,52526273,33316882,0,5481659448,1060488180,52751,[LV21]Lords of Valinor
185836736,ᴸᵛMasonFTW,50300469,470304243,2378902,5724465,2214818,4769431,38553207,3005996,54267917,41559203,0,3356207411,2802859223,28688,[LV21]Lords of Valinor
180060983,ᴸᵛRumRamsey,48954827,365956215,2220332,95115478,5048028,991336,26994036,3146568,131295446,30140604,0,6070270767,417518493,93762,[LV21]Lords of Valinor
184871937,ScazBigLion,48203158,1217022721,4527691,56591135,23364142,26120855,94350903,5549188,205976223,99900091,0,5925433539,13704268108,20850,[LV21]Lords of Valinor
142628224,Dae jang goon,48012697,162622765,2387504,1946869,718048,367829,12891058,1520770,17444574,14411828,0,4912806281,102794418,16881,[LV21]Lords of Valinor
181308342,ᴸᵛRockSolid,46651497,186967403,2676039,2673547,709463,1391557,12483670,2730542,19988779,15214212,0,3443535922,5962949920,40658,[LV21]Lords of Valinor
181825355,ᴸoᵛePUMA,46367624,224481913,1342478,1450618,359419,531778,15955680,3089452,21386947,19045132,0,3290245647,3599759382,35316,[LV21]Lords of Valinor
176994964,Cpl Rage,45804250,114315818,476905,2377013,1506916,2122761,8943256,645149,15595095,9588405,0,1897067015,63265830,17114,[LV21]Lords of Valinor
185808036,Ze Bosh,45657049,324557669,903869,8598579,2626646,3862918,28938009,637645,44663797,29575654,0,5524831742,631820319,29935,[LV21]Lords of Valinor
188920797,FreyaFullBosom,45368740,91720890,1751730,1764654,953550,1150730,7327446,579174,11775554,7906620,0,3592324497,1323334617,24143,[LV21]Lords of Valinor
179750493,GuiltyMahiru,44725718,170017490,976622,2932954,770432,1180564,14459134,928822,20271906,15387956,0,1482259933,2025360302,40245,[LV21]Lords of Valinor
184826667,ᴸᵛAHERUS勇,43301890,513672701,1416939,12789309,5927578,11125761,44119962,677851,74640461,44797813,0,5910638054,1446853955,25015,[LV21]Lords of Valinor
182423962,シValkyrieCillaﾒ,42602395,115842563,1859110,5641345,822285,707431,8900626,1061687,17133374,9962313,0,5101320318,1265202822,15109,[LV21]Lords of Valinor
179813923,ㄴ Bless ㄱ,42355423,236773429,2185386,7761519,5947505,5144214,18830978,721974,38406190,19552952,0,2477732481,978016636,23456,[LV21]Lords of Valinor
181739549,kylinn,41829522,97526701,3321903,2389177,278410,278364,6880327,1328766,11155044,8209093,0,5128390117,10337862643,31310,[SFIS]Sky Fighters
185690465,Dictator  Goat,41781780,350310517,2053726,6070059,2159337,1277583,31857908,1054421,42419308,32912329,0,6110080391,1005155698,34986,[LV21]Lords of Valinor
187247613,Queen Padmé,41589718,206445398,3171048,4415860,2992217,3977513,16277592,1044591,28707773,17322183,0,7645033184,4648542203,86897,[LV21]Lords of Valinor
188976136,ᴸᵛ MUSE,41116352,98252030,1184156,2079562,2348513,921788,7589404,677895,13617162,8267299,0,5170042437,365719425,47963,[LV21]Lords of Valinor
188241812,Gilgamesh2323,41024266,107483365,858128,24146808,200187,260810,9191245,464897,34263947,9656142,0,5093240149,62620586,25169,[LV21]Lords of Valinor
188969478,ᴰᴹMePaul,40468204,88140831,983206,1953068,3290337,2573561,6152602,467464,14437032,6620066,0,3669477189,278578838,3548,[LV21]Lords of Valinor
188483360,ᴼᴸTryxan,40307863,200408316,1209835,21229570,2837205,2706913,15624592,1170721,43569001,16795313,0,6084235630,2169436768,40389,[LV21]Lords of Valinor
188785515,Johnvin,40312369,170893939,1692593,738996,467737,1071559,14709297,921573,17909162,15630870,0,4947842000,93446315,56866,[LV21]Lords of Valinor
187423027,ᴸᴳPandaFr3d,39561836,187488030,2048263,1957321,794040,914974,14551707,1816576,20034618,16368283,0,2849115211,6820681844,26235,[LV21]Lords of Valinor
188485523,ᴸᵛIMPERADOR,39243454,194318576,1007660,600362,31074,81329,15846910,1767097,18326772,17614007,0,6224058941,281752989,36861,[LV21]Lords of Valinor
186199010,Daphneᴵᴿ,39214665,199358295,1701241,1778105,1269505,3330126,15273890,1520213,23171839,16794103,0,4176231321,1498857670,55255,[LV21]Lords of Valinor
188882878,Rtthyr,38418793,97058353,842990,232908,106385,116963,8286205,673455,9415916,8959660,0,7435690366,93046400,19311,[LV21]Lords of Valinor
185282531,Jëster,38416713,45496988,2695521,469962,132883,175975,4001273,221030,5001123,4222303,0,3451908286,592793562,26239,[LV21]Lords of Valinor
185457048,Cman9918,38231477,133602129,1160939,3704156,1184975,873737,11641776,528932,17933576,12170708,0,1996001700,126071365,16769,[LV21]Lords of Valinor
187726069,ᵀᴿvSpryth,37776661,65864411,731133,1327439,163988,333442,5631670,381024,7837563,6012694,0,5475007618,15763287,23257,[LV21]Lords of Valinor
188880730,ᴸᵛMarlone,37710183,140317721,1911316,485948,371025,197873,11777629,1045535,13878010,12823164,0,5937973622,136720000,44783,[LV21]Lords of Valinor
188651683,Sol Aliyaa,37524300,12427327,140221,119895,49805,35722,1146505,34790,1386717,1181295,0,3958562132,201676244,15537,[LV21]Lords of Valinor
180368631,ᴸᵛWinfields,37505527,165249366,4670313,23224274,189123,611409,12141439,1818312,37984557,13959751,0,5216521407,1877834074,13707,[LV21]Lords of Valinor
179816952,Hell CAT GTR,37374331,59619348,2896557,79058810,1765741,1889101,2592212,339879,85645743,2932091,0,5512842083,1636698071,10844,[LV21]Lords of Valinor
188303104,HokieHighlander,37366673,70496118,1498673,344971,109840,53066,5793938,602790,6904605,6396728,0,1074205799,84975248,13473,[LV21]Lords of Valinor
189060019,Tušiš,37046296,82068235,775218,722106,635078,1036387,7051037,299887,9744495,7350924,0,2945908234,572362596,20318,[LV21]Lords of Valinor
188569749,ᴵᴾEndoloris,37018743,135932617,1872172,1390988,2616276,1563397,10769220,823804,17163685,11593024,0,1822151378,163440000,5369,-
178213242,ᶦˢLOCOOZ,36596934,139155605,3850546,2141345,957035,1554554,8335675,2361915,15350524,10697590,0,4368166294,1274602396,21996,[LV21]Lords of Valinor
188648613,Känguruᴵᴰ,36553614,25538784,340214,377701,272323,171077,2091875,165777,3078753,2257652,0,2953884233,286935074,13516,[LV21]Lords of Valinor
188805469,BossAlienᴾᴴ,36291961,69990201,1238059,250538,604492,927660,5961291,270378,8014359,6231669,0,4994590098,134750966,39694,[LV21]Lords of Valinor
188789133,MiniMe,36143005,38822357,340034,258586,224998,167551,3543518,110763,4305416,3654281,0,4973444165,34179151,11767,[LV21]Lords of Valinor
182338045,亗ƧHiꟻT亗,36129832,134754048,1095353,2640524,1006449,1310254,8852061,1922571,15731859,10774632,0,5524944212,2515586970,32325,[LV21]Lords of Valinor
188276623,ᴸᵛArork,36044886,85975102,934057,7261071,1265703,1364258,7111817,270814,17273663,7382631,0,3802694166,360935366,16544,[LV21]Lords of Valinor
189072394,ᴵᴾLaura,35861349,49846939,1312098,13850638,383206,780510,3810508,254164,19079026,4064672,0,6277411534,362529904,27286,[LV21]Lords of Valinor
185048534,Han Sansan,35840800,135645165,816325,909706,342096,539228,12049948,606132,14447110,12656080,0,6108405017,357367305,31823,[LV21]Lords of Valinor
189065897,W3llsFargo,35687409,36866964,662685,1191313,898257,213767,3194692,101510,5599539,3296202,0,3924877932,2754424297,18979,[LV21]Lords of Valinor
186444772,Dr4gonツ,35489934,274182066,3165022,5679943,3502249,3856115,23836218,612747,37487272,24448965,0,5330692707,4327255259,38966,[LV21]Lords of Valinor
185341770,ᶜᵘRalfish,35129226,56693661,2488511,836048,394052,497142,4218442,578268,6523952,4796710,0,2686041607,25760000,15862,[LV21]Lords of Valinor
188333348,ᴷᴺLinh,35113710,69280653,935539,1902695,1645656,5139453,3849753,327673,12865230,4177426,0,4910109811,550111352,11037,[LV21]Lords of Valinor
181534760,ᴸᵛSongoku,34732079,78665598,1418818,947363,718037,1206878,6736752,242251,9851281,6979003,0,3892866977,755945265,15898,[LV21]Lords of Valinor
185089489,ᴼᴾZOROGRANJ,34332185,89977952,1885507,550571,355159,737615,7809122,405792,9858259,8214914,0,5703855206,2083599610,21232,[LG21]Lords of Gondor
188969981,ᵸᵒWand0,34239984,65704914,1286067,2054730,706949,524275,5321439,428429,9035822,5749868,0,4298015141,306699275,22608,[LV21]Lords of Valinor
185986678,卂尺丂,34100215,85165499,1209220,680685,1395198,1286689,7045359,331931,10739862,7377290,0,3322054021,1193919485,14916,[LV21]Lords of Valinor
188336265,ᴸᵛiGREC,34006974,35128000,354919,533661,195122,279696,3039866,155679,4204024,3195545,0,2450337076,175934276,17296,[LV21]Lords of Valinor
188826595,Saf1974,33822232,109240034,1400434,1284520,555245,574540,8690310,933569,12038184,9623879,0,5182800372,230946040,49860,[LV21]Lords of Valinor
189017405,ᵸᵒWizzy,33818262,36698364,1128087,812593,975948,1093260,2785201,117945,5784947,2903146,0,2748461919,170159151,14372,[LV21]Lords of Valinor
188970345,PitBlue,33718431,100803181,862627,1120668,1623539,1658595,8170621,449569,13022992,8620190,0,4033756191,1077393393,22917,[LV21]Lords of Valinor
188794709,ᶦᵗˢᵘRYU,33544361,108177474,993557,1318150,2549412,2529700,8630296,319663,15347221,8949959,0,3689978200,94094214,35694,[LV21]Lords of Valinor
189154415,ᵸᵒMDKMB,33310831,64103924,785334,2572471,865337,727479,4956452,469216,9590955,5425668,0,2172814697,2686649252,20074,[LV21]Lords of Valinor
190252265,Jamong,33075881,47896421,986556,240286,331111,224508,4124413,252199,5172517,4376612,0,5262257851,81003240,23542,[LV21]Lords of Valinor
188501467,direraven,32964700,100367932,744306,5169512,2366933,2785371,7230710,557579,18110105,7788289,0,4899255782,4551820,27095,[LV21]Lords of Valinor
182713036,쵸ﾒMØTÃSÊMツ쵸,32962239,24386338,662283,107410,239091,451161,2136407,35898,2969967,2172305,0,5130761493,123301386,20414,[LV21]Lords of Valinor
187029935,HolySpirit,32938667,130508859,1420772,1243047,1343710,1577860,11281393,422373,15868383,11703766,0,2699666437,1104079437,18539,[LV21]Lords of Valinor
188651684,Milo San,32928061,7521953,256838,5998,5637,18715,663262,40100,733712,703362,0,2973774593,359753808,11937,[LV21]Lords of Valinor
182317160,G  O  P  A  Rr,32865494,169220948,1939750,3134912,2312668,2727770,14363163,471296,23009809,14834459,0,4183621135,738465485,28548,[LV21]Lords of Valinor
188362493,亗MrDuck ツ,32775086,54077183,1162431,14223855,2043574,1147191,3984118,135766,21534504,4119884,0,2839273860,909611190,16822,[LV21]Lords of Valinor
188837916,Silent Kakashi,32647077,105876915,889638,839969,754922,750377,9809221,155268,12309757,9964489,0,1784213500,103761097,14013,[LV21]Lords of Valinor
188544046,G4mine,32447417,26635738,854807,262602,631545,296942,2070874,171181,3433144,2242055,0,4317317823,247760315,20193,[LV21]Lords of Valinor
188736727,Alex9003,32319182,36551480,1660154,2964172,704741,765686,2519650,314496,7268745,2834146,0,4193677149,38138060,14307,[LV21]Lords of Valinor
185612447,Chaudary Zain,32315811,144415515,1440237,9266997,1590757,914083,12372583,599922,24744342,12972505,0,4523047583,1323892732,25279,[LV21]Lords of Valinor
188368264,funne,32302103,29062881,1265037,834275,642636,595616,2142091,190369,4404987,2332460,0,3763880434,61698120,16569,[LV21]Lords of Valinor
185037763,ᵛBEARDY,32277187,51437912,2227119,28222212,2319488,801981,2906415,444121,34694217,3350536,0,4921911553,554484409,19513,-
187559873,ｱ尺ﾉ丂ᄃﾉﾚﾚﾑ,31983704,62577567,524842,786256,540194,444292,5234590,360843,7366175,5595433,0,2629725287,626443180,15368,[LV21]Lords of Valinor
188451175,ᵸᵒTerra,31978125,59456104,870910,3422823,860914,534113,4795714,347806,9961370,5143520,0,4035534660,92432122,22415,[LV21]Lords of Valinor
186765655,KönigsKlãsse,31966412,200924402,930323,2111571,1361404,1848800,16784864,1126772,23233411,17911636,0,3568977240,407789115,8243,[LV21]Lords of Valinor
188352541,ᴾᴿ Mèoッ,31894828,127518876,1258710,7188100,1700314,1303642,10538936,603835,21334827,11142771,0,6163857414,0,14370,[LV21]Lords of Valinor
186841127,Anossss,31756766,96562733,1396074,5831747,161764,119554,8329768,564848,15007681,8894616,0,4236059265,4253401,14573,[LV21]Lords of Valinor
188225231,ᴾᴿSko0p,31711015,32664714,356756,168570,89071,72567,3031465,92397,3454070,3123862,0,4545798280,0,27161,[LV21]Lords of Valinor
188833519,JulieLaTueuse쵸,31609715,26213054,621039,141152,346846,94148,2255258,128098,2965502,2383356,0,3564320030,37720000,19862,[LV21]Lords of Valinor
189045190,Azura21,31320893,28813819,1079446,528436,682624,3020226,1479906,23146,5734338,1503052,0,2787495027,423984134,8076,[LV21]Lords of Valinor
185724517,Feldgraŭ,31174031,146940777,1759421,439339,3849630,1436815,11099577,1120531,17945892,12220108,0,4251264146,178066760,33344,[LV21]Lords of Valinor
190407807,동탄불주먹,31062637,27047417,1056665,1020079,330666,695585,2046373,146800,4239503,2193173,0,5316617891,433522789,15469,[LV21]Lords of Valinor
188242643,hoahaizz,30932359,116699839,931394,3648605,968129,568030,9517984,829095,15531843,10347079,0,3779748489,567041937,29846,[LV21]Lords of Valinor
188598120,ᶻSharineko〤,30683086,82378445,830245,875997,1456432,803718,6199089,704231,10039467,6903320,0,2372669340,51185747,16819,[LV21]Lords of Valinor
184882401,Ферма а,30478635,92417701,1751855,22831138,3000621,3316968,6287418,285409,35721554,6572827,0,2671795840,3538154179,17481,[LV21]Lords of Valinor
188847278,ᴸᵛQuang,30351955,151155063,1217495,1245616,1436737,1289374,13345039,471229,17787995,13816268,0,4099116773,1610824614,33978,[LV21]Lords of Valinor
177013392,ᴸᵛ UCC15,30084953,39005363,2664930,1200338,936753,880990,2885533,225625,6129239,3111158,0,5356644466,192271545,16168,[LV21]Lords of Valinor
188961098,Chocolalat,30052069,2573117,220977,51569,65233,15462,226397,5326,363987,231723,0,4184133012,21199999,3588,[LG21]Lords of Gondor
188316323,ᴸᵛ SAKURA,29535490,101576696,1378468,2386732,1137444,2024123,8627821,222488,14398608,8850309,0,4136942010,539454569,26539,[LV21]Lords of Valinor
188797972,21LuviVilu21,29534636,19399984,1222428,579952,518648,328487,1463837,114719,3005643,1578556,0,4378580526,34539709,15839,[LV21]Lords of Valinor
188262339,Kitty27,29448116,7212243,100178,54908,178359,33366,453638,108735,829006,562373,0,3837637921,23588840,10745,[LV21]Lords of Valinor
188293704,ᴸᵛDrMusaab,29424969,42059156,1576702,191214,427716,173783,3595411,225812,4613936,3821223,0,3803494425,84578452,14529,[LV21]Lords of Valinor
181581608,Fledermauz DB,29277765,32274033,694585,248895,300074,511759,2919449,19129,3999306,2938578,0,3577184021,377676127,7743,[LV21]Lords of Valinor
188789684,ᴿᵃtMadson,29274171,23080410,542169,1177460,162620,152532,1967393,111781,3571786,2079174,0,3936025033,72421016,40805,[LV21]Lords of Valinor
185923730,JFDLCA,28993234,270726632,434687,5131053,3803977,6044357,22995362,398071,38372820,23393433,0,4733804989,386336005,36519,[LV21]Lords of Valinor
189001955,ᴸᵛTruNguyen,28982229,23592016,718506,844954,157659,366262,2007146,78560,3454581,2085706,0,4450358355,231678867,16465,[LV21]Lords of Valinor
188853241,Алёнаа,28961202,26499949,749181,246727,344883,856812,1738527,247416,3434365,1985943,0,4510056960,45525540,12981,[LV21]Lords of Valinor
185651937,ᴳᵃʸGrizzy,28827761,394704092,1530202,11881112,5833583,11664631,32492852,453683,62325861,32946535,0,3744084354,952357579,20305,-
188876886,ᴸᵛTheanh,28755164,126687079,1326532,1972819,306133,579340,11558871,388709,14805872,11947580,0,5568099106,107966937,34658,[LV21]Lords of Valinor
188830020,ᴸᴳVersized,28650613,58737663,842032,636445,938250,417681,4791321,357497,7141194,5148818,0,3770662019,46055668,10609,[LV21]Lords of Valinor
188543996,ᴸᴳﾒNØHOPEツ,28609339,22466962,750300,321061,76882,175524,1923229,115730,2612426,2038959,0,3389021615,31608954,11721,[LV21]Lords of Valinor
188364390,ᴸᵛLeonPoi,28521912,150371036,1317830,495443,399103,640818,13041059,824994,15401417,13866053,0,3780237797,108004980,36537,[LV21]Lords of Valinor
186295211,ᶠˡVENDETTA,28473342,115576250,2742984,4081984,1084740,528626,9229579,909004,15833933,10138583,0,3885646386,1050356942,20072,[LV21]Lords of Valinor
188819438,ᴸᴳLuca,28438513,46044144,573803,296542,432636,250296,4088058,161890,5229422,4249948,0,4234485111,286280200,24193,[LG21]Lords of Gondor
188944242,Đạt Feet,28422052,20875568,758416,769072,733958,1500022,1135993,94691,4233736,1230684,0,4592381016,16457231,9142,[LV21]Lords of Valinor
185282573,ᴸᵛ3621 BANK,28364577,62632106,771884,668111,1267167,649115,4855577,440596,7880566,5296173,0,1366951055,2053285969,8660,[LV21]Lords of Valinor
186709522,ᴸᵛ SHERY,28222217,62185658,1562880,609853,401512,544566,5212806,347717,7116454,5560523,0,3409511725,99489407,9542,[LV21]Lords of Valinor
188335709,Rebel Rogue,28144102,74045507,1366902,1040029,700124,771386,6274509,330331,9116379,6604840,0,3456553024,34205137,33721,[LV21]Lords of Valinor
182720562,ᶜᴹᵈSkyy,28092367,19752884,2388318,291902,77615,310791,1289299,270156,2239763,1559455,0,3999667646,685652689,12498,-
188788713,Sam smith,28090123,33664469,760222,594797,331614,179458,2873137,171654,4150660,3044791,0,3890004259,33958258,12592,[LV21]Lords of Valinor
185538462,UMAYKIZ,27880403,82382298,1210994,2427602,767351,902894,7051202,311924,11460973,7363126,0,4064133608,8566632,6435,[LV21]Lords of Valinor
186043643,卂几Ҝ卂,27820208,56876561,1181956,888325,301712,375673,4849766,304756,6720232,5154522,0,3289723914,501165307,30126,[LV21]Lords of Valinor
188547640,Kitty8152,27461616,1630693,12032,78078,153637,150776,70470,0,452961,70470,0,6283865573,2547000,7616,[LG21]Lords of Gondor
188880546,Graf000007,27324978,4086246,1602923,195112,206722,115320,276770,20240,814164,297010,0,3484823143,0,4029,[LG21]Lords of Gondor
188852900,Scorpionking乂,27004650,81836217,2564465,698557,536746,1654576,6965261,217605,10072745,7182866,0,2217228704,58256706,32058,[LV21]Lords of Valinor
188294260,CЦEПИOH,26992293,10421111,1855157,581297,556310,288078,772954,15519,2214158,788473,0,2731696545,173206292,7525,[LG21]Lords of Gondor
188806334,Emrah 51,26971037,3751158,1312229,1012,10602,4008,371372,0,386994,371372,0,4126810750,0,4417,[LR21]Lords of Rohan
188453555,Puyols,26838334,53941739,1090161,414135,352520,193153,4644426,296850,5901084,4941276,0,6762066397,127173124,24079,[LV21]Lords of Valinor
188192835,SвулканS,26657935,19967704,388225,2031363,306088,979874,1431780,35598,4784703,1467378,0,3364532541,52162299,9081,[LV21]Lords of Valinor
188872694,DELİ ÜSTAD,26562621,5962066,716649,208561,290491,524323,257508,33350,1314233,290858,0,4296507221,39905983,2119,[LG21]Lords of Gondor
188285810,ᴵᴰJupanu,26526581,47189990,1043044,864684,1573717,521185,3714482,232003,6906071,3946485,0,4832674852,57408174,20045,[LV21]Lords of Valinor
189040679,ㄴHORIZONㄱ,26495211,74776471,764075,947828,1035889,885967,6855262,20932,9745878,6876194,0,4541245002,188105599,14268,[LG21]Lords of Gondor
188364525,ᴵᴾEmrys II,26412458,3119874,218964,53070,30135,8285,294045,3770,389305,297815,0,2091717356,0,2715,-
188836483,YenifferDeRivia,26288362,41563930,1633040,1784534,2318341,1691838,2852355,63972,8711040,2916327,0,3408936737,140738085,4884,-
188877484,ᴵᵀBLOOM,26240463,73412319,1615750,429658,286070,678042,6496736,253736,8144242,6750472,0,1847010287,111895750,28933,-
186010544,Mehmet027,25988032,55990992,1540749,1745924,1605817,1988711,4394543,26495,9761490,4421038,0,3033193055,173638054,8776,[LV21]Lords of Valinor
189141193,ᴸᵛJankels,25978802,54329109,819486,2368695,1924928,2323951,3777349,146811,10541734,3924160,0,3300444942,28726902,16240,[LV21]Lords of Valinor
188818127,ᴿᶝ风华,25960653,2158531,1064759,62955,74067,33164,157987,14264,342437,172251,0,4144206174,64472747,3873,[LG21]Lords of Gondor
188575943,BATUMSKİ08,25944878,123697233,2518476,8713459,9991171,6956425,7079066,167792,32907913,7246858,0,2802019659,529137921,20690,[LV21]Lords of Valinor
188939030,TBILISI,25900727,7839558,1253222,516250,1297487,330601,372081,4906,2521325,376987,0,3054945431,460258,11692,[LG21]Lords of Gondor
189939798,ʰᵒDestructor,25854514,19301020,52616,21684,68111,82633,1882993,0,2055421,1882993,0,2848341819,11281500,859,[LG21]Lords of Gondor
188365363,diegokristy,25815974,43024019,464864,421018,640200,815724,3361512,239070,5477524,3600582,0,3724189269,246281206,15454,[LV21]Lords of Valinor
188806124,ᴵᴾAltar,25682493,111614407,1481141,3177848,4192360,2583327,8685363,270359,18909257,8955722,0,2531022967,7742830,26734,[LG21]Lords of Gondor
188836051,Cheops Pyramide,25540906,69243815,1096532,644865,285017,461502,6262820,203530,7857734,6466350,0,4459969318,751419894,36910,[LV21]Lords of Valinor
188835262,vinzsou,25449361,16597913,334531,46309,92071,38810,1495429,64749,1737368,1560178,0,2294871902,0,13012,[LV21]Lords of Valinor
188891048,7BeLa,25348582,57642914,872000,370252,777201,2820258,4394591,39376,8401678,4433967,0,3249200119,137794496,5869,[LG21]Lords of Gondor
188855274,GOLTEB,25113935,128214224,1327294,1219432,175391,426239,11747670,421895,13990627,12169565,0,3394285452,35237187,41865,[LV21]Lords of Valinor
188320476,ᴿᵃЛиса,25014332,41215266,1141689,367832,506674,543458,3500224,147614,5065802,3647838,0,4799382653,362428945,39778,[LV21]Lords of Valinor
188912287,ᴸʳgCoelho,24726258,33075843,820622,1419717,814999,1014738,2478233,116031,5843718,2594264,0,2458137185,113818904,7067,[LV21]Lords of Valinor
146179581,lupepvp,24836394,11568565,602010,166315,115101,34970,963558,76482,1356426,1040040,0,5370150794,108915418,15097,[LV21]Lords of Valinor
84905552,Schwazzier,24546014,10701276,506526,147563,86882,62010,838244,93376,1228075,931620,0,3193618864,60672597,8040,[LV21]Lords of Valinor
189236516,ᴿᶝ年华,24490216,2290337,936926,56107,169818,48265,162204,6219,442613,168423,0,3759533807,48671853,2945,[LG21]Lords of Gondor
188319008,ᴸᵛКэп21,24483757,10075514,29597,216150,128394,92909,914970,12708,1365131,927678,0,2233408969,0,10987,[LG21]Lords of Gondor
185602720,ˢᵉAbdallah,24440631,37680310,200395,749910,727131,953454,2914261,155982,5500738,3070243,0,1707106341,127071312,9578,[LV21]Lords of Valinor
188324838,ХОНДА,24399153,7990779,1618420,319927,430706,215833,601619,9293,1577378,610912,0,2514329809,122738819,6015,[LR21]Lords of Rohan
188937309,Velikiy Govard,24241688,9823194,638326,125640,141509,280242,795672,21868,1364931,817540,0,2674782694,125678023,5240,[LG21]Lords of Gondor
184845080,ᴸᵛSCAR德,24083428,56330280,645601,214040,313729,200941,4970637,257494,5956841,5228131,0,3841650475,46674299,28231,[LV21]Lords of Valinor
181974650,IDEM City,23791400,2030305,1163258,142285,141908,58538,141798,3295,487824,145093,0,3776027518,86095121,2071,[LG21]Lords of Gondor
184872506,ᴾᴿF A J A R,23766513,81330450,1396757,2282220,2097345,3030279,6197714,129053,13736611,6326767,0,3250277163,28252952,13422,[LG21]Lords of Gondor
188840841,ᴸᵛNotZach,23624521,30110904,506333,591643,826092,444463,2318528,168863,4349589,2487391,0,1617161387,107725390,4499,[LV21]Lords of Valinor
185094982,Phi Dương F2P,23586495,38331232,1940175,2842133,5213473,4079345,964930,68459,13168340,1033389,0,2109637550,147926355,5359,[LV21]Lords of Valinor
188994494,Snowplow,23294262,1094552,236306,8504,103749,19351,80795,0,212399,80795,0,2900728949,0,3456,[LR21]Lords of Rohan
188390528,ᶦᶠAkrosh,23277756,14179254,358164,80861,884019,546131,1021052,0,2532063,1021052,0,1408491622,139317710,2243,[21If]Immortal Falcons
188793523,FerAmaya,23250054,12157981,506442,129947,223590,105868,831368,147383,1438156,978751,0,3610488192,43532335,5279,[LV21]Lords of Valinor
188376202,ᴵᴾ云霄,23209083,6580450,1214571,147461,159504,83670,521541,34093,946269,555634,0,2593018500,17020000,4275,[LV21]Lords of Valinor
188880486,Kỳ tiktok,22930527,8487802,1062340,68271,30446,79884,622510,93431,894542,715941,0,3950994000,0,3166,[LV21]Lords of Valinor
188899189,QuantSist,22901448,1720056,385409,11624,68715,76283,127517,0,284139,127517,0,2092232390,296458,5547,[LG21]Lords of Gondor
144563085,ᴵᶜPARANOIA,22878266,4730553,1770534,15817,22531,23272,408292,25316,495228,433608,0,2831381744,1021382,4811,[LG21]Lords of Gondor
188937116,ᴵᶜTom,22847232,4798418,78668,26543,281358,25756,401873,5432,740962,407305,0,2254933220,6485919,12148,-
188661481,Kängurufarm,22685146,2847269,781585,208965,117034,10247,253042,0,589288,253042,0,2409834236,1128542199,4146,[LG21]Lords of Gondor
191454845,ᴸᵛTueAnh,22591967,21628353,664298,6082249,104981,279588,1661303,123528,8251649,1784831,0,5641073202,1009408023,11989,[LV21]Lords of Valinor
189057248,Cekko23,22727040,21896824,595985,139303,267141,394238,1785995,94889,2681566,1880884,0,3649492857,76002446,11303,[LV21]Lords of Valinor
185134660,PetitDr,22413048,3101404,85261,63894,67172,12418,288305,1078,432867,289383,0,1499181335,17979430,10865,-
188234979,iGRECfarm,22319661,15844038,286311,273003,46153,43158,1490992,30729,1884035,1521721,0,2703807026,315563112,10672,-
188851823,ᴸʳMent001,22318629,706360,45963,213744,185983,43829,11633,0,455189,11633,0,1980908446,0,2755,[LR21]Lords of Rohan
188842111,JJ00,22198511,12699687,546042,13757,120082,40863,1080466,74433,1329601,1154899,0,2619609251,3999999,3651,[LV21]Lords of Valinor
186016235,卂丂卂千,22003060,5455072,172363,142922,151729,14030,395527,55582,759790,451109,0,1926212184,12932669,3834,[LV21]Lords of Valinor
188830522,ᴸʳTylnmrl,22004940,1670861,37663,32839,20609,4164,155652,2495,215759,158147,0,2294341511,16585000,4649,[LG21]Lords of Gondor
185905587,Ze Boshman,21929998,4802837,1158706,309125,97861,13805,369719,39644,830154,409363,0,2770839083,41584565,2619,-
188870613,xXVincinetteXx,21868756,8307709,1851059,867867,503902,29008,656394,22318,2079489,678712,0,4699104174,5876311,23600,-
188639928,The亗SCARFACE,21848870,2476955,64606,145589,285116,162864,116131,3242,712942,119373,0,3226474240,44040000,4323,[LG21]Lords of Gondor
188846843,BoboFranek,21704370,1436892,86860,96434,230127,133623,42286,0,502470,42286,0,1842439115,45731253,5585,[LG21]Lords of Gondor
187503097,Romulus1991,21587649,29681933,179996,189776,70341,268479,2454996,193971,3177563,2648967,0,3865541525,82802393,17477,[LV21]Lords of Valinor
188255601,Ant Man21,21587050,21740037,261646,303216,192688,238972,1939567,47123,2721566,1986690,0,3143089623,0,3958,[LG21]Lords of Gondor
188838640,Presidente CIAO,21479648,3248958,61803,13150,115426,83389,268192,0,480157,268192,0,1646135218,23800000,4533,[LG21]Lords of Gondor
188878743,Jetare,21415364,15241706,984262,914090,1762279,1205895,613645,28715,4524624,642360,0,3243227991,91210728,3035,[LV21]Lords of Valinor
184817793,meto 313,21357237,2940073,2001835,184629,125724,112750,75554,72258,570915,147812,0,2985432042,1827622,1798,[LR21]Lords of Rohan
188337674,ᴵᴸAxan,21348502,13852737,908861,382486,81728,81286,1314956,6904,1867360,1321860,0,2638217826,376836150,9607,[OP1]OP CLAN
188819819,fox77778,21044659,3782562,738594,75581,204618,428450,164441,0,873090,164441,0,3335380982,1037349,4699,[LG21]Lords of Gondor
186018265,yıldırımsefa,20981632,12642300,258459,159713,850626,471324,812371,45005,2339039,857376,0,3125733481,50620184,8858,[LR21]Lords of Rohan
188889549,СЦEПИОН,20926077,2997871,1241527,21675,25683,72660,248333,8410,376761,256743,0,1923428853,102567597,3693,[LR21]Lords of Rohan
188856715,ᴸᴳJackie,20822218,14164490,284873,80252,30041,24787,1277627,60647,1473354,1338274,0,1256917551,20000000,4099,[LV21]Lords of Valinor
189036655,Vitia back 1990,20805443,9551108,2056000,172660,105414,21917,821704,50052,1171747,871756,0,2704984204,9800000,8587,[LR21]Lords of Rohan
188443825,йкйцк,20721165,48743894,1313992,1943111,2457331,1223280,2839555,507597,8970874,3347152,0,2532968576,1971457076,21172,-
188876948,Ruberoid,20524561,1308095,30041,24678,63862,55794,95226,0,239560,95226,0,1486343460,3846529,4622,[21If]Immortal Falcons
184859052,ᴸᵛamadxd1,20467182,10085592,1080886,167940,454668,303192,683338,54826,1663964,738164,0,2218718747,315992716,7116,[LV21]Lords of Valinor
184819319,joe200,20426646,2022401,1197317,130789,249677,21520,45323,47879,495188,93202,0,1631673131,91263980,5852,[LG21]Lords of Gondor
183360513,ᵀᴸмønoメ,20415868,26110591,478300,186118,247673,221163,2277659,95839,3028452,2373498,0,2125813241,85509847,6981,[LG21]Lords of Gondor
188884272,ZHIANZD,20398835,1216090,246973,127800,150740,29760,77001,0,385301,77001,0,2488342395,0,2033,[LR21]Lords of Rohan
188847403,Vali188847403,20267668,1805843,502942,88125,113717,240436,59904,0,502182,59904,0,1174440329,0,641,[_NDM]New Jersey Nol
188884453,dm152,20243575,261473,0,20838,55033,4660,12860,0,93391,12860,0,2689987569,0,4341,[LG21]Lords of Gondor
188790227,СУЛИМАH,20234807,2937806,1265520,69552,52214,89972,230812,7573,450123,238385,0,1837825253,102878721,3411,[LR21]Lords of Rohan
188325495,쵸 See La Meet 쵸,20218723,26136473,714725,1038428,1614240,1553702,1521512,63519,5791401,1585031,0,3512199870,0,7931,-
145631489,BABA SON,20125281,6791782,290848,136434,494296,267396,335994,67319,1301439,403313,0,2196134340,4400000,4912,[LV21]Lords of Valinor
188806434,ᴸᴳ Bimz,20114043,4958433,658635,38897,29786,6973,379801,53259,508716,433060,0,2977097746,29458520,9806,[LV21]Lords of Valinor
188836639,Ndiaye,20064987,5853377,660696,352077,491543,747064,181162,0,1771846,181162,0,2993737641,383503,1623,[LLA]Lost legion academia
188857113,GritNGravy,19938299,1953070,46395,39362,14347,20181,183578,0,257468,183578,0,2960218152,3200971,3742,[LG21]Lords of Gondor
188898779,kral jon snow,19901685,113087,6227,15339,20427,859,6573,0,43198,6573,0,2753058077,8327554,2900,[21If]Immortal Falcons
188539042,Chieu F2p,19761840,23706450,464904,857871,1727252,652023,1402402,172413,4811961,1574815,0,2140454407,185342934,11076,[LV21]Lords of Valinor
188903920,JoshuaSeil,19710006,5690562,817155,57531,197583,100305,445513,21377,822309,466890,0,2962909973,301497,4086,[LV21]Lords of Valinor
188261313,freezebee 21,19679730,2027071,234347,244875,375237,108803,79241,0,808156,79241,0,1764975427,5187959,14569,[LG21]Lords of Gondor
186613612,Inigo Montoya1,19649338,4781554,1455414,349831,116242,28761,403220,16593,914647,419813,0,2650048267,103076547,8567,[LV21]Lords of Valinor
189075824,NooByZ,19621709,8523920,1530004,77034,121760,128921,748617,13157,1089489,761774,0,3365718003,99259891,19016,-
191530671,ᶦᶠtMadsonn,19587054,1846035,34099,69047,86817,200703,85578,0,442145,85578,0,2649311322,910375198,4603,[LR21]Lords of Rohan
188232993,AKON311,19570367,17474104,658995,571073,531874,842388,1182997,54831,3183163,1237828,0,1770213436,850687088,12260,[LG21]Lords of Gondor
188430882,JapayuKingBILAT,19434091,13661282,558328,244614,718820,347450,1008612,34940,2354436,1043552,0,2874726772,142262581,15617,[LV21]Lords of Valinor
188814205,SUBUTAİ 38,19381196,1466044,274608,292102,181430,22696,95398,0,591626,95398,0,1967512317,3080000,2307,[LG21]Lords of Gondor
188838663,ERON,19151310,7419903,732610,190505,250716,72425,647213,5927,1166786,653140,0,2009368022,20081022,12080,[LG21]Lords of Gondor
188853064,TerrorBlade98,19142426,4698786,941546,120572,115534,39441,414286,7149,696982,421435,0,3347414105,0,1351,[LG21]Lords of Gondor
188818238,PoTaPyh,19113761,17945708,847850,488230,854873,981299,1155520,32896,3512818,1188416,0,3095818179,301072527,13039,-
188776545,ᴳᵒᵈ Ingle,19023968,1048600,93501,85140,135892,24107,66336,0,311475,66336,0,1705600669,3404666,5147,[LR21]Lords of Rohan
188845810,BARBALIAS,18899874,5080729,1177937,167048,291925,201260,352189,6827,1019249,359016,0,1731230822,0,5851,-
188869412,dân chơi đá,18877333,8228309,246570,288205,739830,1185717,194814,0,2408566,194814,0,2106256471,1154652,1641,-
188827507,Dug1man,18839630,106428,5346,18103,18794,0,6522,0,43419,6522,0,2564095708,0,2494,[LG21]Lords of Gondor
188360951,SATORUGOJO1,18509733,9398145,472927,508838,996498,575503,431459,34339,2546637,465798,0,1608865935,317828071,6697,[LV21]Lords of Valinor
187197359,Demir Bilek,18439511,9273471,779097,120768,235808,174193,781889,13102,1325760,794991,0,2226225509,30192868,11181,[LG21]Lords of Gondor
188844580,RedHoodJT,18421245,3724748,210774,117223,615129,546669,28437,0,1307458,28437,0,1683161455,0,1462,[LR21]Lords of Rohan
150165925,ᴸᴳken arok,18382647,20174751,614040,4481149,278014,115931,1646083,89897,6611074,1735980,0,2484623136,26909895,11403,[LV21]Lords of Valinor
188836606,Black AngEL,18316975,8655975,1937740,908418,995278,553139,422312,2403,2881550,424715,0,2137121812,18536152,1820,[LG21]Lords of Gondor
188367613,ᶦᶠKinkyTail,18279931,28516508,652235,1415633,750063,721224,2140908,121964,5149792,2262872,0,981796005,58186939,12133,[LV21]Lords of Valinor
188490339,Eudaimonia,18192149,5257222,227320,56910,36785,12770,453803,29158,589426,482961,0,3282164192,30962500,5644,[LV21]Lords of Valinor
188806199,Op khan,18180832,4774879,1311876,240925,827408,507637,83281,10426,1669677,93707,0,2915542925,4253716,3172,[LR21]Lords of Rohan
188336750,SKY EAGLE,18136313,7121747,985124,330019,49903,45477,677403,0,1102802,677403,0,1931799839,213802552,9588,-
189014302,magister,18034793,11593788,947900,205152,1188782,528161,695989,5133,2623217,701122,0,1327725746,15363819,7383,[LG21]Lords of Gondor
188865329,Việt hoang 07,17892195,607097,64769,419495,234049,900,5150,0,659594,5150,0,2214217502,1833721,888,[21M]Immortal Myrmidons
188884243,HiagoLira,17890453,1285899,1,5567,1871,82946,94926,0,185310,94926,0,1652055453,0,2369,[21If]Immortal Falcons
188787622,MalandrageX,17836237,20690,0,2434,1687,245,1585,0,5951,1585,0,2520328655,0,3279,[LG21]Lords of Gondor
189231766,darkkiller666,17669854,3746982,286312,236683,195194,50737,294065,8283,784962,302348,0,2533244060,20289481,14046,[LG21]Lords of Gondor
188823442,VIP shooter,17664087,3305125,846887,132688,41914,75500,277768,5754,533624,283522,0,1628641562,41800001,5174,[LG21]Lords of Gondor
188487100,Kir8,17545302,744292,46498,47082,45400,57564,41382,0,191428,41382,0,604975853,0,4410,[LG21]Lords of Gondor
190852683,BossAlien FARM,17458035,6771910,168409,19244,81805,135783,606132,0,842964,606132,0,4327213380,1694123182,2674,[LR21]Lords of Rohan
164927516,iven0007,17430317,10077159,800589,584997,950594,899393,404788,20676,2860448,425464,0,1109147513,29829009,6060,[LG21]Lords of Gondor
188904786,Shadow vahalla,17375485,951871,236630,6845,11062,4462,91053,0,113422,91053,0,2849245964,0,3016,[LG21]Lords of Gondor
187016834,ƐƘÁ,17265849,5969476,107689,89142,174787,122716,511121,0,897766,511121,0,2780045748,1489060086,4803,[LR21]Lords of Rohan
196566747,Codrin4Valhalla,17255393,5520581,195320,259178,157063,124705,407586,28997,977529,436583,0,653908880,89594454,6222,[LV21]Lords of Valinor
188368666,Derik 災,17193465,17311218,78795,189202,156137,96806,1633226,12081,2087452,1645307,0,1504456225,57910439,4670,-
188879533,Qertt7,17150934,188791,322,8039,23990,816,10230,1682,44757,11912,0,4108027598,38000000,2162,[LG21]Lords of Gondor
188585266,メDragønメ,17046256,6200803,260935,13008,75292,24207,548489,23295,684291,571784,0,1565973095,73489482,19339,-
188503741,SİYAH KAZ,16994656,2745204,35926,148261,185391,246920,121345,7182,709099,128527,0,1557000457,38351774,6878,-
189068044,Hsotits7,16858908,13123610,995230,966771,1440390,1040579,499742,44487,3991969,544229,0,2147478444,16241240,3444,[LG21]Lords of Gondor
188928573,Thànhteo,16834657,1269484,231737,5214,47138,152454,56435,0,261241,56435,0,1518718910,0,3090,[21M]Immortal Myrmidons
188824641,Sabesaur312,16783039,178017,72,61605,21023,10955,7983,0,101566,7983,0,717328751,0,1962,[LR21]Lords of Rohan
189181702,222mb222,16597760,2096107,769471,199359,63662,40288,176776,0,480085,176776,0,3107113093,225401626,1736,[LR21]Lords of Rohan
188845980,Azadi,16588599,2414584,591878,280392,474111,105066,99002,0,958571,99002,0,1862936476,3366983,1071,[I-am]RoyalLoyalMembers
188868206,Quocbao05032012,16690136,1765350,652703,140343,12908,5049,169127,0,327427,169127,0,1755879714,6000000,2032,[LR21]Lords of Rohan
188432088,BandAid,16542227,6291099,303434,23738,88926,146960,503492,24287,787403,527779,0,3037430058,308659606,8325,[LG21]Lords of Gondor
188861925,blackbandito,16481925,3299236,432177,181283,407143,143151,130863,28373,890813,159236,0,1526293923,24105565,1989,[LG21]Lords of Gondor
189579148,стратег,16475452,2439007,1269763,90576,272116,146355,125592,1766,636405,127358,0,2309890690,1378833,2187,-
188833114,Quent2,16410336,22825032,342325,313030,76329,372177,1910364,100871,2772771,2011235,0,1466991534,21298007,10358,[LV21]Lords of Valinor
188513738,MooSáke,16290580,198927,96089,15385,14235,12870,11590,0,54080,11590,0,1806047091,0,1221,[RC21]ROYAL CROWN
188894198,Tomioka senpai,16282544,379272,52185,4153,47557,61967,3546,0,117223,3546,0,2594090647,0,1810,[21If]Immortal Falcons
188852196,DarkExecutioner,16177458,1452447,100617,60616,84044,164244,61526,0,370430,61526,0,1216662089,28060602,1834,[TFS:]The Forsaken Souls
188823187,AZERBAIJAN90,16127248,891992,1273713,78632,32607,42323,49764,7206,210532,56970,0,2188918647,3040,1275,[~AKT]BR AKATSUKI
188876717,DEWO YEAGER,16028026,4619081,1089416,433008,785790,289890,180134,0,1688822,180134,0,2470473133,0,1755,[21if]farm 21If
187880560,wcwc,16017764,230115722,1527635,19485000,18674475,23053443,9591814,36893,70841625,9628707,0,3214040764,596448438,13547,[21if]farm 21If
188376429,ᴵᶜmySoul,15838205,447638,94861,165290,199177,4054,1,0,368522,1,0,1311135078,7488905,8465,[LR21]Lords of Rohan
188436016,KiLLedYouhaha,15787565,6307690,234650,186713,224968,166558,470080,22669,1070988,492749,0,2621616940,115055118,9901,[LV21]Lords of Valinor
188134384,ˢ carlossainz,15679684,6601011,1300774,21788,65922,52235,498539,63524,702008,562063,0,1190118090,25406959,4002,[LG21]Lords of Gondor
187078010,Dr4gonsFarmerツ,15490724,22163921,1316246,641729,1799365,1256244,1338903,1142,5037383,1340045,0,2602487365,1725005764,7887,[LG21]Lords of Gondor
188825941,S0SKA,15447745,1189854,237525,181770,115056,123932,42766,0,463524,42766,0,1573181792,17191302,2471,[21M]Immortal Myrmidons
186073361,卂尺丂Farm,15335269,3668107,345837,39537,204145,32135,312337,0,588154,312337,0,2285339693,489706596,1514,[LV21]Lords of Valinor
188878343,Cheiron City,15325813,2006372,65708,76640,299335,127026,88427,0,591428,88427,0,1356102538,0,1660,[21if]farm 21If
188809474,Edgar15,15275743,46285,13168,43659,11087,2650,478,0,57874,478,0,2116886110,0,1245,[21M]Immortal Myrmidons
188879219,Akglate,15231878,247677,40137,19567,121882,0,0,0,141449,0,0,2071709078,1758755,592,[LR21]Lords of Rohan
188857667,Apoathou,15231019,1322660,1124764,128214,19733,13903,120194,0,282044,120194,0,230139173,156690,1083,[LG21]Lords of Gondor
188877463,Se Tuath De,15075919,1904865,811661,93157,158781,182383,83914,0,518235,83914,0,2524851503,5600000,2408,[LG21]Lords of Gondor
188825002,Namiq Cebrayilo,15055158,3934535,1259596,213707,290110,151386,270603,0,925806,270603,0,2191291981,0,728,[21MA]Myrmidons Academy
188781490,Fra1d,14963604,1187031,100258,39857,116341,94712,56753,0,307663,56753,0,1220961083,5509155,3143,[LG21]Lords of Gondor
186035363,Klgi20,14959382,1079100,1084576,54111,135908,7883,18115,29189,245206,47304,0,1879204762,1200000,3130,[21If]Immortal Falcons
188281290,1GuiltyCrown1,14978186,19247655,1007323,1096697,1425467,992963,1183957,18298,4717382,1202255,0,3433156808,1967206382,17104,[LG21]Lords of Gondor
190329472,F1Quang,14950027,14222941,1403680,76015,288128,303523,1225945,7897,1901508,1233842,0,3934523953,2734670795,8478,[LR21]Lords of Rohan
188858878,lisabella,14945370,237752,277117,67710,112105,0,0,0,179815,0,0,576756411,0,1611,[21M]Immortal Myrmidons
187560016,Kyubi Farm1,14904977,43242083,1156562,1634869,1976614,1528733,3245429,19633,8405278,3265062,0,1348799318,409430369,6745,[LG21]Lords of Gondor
188800436,LilPiglet,14883468,769658,220953,34240,152043,47076,27042,0,260401,27042,0,1368811506,0,1294,[LR21]Lords of Rohan
188365295,ᴿᵃTsumiki,14849316,2089406,0,8924,38778,19749,193107,0,260558,193107,0,1063300942,3762398,6032,-
188785649,priam,14836043,1750608,803133,48303,27617,11291,164055,0,251266,164055,0,1478904072,18007168,327,[tgqm1]amarl
189036275,TheBlackDragon,14821976,163506,24134,22964,32186,14353,3713,0,73216,3713,0,2038941597,0,1768,[LG21]Lords of Gondor
188963486,GÖZTEPELİ35,14745890,131575,0,26938,85,5222,10513,0,42758,10513,0,1956299993,230887100,3805,-
183848200,Ei Farm,14731064,38195393,1298931,2526718,1320489,1044558,2973860,56612,7922237,3030472,0,3111047090,519374881,13485,[LG21]Lords of Gondor
188802524,Yamato68,14691167,193221,131028,1699,7453,9839,13862,0,32853,13862,0,1212242357,13257436,2989,[LG21]Lords of Gondor
12113325,Elena23EV,14659557,1817847,131418,8455,10921,55191,154067,1644,230278,155711,0,1126312728,24431024,5756,[LG21]Lords of Gondor
188863496,dark8582,14638594,408222,113485,9062,63839,37988,12678,0,123567,12678,0,1891896881,0,709,[jk10]jk 3621
188986083,KyoHN,14555644,58505,16806,10125,15173,711,2329,0,28338,2329,0,2332123310,69,2859,[LG21]Lords of Gondor
188796842,Menda2137,14375615,321687,136804,21106,48638,8855,18477,0,97076,18477,0,1116877840,0,1470,[LR21]Lords of Rohan
188873290,FarmЛиса,14323510,5775194,596991,64191,23711,6956,553801,7455,656114,561256,0,1478137049,122800001,4161,[LG21]Lords of Gondor
188287771,ᅟᅠᅠᅠᅠᅟᅠᅠᅠᅠ ᅟᅠᅠ,14215865,55138144,428726,330732,673936,319444,5244635,0,6568747,5244635,0,5021566925,2212968833,28881,[LG21]Lords of Gondor
188885945,whyreall,14191004,1427513,1410059,61686,45602,10688,128122,0,246098,128122,0,1497367838,862617,2035,-
188858305,Palestine313,14180310,3028033,1334422,129577,527939,188640,119168,0,965324,119168,0,1399529134,0,4,[Alg]Palestine313
188806889,Gouverneur188806889,14150447,785370,316714,61610,182543,80923,8427,0,333503,8427,0,1087891811,0,1024,[21MS]Myrmidons Farm
188847086,Dimiboy,14108947,75311,0,179,37638,0,0,0,37817,0,0,1226639823,0,24,[Tick]Tick tack
170835406,ᴵᶜ Has,13955620,1445859,679890,46009,32626,7559,101847,16135,204176,117982,0,687055286,298517,2940,-
188931757,ᴸʳANTHRAX,13954350,659165,84307,164935,187652,32931,11915,0,397433,11915,0,1411138221,0,2100,[LR21]Lords of Rohan
188856535,HOIANA,13931152,1190153,693357,435295,160981,54643,43890,6183,700992,50073,0,1783231108,400000,1173,[21if]farm 21If
188832666,ChifOJ,13901330,2361104,125471,94442,41533,55215,203829,0,395019,203829,0,2551589361,0,538,[21IR] Corral
188896546,БорисBao,13857624,1182765,168254,14668,118405,170863,25957,0,329893,25957,0,1761224189,22966398,1423,[LR21]Lords of Rohan
188953179,SarahVinyard017,13756390,5795264,260817,103502,87804,304494,438098,0,933898,438098,0,1388844714,31860199,3832,[LG21]Lords of Gondor
191177358,RtthyrFarm,13669046,52258,8925,14892,0,0,4928,0,19820,4928,0,3553012413,1594265331,1144,[LG21]Lords of Gondor
44936497,젝스킹,15991483,6996924,923387,39204,54846,41378,523118,74135,732681,597253,0,2183506756,0,9052,-
188787790,You  andl,13480002,920284,416012,51124,134014,82128,31352,0,298618,31352,0,1347580273,4084888,1943,[LR21]Lords of Rohan
187795145,SOTER,13387632,8447735,539910,529189,65018,309343,652149,22650,1578349,674799,0,1281516203,112215799,15283,[LG21]Lords of Gondor
188837379,안정아남자,13284800,885792,199719,262430,137821,8581,52334,0,461166,52334,0,1867388126,0,1110,[LG21]Lords of Gondor
191069538,Shinnygamyy,13259416,3037148,499817,235031,755080,228183,56725,0,1275019,56725,0,1083252012,5089962,691,-
187257305,HolySpirits,13221458,4186335,271743,116035,83670,59317,375642,105,634769,375747,0,1164962213,477259605,5804,[21If]Immortal Falcons
188836866,zlucifer,13134321,2684582,271491,220751,328964,145856,139908,0,835479,139908,0,1701695970,0,1524,-
185484265,Tors228,13083005,7740094,636018,1305674,1878812,627539,120762,178,3932965,120940,0,1312958755,25325363,7376,-
188887466,Jensamtresen,12961460,2851467,834974,287219,392239,254799,99035,0,1033292,99035,0,880825536,10799999,842,[I-am]RoyalLoyalMembers
193596249,Korkusuz 51,12958052,239160,358859,12402,0,0,23668,0,36070,23668,0,1401609699,60357336,943,[LR21]Lords of Rohan
188817273,Munmon,12901737,1116310,211912,39551,42589,125343,52185,0,259668,52185,0,2476678488,0,125,-
188845348,ᴸʳLUNICTUS,12877100,104914,26926,6884,16888,8978,3385,0,36135,3385,0,1558632979,0,455,[LR21]Lords of Rohan
188291209,ROCKS  D  XEBEC,12853105,3694092,969555,42334,42629,46712,328702,6325,466702,335027,0,1822462533,37349860,9225,[jk10]jk 3621
190539451,puyolF,12822606,972686,309560,2673,66571,105265,41795,0,216304,41795,0,4692843854,1818372170,2043,[LR21]Lords of Rohan
188292201,쵸Bear,12762411,3636617,863462,127956,652623,13205,183272,21012,998068,204284,0,1398516677,0,8400,-
123456386,Igoryan,12754826,5049921,193112,1352415,222892,143876,374139,838,2094160,374977,0,1383427993,11392165,1331,[LG21]Lords of Gondor
188899884,hanaaaa230,12638115,3656113,993138,112016,538707,284659,141766,0,1077148,141766,0,1488332280,3785937,1108,[K~R~]3621 Utility Box
192581999,LilitЛиса,12443530,4099267,2586,4079,12074,27936,396256,0,440345,396256,0,2095084381,534525710,3611,[LG21]Lords of Gondor
188986347,Pimpammm,12386241,390745,21517,13926,70135,29655,12907,0,126623,12907,0,1444868924,9172286,4484,[OP1]OP CLAN
189266244,ᴵᴾRágnär,12376390,2424921,681640,338989,350984,104124,70352,26757,891206,97109,0,245500638,11642489,7444,-
142371438,NokedliF11,12302691,3005981,754566,516818,830716,67154,61715,17771,1494174,79486,0,1496304971,2400001,10465,[21M]Immortal Myrmidons
188816893,WARRIOR FARM 10,12314581,242793,17769,22009,47558,10254,10226,0,90047,10226,0,1311205884,0,1891,[21If]Immortal Falcons
178904209,MorFarm2,12182432,243458,0,0,0,3117,23099,0,26216,23099,0,1692919713,335244116,803,-
188829162,Mkジinsane,12152527,911799,856240,15867,56941,24326,65024,2360,164518,67384,0,1543783586,1400000,3486,[LR21]Lords of Rohan
190430624,IMPERADOR FARM,12116350,449281,436505,3716,0,322,44725,0,48763,44725,0,4833868024,2527734725,1573,[LR21]Lords of Rohan
187384799,C H A D 3 3 3,12107731,5025006,638494,336794,550030,58137,356220,3142,1304323,359362,0,949161263,0,4534,[LG21]Lords of Gondor
188880051,qftydhunvfezbjj,12100235,18338939,1337013,1249255,1030656,1111224,1086802,35743,4513680,1122545,0,1422326310,88951930,7822,-
188900034,Rajpoots,12010313,854381,223016,55556,81433,13291,62724,0,213004,62724,0,1882519435,0,3113,[LG21]Lords of Gondor
185259121,Lets go Os,11986214,913938,1168728,282,16846,7330,13445,35821,73724,49266,0,1375527451,4800000,1579,[LG21]Lords of Gondor
188217778,ᴵᴰKing Nemo,11974922,1852509,716667,684238,272077,322,117022,0,1073659,117022,0,1857331281,0,12936,-
188479340,ㅡᅟᅟF2P 8      ㅡ,11903171,9974813,173571,883535,766581,262971,721306,0,2634393,721306,0,2727573921,956471741,8847,[LG21]Lords of Gondor
188838338,boble 79,11892832,306757,46338,1697,52760,41937,3315,0,99709,3315,0,1278554670,0,2120,[21MA]Myrmidons Academy
188952266,ErDegui,11875134,7108681,230822,125436,58773,125367,620570,12944,943090,633514,0,1173596936,13045768,5398,[LG21]Lords of Gondor
188946350,BaabyyKiller,11764448,45777543,823248,1480408,3397133,2896319,2635750,37221,10446831,2672971,0,1760569996,20189360,9196,-
188819203,Cominogr,11711027,347521,71452,268238,123679,11074,222,0,403213,222,0,1681656087,0,850,[ANTB]ANnti Banned Club
187155907,Yuzhi,11683933,5032590,1641848,115533,189407,294655,290433,27386,917414,317819,0,2050535544,257605,2023,[LR21]Lords of Rohan
188887462,Dunks,11595270,1538565,760926,36818,198678,122594,64347,0,422437,64347,0,1107672787,0,1041,[LR21]Lords of Rohan
188801943,Brunk100,11490847,938220,200395,171290,279130,31043,22153,0,503616,22153,0,1330342807,2513093,2827,[21If]Immortal Falcons
188900167,Charles grand 3,11487743,4207791,779277,591939,722430,168606,197012,0,1679987,197012,0,1787172574,8400000,916,[Tick]Tick tack
188363322,쵸Belmont,11471499,726781,18931,225245,250029,43961,583,0,519818,583,0,1185584888,1410552,11058,-
185877603,ㄴ Aurelio ㄱ,11433632,3426162,734268,194294,519109,17374,220713,3623,955113,224336,0,918025985,1758080,3483,[LG21]Lords of Gondor
188892262,Udi lopez,11379319,286475,30519,120358,27289,7419,17815,0,172881,17815,0,259364387,3001045,1839,[21If]Immortal Falcons
188856725,Uranusuki,11348687,268914,32838,25630,66282,25841,2786,0,120539,2786,0,844045505,3859996,729,[LR21]Lords of Rohan
188818543,GodAnubis,11339729,3265470,842158,347813,333503,280538,140675,0,1102529,140675,0,1229297399,473118,750,[21IR] Corral
188885079,ᴵᶜnoobhuhu,11287294,4932153,869902,263679,640053,58918,316980,9692,1289322,326672,0,1694858992,26599999,5002,-
188840730,FurkiTolki,11203133,1839593,1140153,3217,12856,72657,143339,4461,236530,147800,0,1684592274,3600000,2038,[21M]Immortal Myrmidons
174523518,ㅡᅟᅟF2P 5      ㅡ,11201649,3700033,325966,825415,1309771,123637,42086,0,2300909,42086,0,2253587245,828382628,2421,[LG21]Lords of Gondor
184327666,ツاحمدᴰᴮ,11162905,2653497,532046,681079,488185,101508,87684,12902,1371358,100586,0,1444273934,72130,2247,[LV21]Lords of Valinor
188307234,ᴵᵀJessyS2,11159564,3418968,138406,130180,168640,9783,301652,0,610255,301652,0,1509177777,180913621,6306,-
188818957,alonsoisma,11107567,2300239,762386,25316,47973,75270,189815,0,338374,189815,0,1543844193,4826393,1412,[LR21]Lords of Rohan
188840453,La pampara,11064953,4065536,1018214,200050,433845,478194,124506,0,1236595,124506,0,1495998828,0,316,[21if]farm 21If
189182502,ᴵᶜVatson67F,11047173,137197,213594,1669,4693,617,12501,0,19480,12501,0,3490638671,1724148322,1606,[LR21]Lords of Rohan
189443468,Hubey,10948714,2171604,462536,189562,257421,35910,147521,0,630414,147521,0,918945909,0,1967,-
188320795,Fïshböy F1,10904017,1130852,410313,146172,398,5918,103727,1994,258209,105721,0,1523325888,649927741,1105,[LR21]Lords of Rohan
189007908,vua đại du,10847143,2010095,594035,32817,68882,36737,135324,18279,292039,153603,0,1664459657,27506603,6095,-
188309795,ᴵᶜ TAZIEX,10844048,8618161,951227,435439,559362,399095,559725,10936,1964557,570661,0,1632163083,0,8839,-
188839518,Zaragoza,10687289,1181120,88062,120100,376712,100919,0,0,597731,0,0,1424532659,0,1140,[LR21]Lords of Rohan
188817859,oktaev,10720401,401425,359467,33669,31021,2770,32157,0,99617,32157,0,1089734555,0,100,[DD21])Dragon of Death
188847841,Lj1208,10594812,314850,314434,984,0,1961,30681,0,33626,30681,0,1172899928,0,904,[21If]Immortal Falcons
188889920,Carolk,10405243,642390,541227,49383,96269,35954,29616,0,211222,29616,0,1157076734,1349311,322,[fagr]alpha table
189182788,Vatson67f3,10398500,260412,485136,2684,4031,13106,19939,0,39760,19939,0,3482159593,1133268751,1357,[LR21]Lords of Rohan
117517315,ᴵᶜBOTAN,10360428,13712356,945529,506093,1444925,965222,611992,37024,3565256,649016,0,1235813199,498018246,20006,-
188522411,Ваn,10346788,1095208,3365,36724,120447,26500,74097,0,257768,74097,0,727419882,1,2219,[21If]Immortal Falcons
189442766,Gubernur189442766,10339474,77204,41779,1313,9937,12737,612,0,24599,612,0,2520471159,1989430704,711,[21IR] Corral
195403312,môngcổ,10320907,1446809,783623,85946,65345,87040,95077,0,333408,95077,0,1263576129,0,1035,[LG21]Lords of Gondor
188295840,ッ Yakuza ッ 6,10205094,395204,0,3871,70818,40591,9043,0,124323,9043,0,992758872,82882904,4847,[21if]farm 21If
188721766,ᴵᶜZver225,10146168,5600948,578427,272790,772945,368830,252518,0,1667083,252518,0,1282562432,205403656,7602,[LG21]Lords of Gondor
188899095,Minuz,10121073,1614469,364375,167345,306671,102167,55899,0,632082,55899,0,725671492,0,1695,[LR21]Lords of Rohan
188906315,ᴵᶜИвaн,10139924,1248369,45240,148765,274837,58418,43527,0,525547,43527,0,943901017,16348226,12804,-
188881481,678907,10095713,4054167,576543,566707,812285,378314,80300,0,1837606,80300,0,1236810461,53227,1515,[LLA]Lost legion academia
189285062,Linh farm 2,10094068,9739359,1413236,1086939,10938,8479,938116,4251,2048723,942367,0,5464879984,3128768761,1821,[LR21]Lords of Rohan
194265891,쵸MØTÃSÊMツ쵸 2,9806402,2255805,0,5126,24684,21098,212102,0,263010,212102,0,1447150424,125453620,1392,[LG21]Lords of Gondor
188840603,andyrendy,10073872,1722850,894100,10373,99042,247058,53446,0,409919,53446,0,1032365452,0,459,[Slon]Slonii
188300029,Hoàng Saa,10070250,5137975,463048,87026,120041,279872,368510,3795,859244,372305,0,1274097661,9873378,8150,[LR21]Lords of Rohan
188857096,Di 1,10019335,909985,10470,103819,160058,85834,22577,0,372288,22577,0,934774982,1843151,2952,-
189869613,Алёнааа,9878154,3146615,691598,31047,82951,360086,153416,0,627500,153416,0,1475255043,503089664,1095,[GW21]GOATED WARRIORS
188898591,Dthomas,9838220,468487,81006,125157,122286,22516,10882,0,280841,10882,0,434478065,0,1343,[LR21]Lords of Rohan
188471943,NoCoboY,9816138,413116,95171,64153,54918,15880,22693,0,157644,22693,0,1081418218,0,3619,[LG21]Lords of Gondor
188846435,psilva3,9800195,1390439,255473,331056,379662,122656,7428,0,840802,7428,0,944653382,0,584,[21IR] Corral
189915380,BJXXX,9760666,4168395,1002299,38629,16464,369203,265093,0,689389,265093,0,1412603784,0,1632,[LR21]Lords of Rohan
191785327,ᴿᵃQueen,9625702,3017237,247312,228656,300820,10824,232657,0,772957,232657,0,2123392947,813781963,1187,[LR21]Lords of Rohan
186988267,Panda ᴸᴺ,9616784,2766515,1120377,7927,2980,11995,264463,3318,290683,267781,0,3082740466,512115698,1981,-
188962647,卂几Ҝ卂2,9578262,2082291,325396,3405,6149,30163,194866,0,234583,194866,0,1618176948,1219440595,2004,[LR21]Lords of Rohan
188815675,KōbøLord,9517898,145859,16647,15805,9235,19277,4712,0,49029,4712,0,843374303,0,1696,[LR21]Lords of Rohan
188790900,Dom Daddy,9512009,3388766,1222043,27914,83403,91562,276497,4258,483634,280755,0,1773010253,0,1445,[OP1]OP CLAN
186065635,MASONFTW WOOD,9501931,1910931,810165,6189,9403,5772,186780,0,208144,186780,0,1676823126,950725213,1283,[LR21]Lords of Rohan
188844276,tori,9424138,213019,54967,3007,1985,1182,20372,0,26546,20372,0,486406302,0,915,[21If]Immortal Falcons
188308863,Rock Farm ll,9385339,10088421,459789,450027,1066779,575927,546551,4782,2644066,551333,0,737133728,45352280,6170,-
