ID,Name,Power,Killpoints,Deads,T1 Kills,T2 Kills,T3 Kills,T4 Kills,T5 Kills,Total Kills,T45 Kills,Ranged,Rss Gathered,Rss Assistance,Helps,Alliance
179940560,ᴸᵛ ink,103385651,681650959,4362036,2922076,868211,971623,40507037,13518663,58787610,54025700,0,6146364316,1873979817,82059,[LV21]Lords of Valinor
186145908,ʳᵉʸEscanor,88451131,1531431354,3712561,4661820,915441,1734412,126562596,12805225,146679494,139367821,0,3557058467,4498233340,22608,[LV21]Lords of Valinor
188540500,TakeMe2Valhalla,85185190,1461585640,5178385,12805473,5652155,10639829,107845040,16335526,153278023,124180566,0,2834280658,7101247251,44789,[LV21]Lords of Valinor
180304933,LilLƴ,80869163,324306462,3362990,2782862,2764385,3236435,18035808,6245865,33065355,24281673,0,1171579249,5020554697,22431,[LV21]Lords of Valinor
188858506,Cúchulainn 쵸,76677389,266615990,1972640,936833,278745,498321,23379991,1503897,26597787,24883888,0,5102514815,552651627,38056,[LV21]Lords of Valinor
179655012,ᴸᵛDØØPER,74314095,561651625,2663421,2667918,973558,1257919,36144409,9634758,50678562,45779167,0,8493153297,1491282008,38554,[LV21]Lords of Valinor
178695066,SokoDrake,67286658,126212966,2755706,1295551,106206,148891,9230362,1642113,12423123,10872475,0,7985205355,115903540,17702,[LV21]Lords of Valinor
180560115,TripEhh,63377625,426887247,1462944,2776979,822023,695354,26535253,7827693,38657302,34362946,0,6691953276,1225250480,11319,[LV21]Lords of Valinor
184964288,ᴾᴿFïshböy,62165673,277723981,2109563,2057085,4656295,3958131,21143365,2036690,33851566,23180055,0,3506845070,632742525,39180,[LV21]Lords of Valinor
179977300,ᴸᵛTmulla,60993890,803546821,1802631,3860548,420787,1492407,45345975,17125188,68244905,62471163,0,6986046478,5600679937,17714,[LV21]Lords of Valinor
186009654,Dooby ᴼᴺᴱ,59939402,324804278,750717,2581671,360853,500752,29376559,1389882,34209717,30766441,0,7620039329,137216122,35834,[LV21]Lords of Valinor
188839265,A 10 Warthog,58345185,12765610,230642,42253,74269,128873,1010827,99243,1355465,1110070,0,3752959523,754780894,11287,[21M]Immortal Myrmidons
188341936,ᴸᵛ Vatson67,56135392,287737986,1695197,1362222,557828,606199,24635915,1878297,29040461,26514212,0,6610549920,384720155,42360,[LV21]Lords of Valinor
188918989,ᴼᴸ Kaymo,55130631,125177460,1092879,2484352,1386449,2529103,10279320,449904,17129128,10729224,0,3808277288,1075163587,41664,[LV21]Lords of Valinor
178814644,ᵁʷᵘØtòt,55109959,444858744,3140400,18550973,3385819,2356133,31505688,5494775,61293388,37000463,0,2295222519,2329433716,15901,[LV21]Lords of Valinor
185836736,ᴸᵛMasonFTW,51732611,485003885,2396695,5724465,2218733,4779924,39893831,3068176,55685129,42962007,0,3370836894,2802859223,28969,[LV21]Lords of Valinor
182514982,ᴸoᵛeSalmon,51748070,440128775,3085731,17974387,656722,752616,30368903,6426048,56178676,36794951,0,5510962390,1060488180,53418,[LV21]Lords of Valinor
186985518,HornyAPOLLOS,50867130,234761996,1473165,2933292,1516250,3177802,19826269,1008447,28462060,20834716,0,2765686504,594947984,18426,[LV21]Lords of Valinor
184871937,ScazBigLion,48290328,1217022721,4527691,56591135,23364142,26120855,94350903,5549188,205976223,99900091,0,5925433539,13704268108,20876,[LV21]Lords of Valinor
181825355,ᴸoᵛePUMA,48241412,240010212,1420218,1482144,360220,537196,17243018,3220719,22843297,20463737,0,3290251532,3599759382,35621,[LV21]Lords of Valinor
142628224,Dae jang goon,48057619,179520430,2398902,2082564,718074,369855,14260849,1678993,19110335,15939842,0,4945706185,102794418,17107,[LV21]Lords of Valinor
180060983,ᴸᵛRumRamsey,47423651,387640592,2382213,115868081,5049133,993080,28315165,3362237,153587696,31677402,0,6136282146,417518493,94477,[LV21]Lords of Valinor
181308342,ᴸᵛRockSolid,47260848,198921326,2758682,2730982,709675,1442730,13502684,2807901,21193972,16310585,0,3444680603,6082949920,41228,[LV21]Lords of Valinor
188920797,FreyaFullBosom,46233327,99123612,1770390,1816612,953713,1153116,7898510,662765,12484716,8561275,0,3629223743,1323334617,24321,[LV21]Lords of Valinor
176994964,Cpl Rage,45876550,114315818,476905,2377013,1506916,2122761,8943256,645149,15595095,9588405,0,1910844064,63265830,17140,[LV21]Lords of Valinor
185808036,Ze Bosh,45657049,324557669,903869,8598579,2626646,3862918,28938009,637645,44663797,29575654,0,5524831742,631820319,29935,-
179750493,GuiltyMahiru,44687192,178254190,985885,2932954,770432,1180564,15194120,973164,21051234,16167284,0,1495429337,2025360302,40649,[LV21]Lords of Valinor
184826667,ᴸᵛAHERUS勇,43681673,521670901,1451476,12792266,5953573,11242333,44861419,681089,75530680,45542508,0,5975829404,1446853955,25090,[LV21]Lords of Valinor
182423962,シValkyrieCillaﾒ,42654191,120341311,1875411,5641345,823181,711090,9251166,1110533,17537315,10361699,0,5106333590,1265202822,15210,[LV21]Lords of Valinor
179813923,ㄴ Bless ㄱ,42386817,240425339,2185386,7761519,5947505,5144214,19145711,747203,38746152,19892914,0,2510066541,978016636,23550,[LV21]Lords of Valinor
181739549,kylinn,41829522,97526701,3321903,2389177,278410,278364,6880327,1328766,11155044,8209093,0,5128390117,10337862643,31310,[SFIS]Sky Fighters
185690465,Dictator  Goat,41354516,357451228,2170212,6092140,2162244,1318953,32521920,1070665,43165922,33592585,0,6157374850,1005155698,35122,[21If]Immortal Falcons
188241812,Gilgamesh2323,41157034,116195525,858128,24225859,200187,260810,9803864,593405,35084125,10397269,0,5146560109,62620586,25618,[LV21]Lords of Valinor
188969478,ᴰᴹMePaul,40727304,97245091,983206,1953068,3290337,2573561,6772996,612480,15202442,7385476,0,3728264880,278578838,3621,[LV21]Lords of Valinor
187247613,Queen Padmé,40618530,215127774,3313856,4426292,2996263,4013920,16994131,1112650,29543256,18106781,0,7719232591,4648542203,87654,[21If]Immortal Falcons
188785515,Johnvin,40606346,174407938,1722271,874780,509812,1100372,15012445,934371,18431780,15946816,0,4975397155,93446315,57289,[LV21]Lords of Valinor
188976136,ᴸᵛ MUSE,40440512,103172900,1197849,2081810,2348513,921788,7997488,719874,14069473,8717362,0,5187023603,365719425,48341,[LV21]Lords of Valinor
188483360,ᴼᴸTryxan,40370243,200408316,1209835,21229570,2837205,2706913,15624592,1170721,43569001,16795313,0,6127793861,2169436768,40513,[LV21]Lords of Valinor
187423027,ᴸᴳPandaFr3d,39596152,189731110,2048263,1957321,794040,914974,14674257,1867455,20208047,16541712,0,2849115211,6820681844,26299,[LV21]Lords of Valinor
188485523,ᴸᵛIMPERADOR,39301586,197545856,1007660,600362,31074,81329,16036994,1833419,18583178,17870413,0,6289148825,281752989,37134,[LV21]Lords of Valinor
185282531,Annıɛ,38631309,45496988,2695521,469962,132883,175975,4001273,221030,5001123,4222303,0,3456998437,592793562,26285,[LV21]Lords of Valinor
179816952,Hell CAT GTR,38256903,59843748,2896557,79058810,1765741,1889101,2614652,339879,85668183,2954531,0,5512842125,1636698071,10894,[LV21]Lords of Valinor
185457048,Cman9918,38231477,133602129,1160939,3704156,1184975,873737,11641776,528932,17933576,12170708,0,1996001700,126071365,16769,-
188882878,Rtthyr,38184769,107307105,991223,260295,107586,120751,9151957,751865,10392454,9903822,0,7484933564,93046400,19603,[LV21]Lords of Valinor
187726069,ᵀᴿvSpryth,37872522,76673179,799478,1374927,170605,364206,6595930,432043,8937711,7027973,0,5513922935,15763287,23778,[LV21]Lords of Valinor
180368631,ᴸᵛWinfields,37785075,165249366,4670313,23224274,189123,611409,12141439,1818312,37984557,13959751,0,5256423063,1877834074,13839,[LV21]Lords of Valinor
178213242,ᶦˢLOCOOZ,37722098,140178485,3850546,2141345,957035,1554554,8372481,2394656,15420071,10767137,0,4390835929,1274602396,22115,[LV21]Lords of Valinor
186199010,Daphneᴵᴿ,38405411,210761372,1799605,1835853,1275812,3351467,16150625,1646523,24260280,17797148,0,4195380537,1498857670,55836,[LV21]Lords of Valinor
188651683,Sol Aliyaa,37587264,12784707,140221,119895,49805,35722,1148147,51838,1405407,1199985,0,3972576272,201676244,15635,[LV21]Lords of Valinor
188303104,HokieHighlander,37284273,81119850,1521401,364892,109840,71088,6718226,668029,7932075,7386255,0,1076306741,84975248,13686,[LV21]Lords of Valinor
186765655,KönigsKlãsse,37156467,221850996,1053404,2222751,1369298,1901810,18589133,1258464,25341456,19847597,0,3618729301,407789115,8594,[LV21]Lords of Valinor
188569749,ᴵᴾEndoloris,37018743,135932617,1872172,1390988,2616276,1563397,10769220,823804,17163685,11593024,0,1822151378,163440000,5369,-
189060019,Tušiš,36822506,89666855,811530,787015,636628,1052564,7629778,386408,10492393,8016186,0,2979545162,572362598,20590,[LV21]Lords of Valinor
188648613,Känguruᴵᴰ,36553614,25538784,340214,377701,272323,171077,2091875,165777,3078753,2257652,0,2953884233,286935074,13516,[LV21]Lords of Valinor
188880730,ᴸᵛMarlone,36479823,148209496,1942492,485972,373109,200006,12467842,1094382,14621311,13562224,0,5980958157,136720000,45273,[LV21]Lords of Valinor
188789133,MiniMe,36406948,41987631,345200,260258,224998,167551,3776334,152602,4581743,3928936,0,5030894460,34179151,11910,[LV21]Lords of Valinor
188805469,BossAlienᴾᴴ,36337961,69990201,1238059,250538,604492,927660,5961291,270378,8014359,6231669,0,5020720832,134750966,39904,[LV21]Lords of Valinor
189072394,ᴵᴾLaura,36300378,51126391,1312098,15223045,383206,780510,3891089,264122,20541972,4155211,0,6326675872,362529904,27434,[LV21]Lords of Valinor
188333348,ᴷᴺLinh,36175593,69285283,935539,1902695,1645656,5139453,3850216,327673,12865693,4177889,0,4936564831,550111352,11060,[LV21]Lords of Valinor
188276623,ᴸᵛArork,36008926,91915549,961128,7304379,1269333,1365737,7613004,316151,17868604,7929155,0,3845975222,360935366,16733,[LV21]Lords of Valinor
189065897,W3llsFargo,35882202,36866964,662685,1191313,898257,213767,3194692,101510,5599539,3296202,0,3960371377,2754424297,19007,[LV21]Lords of Valinor
182338045,亗ƧHiꟻT亗,35311525,150628524,1131937,2662150,1006449,1312309,10247812,2017792,17246512,12265604,0,5553885255,2545586970,32792,[LV21]Lords of Valinor
185048534,Han Sansan,35216347,144105618,853739,946281,342096,539590,12797161,655110,15280238,13452271,0,6159202955,357367305,32310,[LV21]Lords of Valinor
186444772,Dr4gonツ,35060514,285159549,3281912,5828115,3526172,4284923,24628349,675920,38943479,25304269,0,5343190068,4367255328,39583,[LV21]Lords of Valinor
188794709,ᶦᵗˢᵘRYU,34638517,108957954,998511,1318150,2549412,2529700,8680888,333391,15411541,9014279,0,3739476927,94094214,35821,[LV21]Lords of Valinor
185341770,ᶜᵘRalfish,34569150,60399425,2577295,843215,394122,498537,4521775,611532,6869181,5133307,0,2694197853,25760000,16026,[LV21]Lords of Valinor
185089489,ᴼᴾZOROGRANJ,34432058,89977952,1885507,550571,355159,737615,7809122,405792,9858259,8214914,0,5703855206,2083599610,21234,[LG21]Lords of Gondor
188969981,ᵸᵒWand0,34392764,65852934,1286067,2054730,706949,524275,5336241,428429,9050624,5764670,0,4299659159,306699275,22626,[LV21]Lords of Valinor
189017405,ᵸᵒWizzy,34166787,39309436,1128087,812593,976175,1093762,2997282,142335,6022147,3139617,0,2772738620,170159151,14659,[LV21]Lords of Valinor
181534760,ᴸᵛSongoku,34588399,81155158,1453686,947363,718037,1206878,6952808,258701,10083787,7211509,0,3917871036,755945265,16143,[LV21]Lords of Valinor
188336265,ᴸᵛiGREC,34032306,40103594,370445,535084,195209,299340,3462098,189391,4681122,3651489,0,2450337118,175934276,17452,[LV21]Lords of Valinor
188826595,Saf1974,33649398,123125177,1439912,1377958,555476,577431,9543989,1199451,13254305,10743440,0,5229426343,230946040,50825,[LV21]Lords of Valinor
188970345,PitBlue,33660479,102079961,862627,1120668,1623539,1658595,8244143,476647,13123592,8720790,0,4033756191,1077393393,22996,[LV21]Lords of Valinor
189154415,ᵸᵒMDKMB,33465765,64131804,785334,2572471,865337,727479,4957494,470089,9592870,5427583,0,2186425059,2686649252,20219,[LV21]Lords of Valinor
182317160,MALAM 1 SURO,33357529,175793594,1950501,3166593,2312668,2727770,14997180,482603,23686814,15479783,0,4245291674,738465485,28829,[LV21]Lords of Valinor
185986678,卂尺丂,33906362,91846834,1214629,681974,1395198,1304176,7560868,404733,11346949,7965601,0,3322057825,1193919485,15076,[LV21]Lords of Valinor
188837916,Silent Kakashi,33205434,105876915,889638,839969,754922,750377,9809221,155268,12309757,9964489,0,1797038374,103761097,14036,[LV21]Lords of Valinor
188501467,direraven,33080024,112957479,752809,5173869,2368802,2785598,8231023,686624,19245916,8917647,0,4922292328,4551820,27437,[LV21]Lords of Valinor
190252265,Jamong,33023105,48035801,986726,240286,331209,224664,4135373,253647,5185179,4389020,0,5301171823,81003240,23605,[LV21]Lords of Valinor
182713036,쵸ﾒMØTÃSÊMツ쵸,33004739,25758138,662283,107410,239091,451161,2273587,35898,3107147,2309485,0,5169183507,123301386,20600,[LV21]Lords of Valinor
188651684,Milo San,32993061,7567393,256838,5998,5637,18715,667806,40100,738256,707906,0,2987643295,359753808,12029,[LV21]Lords of Valinor
185612447,Chaudary Zain,32713196,146792912,1444870,9269291,1590830,914396,12570247,619867,24964631,13190114,0,4562346267,1323892732,25549,[LV21]Lords of Valinor
188736727,Alex9003,32621662,39909345,1661889,2965695,704903,767680,2742202,370683,7551163,3112885,0,4206437902,38138060,14358,[LV21]Lords of Valinor
187029935,HolySpirit,32552815,139214472,1508586,1270651,1347299,1593326,12091148,449048,16751472,12540196,0,2699705942,1104079437,18963,[LV21]Lords of Valinor
188362493,亗MrDuck ツ,32419929,57352889,1219396,14224356,2044148,1147653,4244343,169284,21829784,4413627,0,2841124324,909611190,17005,[LV21]Lords of Valinor
185037763,ᵛBEARDY,32277187,51437912,2227119,28222212,2319488,801981,2906415,444121,34694217,3350536,0,4921911553,554484409,19513,-
188451175,ᵸᵒTerra,32036192,60110534,870910,3422823,860914,534113,4831117,362826,10011793,5193943,0,4052479360,92432122,22451,[LV21]Lords of Valinor
187559873,ｱ尺ﾉ丂ᄃﾉﾚﾚﾑ,31983704,62577567,524842,786256,540194,444292,5234590,360843,7366175,5595433,0,2629725287,626443180,15368,[LV21]Lords of Valinor
188352541,ᴾᴿ Mèoッ,31939371,127518876,1258710,7188100,1700314,1303642,10538936,603835,21334827,11142771,0,6172559629,0,14380,[LV21]Lords of Valinor
186841127,Anossss,31813590,96562733,1396074,5831747,161764,119554,8329768,564848,15007681,8894616,0,4272721715,4253401,14670,[LV21]Lords of Valinor
188225231,ᴾᴿSko0p,31729746,33459441,362846,178306,89071,72567,3099403,98067,3537414,3197470,0,4568964965,0,27246,[LV21]Lords of Valinor
188833519,JulieLaTueuse쵸,31695349,29358324,658444,141152,346846,94148,2531257,147362,3260765,2678619,0,3572849181,37720000,20016,[LV21]Lords of Valinor
185724517,Feldgraŭ,31504209,147054567,1759421,439339,3849630,1436815,11107476,1122271,17955531,12229747,0,4251264607,178066760,33407,[LV21]Lords of Valinor
189045190,Azura21,31370041,28966509,1079446,528436,682624,3020226,1491111,25178,5747575,1516289,0,2787495027,423984134,8168,[LV21]Lords of Valinor
188242643,hoahaizz,31262103,125342482,960344,3664404,983434,590291,10198875,914641,16351645,11113516,0,3807635243,567041937,30431,[LV21]Lords of Valinor
188847278,ᴸᵛQuang,30856931,152721713,1217495,1245617,1436737,1289374,13458854,492654,17923236,13951508,0,4119446028,1618614837,34241,[LV21]Lords of Valinor
188368264,funne,30569019,33194129,1315248,897805,642680,597232,2389600,272214,4799531,2661814,0,3792816725,61698120,16763,[LV21]Lords of Valinor
188598120,ᶻSharineko〤,30560242,84971007,830245,875997,1456433,803718,6423199,721804,10281151,7145003,0,2372694859,63185747,17171,-
190407807,동탄불주먹,30520594,29393118,1082915,1045271,330899,696549,2256677,158465,4487861,2415142,0,5348413771,433522789,15648,[LV21]Lords of Valinor
188797972,21LuviVilu21,30483368,20428974,1287202,579952,518648,328487,1528412,133881,3089380,1662293,0,4410732496,34539709,15960,[LV21]Lords of Valinor
184882401,Ферма а,30470747,92480601,1751855,22831138,3000621,3316968,6293708,285409,35727844,6579117,0,2673583185,3538154179,17492,[LV21]Lords of Valinor
181581608,Fledermauz DB,30294197,32281293,694585,248895,300074,511759,2920175,19129,4000032,2939304,0,3609465781,377676127,7809,[LV21]Lords of Valinor
188961098,Chocolalat,30046331,2667617,220977,51569,65233,15462,226419,10040,368723,236459,0,4228765179,21199999,3623,[LV21]Lords of Valinor
185923730,JFDLCA,30029292,282617864,474199,5136364,3803977,6044367,23877053,551732,39413493,24428785,0,4759802613,386336005,36828,[LV21]Lords of Valinor
177013392,ᴸᵛ UCC15,29899967,40187311,2690015,1200429,936753,881360,2997858,228485,6244885,3226343,0,5366612884,192271545,16247,[LV21]Lords of Valinor
188293704,ᴸᵛDrMusaab,29666833,45572286,1613595,191214,427716,173783,3854486,271931,4919130,4126417,0,3839474708,84578452,14670,[LV21]Lords of Valinor
188262339,Kitty27,29653453,7653613,100178,54908,178359,33366,483795,115725,866153,599520,0,3879083243,23588840,10924,[LV21]Lords of Valinor
188335709,Rebel Rogue,29622296,74045507,1366902,1040029,700124,771386,6274509,330331,9116379,6604840,0,3466850420,34205137,33753,[LV21]Lords of Valinor
188789684,ᴿᵃtMadson,29535649,24821897,558556,1189648,162620,152532,2097548,133656,3736004,2231204,0,3955896437,92421016,41458,[LV21]Lords of Valinor
188316323,ᴸᵛ SAKURA,29289392,102725296,1378468,2386732,1137444,2024123,8699757,243950,14492006,8943707,0,4138416080,539454569,26636,[LV21]Lords of Valinor
189001955,ᴸᵛTruNguyen,29118558,34543091,725153,1039838,168924,415164,3008024,112819,4744769,3120843,0,4465473480,231678867,16921,[LV21]Lords of Valinor
188876886,ᴸᵛTheanh,29107538,138654863,1335143,17870389,306386,596601,12019511,594325,31387212,12613836,0,5586438648,107966937,35414,[LV21]Lords of Valinor
188364390,ᴸᵛLeonPoi,28987070,158003555,1363790,518948,400864,665017,13736413,853692,16174934,14590105,0,3801094123,108004980,36973,[LV21]Lords of Valinor
185651937,ᴳᵃʸGrizzy,28913873,394704092,1530202,11881112,5833583,11664631,32492852,453683,62325861,32946535,0,3744084354,952357579,20305,-
188543996,ᴸᴳﾒNØHOPEツ,28621078,24672534,769216,336061,77756,186665,2112475,128920,2841877,2241395,0,3392051894,31608954,11934,[LV21]Lords of Valinor
188944242,Đạt Feet,28586190,22471916,771640,770802,734141,1502286,1259985,112024,4379238,1372009,0,4652512582,16457231,9281,[LV21]Lords of Valinor
186295211,ᶠˡVENDETTA,28561670,115576250,2742984,4081984,1084740,528626,9229579,909004,15833933,10138583,0,3885646386,1050356942,20081,[LV21]Lords of Valinor
186709522,ᴸᵛ SHERY,28441773,62185658,1562880,609853,401512,544566,5212806,347717,7116454,5560523,0,3409511725,99489407,9543,[LV21]Lords of Valinor
185282573,ᴸᵛ3621 BANK,28364577,62632106,771884,668111,1267167,649115,4855577,440596,7880566,5296173,0,1373861367,2253285969,8672,[LV21]Lords of Valinor
188819438,ᴸᴳLuca,28337247,46983742,616568,378993,894190,250296,4088058,161890,5773427,4249948,0,4237092261,286280200,24198,[DNTM]Dont Touch Me
188830020,ᴸᴳVersized,28267065,71672121,891087,658409,938556,437662,5862888,464190,8361705,6327078,0,3813040415,46055668,10995,[LV21]Lords of Valinor
182720562,ᶜᴹᵈSkyy,28092367,19752884,2388318,291902,77615,310791,1289299,270156,2239763,1559455,0,3999667646,685652689,12498,-
188547640,Kitty8152,27849879,1630693,12032,78078,153637,150776,70470,0,452961,70470,0,6357491693,2547000,7669,[LG21]Lords of Gondor
186043643,卂几Ҝ卂,27855146,62150254,1249323,891073,302733,404481,5295183,339841,7233311,5635024,0,3307130952,501165307,30804,[LV21]Lords of Valinor
188880546,Graf000007,27416064,4086246,1602923,195112,206722,115320,276770,20240,814164,297010,0,3508944793,0,4078,[LG21]Lords of Gondor
188806334,Emrah 51,27393145,3751158,1312229,1012,10602,4008,371372,0,386994,371372,0,4133003650,0,4420,[LR21]Lords of Rohan
188853241,Алёнаа,27159422,28003663,751734,247949,344883,856812,1850580,266563,3566787,2117143,0,4556668850,45525540,13061,[LV21]Lords of Valinor
185538462,UMAYKIZ,27045615,83444728,1211798,2427602,767351,902894,7145505,317894,11561246,7463399,0,4064142942,8566632,6462,[LV21]Lords of Valinor
188294260,CЦEПИOH,27122074,10421111,1855157,581297,556310,288078,772954,15519,2214158,788473,0,2747070645,173206292,7538,[LG21]Lords of Gondor
188836483,YenifferDeRivia,27042645,41563930,1633040,1784534,2318341,1691838,2852355,63972,8711040,2916327,0,3408936737,140738085,4884,[LR21]Lords of Rohan
188285810,ᴵᴰJupanu,27008939,51783856,1139226,875230,1573881,523582,4112608,262032,7347333,4374640,0,4856154139,57408174,20224,[LV21]Lords of Valinor
188788713,Sam smith,26879731,36247697,772626,601729,331796,180165,3096282,189014,4398986,3285296,0,3910079209,33958258,12659,[LV21]Lords of Valinor
188192835,SвулканS,26874843,19967704,388225,2031363,306088,979874,1431780,35598,4784703,1467378,0,3364532541,52162299,9107,[LV21]Lords of Valinor
188544046,G4mine,32447417,26635738,854807,262602,631545,296942,2070874,171181,3433144,2242055,0,4317317823,247760315,20193,-
188872694,DELİ ÜSTAD,26622724,5962066,716649,208561,290491,524323,257508,33350,1314233,290858,0,4326175045,39905983,2129,[LG21]Lords of Gondor
188453555,Puyols,26842067,58877312,1128051,427252,353152,210662,5069459,327416,6387941,5396875,0,6811080445,127173124,24567,[LV21]Lords of Valinor
188818127,ᴿᶝ风华,26562065,2158531,1064759,62955,74067,33164,157987,14264,342437,172251,0,4166247276,64472747,3895,[LG21]Lords of Gondor
188852900,Scorpionking乂,26521490,86546597,2576331,701687,536852,1689544,7398736,229351,10556170,7628087,0,2247532645,58256706,32630,[LV21]Lords of Valinor
189040679,ㄴHORIZONㄱ,26495211,74776471,764075,947828,1035889,885967,6855262,20932,9745878,6876194,0,4541245002,188105599,14268,[LG21]Lords of Gondor
188939030,TBILISI,26424607,7839558,1253222,516250,1297487,330601,372081,4906,2521325,376987,0,3078444786,460258,11718,[LG21]Lords of Gondor
188364525,ᴵᴾEmrys II,26412458,3119874,218964,53070,30135,8285,294045,3770,389305,297815,0,2091717356,0,2715,-
188365363,diegokristy,26359619,50772805,476980,429498,640200,815724,3929613,342374,6157409,4271987,0,3732548700,246281206,15745,[LV21]Lords of Valinor
188575943,BATUMSKİ08,26295905,124654920,2518476,8729094,9991171,6956425,7155716,177195,33009601,7332911,0,2815540982,529137921,20862,[LV21]Lords of Valinor
188877484,ᴵᵀBLOOM,26240463,73412319,1615750,429658,286070,678042,6496736,253736,8144242,6750472,0,1847010287,111895750,28933,-
189939798,ʰᵒDestructor,26120112,19301020,52616,21684,68111,82633,1882993,0,2055421,1882993,0,2895736789,11281500,869,[LG21]Lords of Gondor
189141193,ᴸᵛJankels,25680367,64448681,899417,2484769,1932099,2347605,4640425,214643,11619541,4855068,0,3316281093,28726902,16689,[LV21]Lords of Valinor
188806124,ᴵᴾAltar,25682493,111614407,1481141,3177848,4192360,2583327,8685363,270359,18909257,8955722,0,2531022967,7742830,26734,[LG21]Lords of Gondor
188277784,ᴵᴾPecimura,25422395,28014853,96045,30115,106786,86982,2470635,137049,2831567,2607684,0,1993688634,30935666,8678,[LG21]Lords of Gondor
188835262,vinzsou,25370789,19974141,401813,47518,92506,54319,1802303,76966,2073612,1879269,0,2300208927,0,13296,[LV21]Lords of Valinor
188855274,GOLTEB,25378479,130201754,1327294,1219432,175391,426239,11908029,441092,14170183,12349121,0,3402030514,35237187,42015,[LV21]Lords of Valinor
188891048,7BeLa,25348582,57642914,872000,370252,777201,2820258,4394591,39376,8401678,4433967,0,3249200119,137794496,5869,[LG21]Lords of Gondor
84905552,Schwazzier,25102867,10701276,506526,147563,86882,62010,838244,93376,1228075,931620,0,3220058944,60672597,8167,[LV21]Lords of Valinor
188320476,ᴿᵃЛиса,24982880,43750346,1168017,367832,506674,543458,3634254,207353,5259571,3841607,0,4824623922,362428945,39975,[LV21]Lords of Valinor
146179581,lupepvp,24972805,13318932,615993,207971,115291,37404,1071142,109286,1541094,1180428,0,5414955143,108915418,15479,[LV21]Lords of Valinor
188836051,Cheops Pyramide,24823804,78037383,1222442,665596,285383,464232,6977525,285066,8677802,7262591,0,4505693299,751419894,38150,[LV21]Lords of Valinor
188912287,ᴸʳgCoelho,25241327,35218187,820622,1419717,815104,1021139,2657372,132288,6045620,2789660,0,2465361903,113818904,7249,[LV21]Lords of Valinor
186010544,Mehmet027,24741823,59660904,1615916,1767561,1668161,2013950,4654773,68377,10172822,4723150,0,3061333313,173638054,9104,[LV21]Lords of Valinor
184845080,ᴸᵛSCAR德,24333532,57115838,656372,214040,313814,201078,5017335,273387,6019654,5290722,0,3889602626,46674299,28466,[LV21]Lords of Valinor
189236516,ᴿᶝ年华,24575547,2290337,936926,56107,169818,48265,162204,6219,442613,168423,0,3785537975,48671853,2964,[LG21]Lords of Gondor
185602720,ˢᵉAbdallah,24518011,37680310,200395,749910,727131,953454,2914261,155982,5500738,3070243,0,1721001027,127071312,9800,[LV21]Lords of Valinor
188319008,ᴸᵛКэп21,24483757,10075514,29597,216150,128394,92909,914970,12708,1365131,927678,0,2233408969,0,10987,[LG21]Lords of Gondor
188324838,ХОНДА,24413953,7990779,1618420,319927,430706,215833,601619,9293,1577378,610912,0,2520068321,122738819,6016,[LR21]Lords of Rohan
188937309,Velikiy Govard,24299588,9823194,638326,125640,141509,280242,795672,21868,1364931,817540,0,2732851156,125678023,5277,[LG21]Lords of Gondor
181974650,IDEM City,23791400,2030305,1163258,142285,141908,58538,141798,3295,487824,145093,0,3776027518,86095121,2071,[LG21]Lords of Gondor
184872506,ᴾᴿF A J A R,23766513,81330450,1396757,2282220,2097345,3030279,6197714,129053,13736611,6326767,0,3250277163,28252952,13422,[LG21]Lords of Gondor
185094982,Phi Dương F2P,23649819,38331232,1940175,2842133,5213473,4079345,964930,68459,13168340,1033389,0,2118027246,147926355,5438,[LV21]Lords of Valinor
188840841,ᴸᵛNotZach,23598117,32939204,548532,661641,826162,444933,2565980,185751,4684467,2751731,0,1640776558,107725390,4640,-
188376202,ᴵᴾ云霄,23406909,6580450,1214571,147461,159504,83670,521541,34093,946269,555634,0,2594984100,17020000,4282,[LV21]Lords of Valinor
188994494,Snowplow,23320382,1094552,236306,8504,103749,19351,80795,0,212399,80795,0,2919733949,0,3465,[LR21]Lords of Rohan
188390528,ᶦᶠAkrosh,23306956,14179254,358164,80861,884019,546131,1021052,0,2532063,1021052,0,1408491622,139317710,2243,[21If]Immortal Falcons
188880486,Kỳ tiktok,23136603,9134722,1062496,68271,30446,79884,647748,113158,939507,760906,0,4019745193,0,3230,[LV21]Lords of Valinor
191454845,ᴸᵛTueAnh,23083219,21995213,664298,6082249,104981,279588,1693417,125814,8286049,1819231,0,5684951997,1141408023,12239,[LV21]Lords of Valinor
188793523,FerAmaya,23299534,14022219,506442,137105,231910,107247,945703,182248,1604213,1127951,0,3610496763,43532335,5348,[LV21]Lords of Valinor
188899189,QuantSist,23002758,1720056,385409,11624,68715,76283,127517,0,284139,127517,0,2098878890,296458,5556,[LG21]Lords of Gondor
144563085,ᴵᶜPARANOIA,22878266,4730553,1770534,15817,22531,23272,408292,25316,495228,433608,0,2831381744,1021382,4811,[LG21]Lords of Gondor
188937116,ᴵᶜTom,22847232,4798418,78668,26543,281358,25756,401873,5432,740962,407305,0,2254933220,6485919,12148,-
189057248,Cekko23,22748932,24411066,616878,159414,267445,394996,1981667,122382,2925904,2104049,0,3693883125,76002446,11397,[LV21]Lords of Valinor
188661481,Kängurufarm,22685146,2847269,781585,208965,117034,10247,253042,0,589288,253042,0,2409834236,1128542199,4146,[LG21]Lords of Gondor
188851823,ᴸʳMent001,22625409,706360,45963,213744,185983,43829,11633,0,455189,11633,0,2018487946,0,2777,[LR21]Lords of Rohan
188842111,JJ00,22535635,12699687,546042,13757,120082,40863,1080466,74433,1329601,1154899,0,2619609251,3999999,3674,[LV21]Lords of Valinor
185134660,PetitDr,22413048,3101404,85261,63894,67172,12418,288305,1078,432867,289383,0,1499181335,17979430,10865,-
188830522,ᴸʳTylnmrl,22324586,1670861,37663,32839,20609,4164,155652,2495,215759,158147,0,2315673414,16585000,4663,[LG21]Lords of Gondor
188234979,iGRECfarm,22319661,15844038,286311,273003,46153,43158,1490992,30729,1884035,1521721,0,2703807026,315563112,10672,-
186016235,卂丂卂千,22061968,5455072,172363,142922,151729,14030,395527,55582,759790,451109,0,1956083634,12932669,3856,[LV21]Lords of Valinor
188878743,Jetare,22043745,15241706,984262,914090,1762279,1205895,613645,28715,4524624,642360,0,3275852991,91210728,3082,[LV21]Lords of Valinor
188639928,The亗SCARFACE,22037940,2476955,64606,145589,285116,162864,116131,3242,712942,119373,0,3250918240,44040000,4350,[LG21]Lords of Gondor
185905587,Ze Boshman,21929998,4802837,1158706,309125,97861,13805,369719,39644,830154,409363,0,2770839083,41584565,2619,-
188870613,xXVincinetteXx,21868756,8307709,1851059,867867,503902,29008,656394,22318,2079489,678712,0,4699104174,5876311,23600,-
188846843,BoboFranek,21704370,1436892,86860,96434,230127,133623,42286,0,502470,42286,0,1842439115,45731253,5585,[LG21]Lords of Gondor
188255601,Ant Man21,21587050,21740037,261646,303216,192688,238972,1939567,47123,2721566,1986690,0,3143089623,0,3958,[LG21]Lords of Gondor
188838640,Presidente CIAO,21555469,3248958,61803,13150,115426,83389,268192,0,480157,268192,0,1656500818,23800000,4560,[LG21]Lords of Gondor
184817793,meto 313,21645329,2940073,2001835,184629,125724,112750,75554,72258,570915,147812,0,3008099442,1827622,1806,[LR21]Lords of Rohan
188337674,ᴵᴸAxan,21370602,13852737,908861,382486,81728,81286,1314956,6904,1867360,1321860,0,2645412426,376836150,9609,[OP1]OP CLAN
188819819,fox77778,21277357,3782562,738594,75581,204618,428450,164441,0,873090,164441,0,3363542626,1037349,4735,[LG21]Lords of Gondor
188889549,СЦEПИОН,21044476,2997871,1241527,21675,25683,72660,248333,8410,376761,256743,0,1929432752,102567597,3695,[LR21]Lords of Rohan
186018265,yıldırımsefa,21004432,12642300,258459,159713,850626,471324,812371,45005,2339039,857376,0,3139908481,50620184,8902,[LV21]Lords of Valinor
189036655,Vitia back 1990,20852243,9551108,2056000,172660,105414,21917,821704,50052,1171747,871756,0,2732091900,9800000,8601,[LR21]Lords of Rohan
188443825,йкйцк,20721165,48743894,1313992,1943111,2457331,1223280,2839555,507597,8970874,3347152,0,2532968576,1971457076,21172,-
188876948,Ruberoid,20668930,1308095,30041,24678,63862,55794,95226,0,239560,95226,0,1491295260,3846529,4624,[21If]Immortal Falcons
187503097,Romulus1991,20641512,33314094,204467,206454,70430,269316,2769298,218085,3533583,2987383,0,3935350510,82802395,17857,[LV21]Lords of Valinor
188884453,dm152,20522364,261473,0,20838,55033,4660,12860,0,93391,12860,0,2735200893,0,4367,[LG21]Lords of Gondor
184819319,joe200,20426646,2022401,1197317,130789,249677,21520,45323,47879,495188,93202,0,1631673131,91263980,5852,[LG21]Lords of Gondor
183360513,ᵀᴸмønoメ,20415868,26110591,478300,186118,247673,221163,2277659,95839,3028452,2373498,0,2125813241,85509847,6981,[LG21]Lords of Gondor
188884272,ZHIANZD,20398835,1216090,246973,127800,150740,29760,77001,0,385301,77001,0,2488342395,0,2033,[LR21]Lords of Rohan
187197359,Demir Bilek,20386329,9273471,779097,120768,235808,174193,781889,13102,1325760,794991,0,2269005535,30192868,11205,[LG21]Lords of Gondor
188847403,Vali188847403,20326068,1805843,502942,88125,113717,240436,59904,0,502182,59904,0,1174440329,0,641,[_NDM]New Jersey Nol
188790227,СУЛИМАH,20314740,2937806,1265520,69552,52214,89972,230812,7573,450123,238385,0,1855508039,102878721,3417,[LR21]Lords of Rohan
145631489,BABA SON,20282305,7880142,290848,136434,494296,267396,373532,102968,1374626,476500,0,2267964562,4400000,5085,[LV21]Lords of Valinor
188836639,Ndiaye,20226299,5853377,660696,352077,491543,747064,181162,0,1771846,181162,0,3015682641,383503,1632,[LLA]Lost legion academia
188325495,쵸 See La Meet 쵸,20218723,26136473,714725,1038428,1614240,1553702,1521512,63519,5791401,1585031,0,3512199870,0,7931,-
188806434,ᴸᴳ Bimz,20195843,4958433,658635,38897,29786,6973,379801,53259,508716,433060,0,3028626962,29458520,9853,[LV21]Lords of Valinor
188856715,ᴸᴳJackie,20188088,15197220,284873,80252,30041,24787,1332528,84833,1552441,1417361,0,1271289197,20000000,4128,[LV21]Lords of Valinor
188903920,JoshuaSeil,20167218,6169856,820331,57540,197750,100917,483086,26416,865709,509502,0,2969045697,301497,4225,[LV21]Lords of Valinor
191530671,ᶦᶠtMadsonn,19971791,1846035,34099,69047,86817,200703,85578,0,442145,85578,0,2668324966,910375198,4618,[LR21]Lords of Rohan
188857113,GritNGravy,19953099,1953070,46395,39362,14347,20181,183578,0,257468,183578,0,2970498595,3200971,3745,[LG21]Lords of Gondor
188898779,kral jon snow,19901685,113087,6227,15339,20427,859,6573,0,43198,6573,0,2753058077,8327554,2900,[21If]Immortal Falcons
188261313,freezebee 21,19866281,2027071,234347,244875,375237,108803,79241,0,808156,79241,0,1773688702,5187959,14594,[LG21]Lords of Gondor
188814205,SUBUTAİ 38,19774474,1466044,274608,292102,181430,22696,95398,0,591626,95398,0,1988656692,3080000,2314,[LG21]Lords of Gondor
186613612,Inigo Montoya1,19721628,4819124,1455414,349831,116242,28761,406977,16593,918404,423570,0,2696725763,103076547,8683,[LV21]Lords of Valinor
189075824,NooByZ,19621709,8523920,1530004,77034,121760,128921,748617,13157,1089489,761774,0,3365718003,99259891,19016,-
188853064,TerrorBlade98,20177394,4698786,941546,120572,115534,39441,414286,7149,696982,421435,0,3386724243,0,1371,[LG21]Lords of Gondor
188232993,AKON311,19570367,17474104,658995,571073,531874,842388,1182997,54831,3183163,1237828,0,1770213436,850687088,12260,[LG21]Lords of Gondor
188430882,JapayuKingBILAT,19541567,16224241,589575,264537,718955,348631,1254670,39610,2626403,1294280,0,2896383022,142262581,15934,[LV21]Lords of Valinor
140534782,ᴵᴾCoCaSNX,19345651,21797010,531203,1203243,267031,348395,1715668,123602,3657939,1839270,0,3530980381,2108538017,6924,[RC21]ROYAL CROWN
188776545,ᴳᵒᵈ Ingle,19249070,1048600,93501,85140,135892,24107,66336,0,311475,66336,0,1705728624,3404666,5151,[LR21]Lords of Rohan
188539042,Chieu F2p,19148586,33429745,572222,886405,1728535,661706,2262163,226347,5765156,2488510,0,2146103967,185342934,11636,[LV21]Lords of Valinor
188838663,ERON,19175110,7419903,732610,190505,250716,72425,647213,5927,1166786,653140,0,2017632047,20081022,12083,[LG21]Lords of Gondor
184859052,ᴸᵛamadxd1,19171920,11140391,1696065,175899,454668,303269,783220,57530,1774586,840750,0,2235493929,315992716,7276,[LV21]Lords of Valinor
188818238,PoTaPyh,19113761,17945708,847850,488230,854873,981299,1155520,32896,3512818,1188416,0,3095818334,301072527,13049,[LV21]Lords of Valinor
188827507,Dug1man,18959500,106428,5346,18103,18794,0,6522,0,43419,6522,0,2607340752,0,2502,[LG21]Lords of Gondor
188869412,dân chơi đá,18877333,8228309,246570,288205,739830,1185717,194814,0,2408566,194814,0,2106256471,1154652,1641,-
188844580,RedHoodJT,18583081,3724748,210774,117223,615129,546669,28437,0,1307458,28437,0,1717879541,0,1480,[LR21]Lords of Rohan
188360951,SATORUGOJO1,18495477,9422205,472927,508838,996498,575503,431459,35542,2547840,467001,0,1617465082,317828071,6725,[LV21]Lords of Valinor
188367613,ᶦᶠKinkyTail,18490665,30188549,665162,1489618,750563,721295,2290804,129814,5382094,2420618,0,1006174384,58186939,12905,[LV21]Lords of Valinor
188806199,Op khan,18458558,4774879,1311876,240925,827408,507637,83281,10426,1669677,93707,0,2965115090,4253716,3216,[LR21]Lords of Rohan
188836606,Black AngEL,18388085,8655975,1937740,908418,995278,553139,422312,2403,2881550,424715,0,2137121812,18536152,1822,[LG21]Lords of Gondor
150165925,ᴸᴳken arok,18178030,22745555,626373,4481846,278206,119051,1895431,93113,6867647,1988544,0,2497025129,26909895,11858,[LV21]Lords of Valinor
188336750,SKY EAGLE,18136313,7121747,985124,330019,49903,45477,677403,0,1102802,677403,0,1931799839,213802552,9588,-
188490339,Eudaimonia,18541112,5934482,227320,56910,36785,12770,501291,39277,647033,540568,0,3325965372,30962500,5859,[LV21]Lords of Valinor
189014302,magister,18034793,11593788,947900,205152,1188782,528161,695989,5133,2623217,701122,0,1327725746,15363819,7383,[LG21]Lords of Gondor
188823442,VIP shooter,17981880,3305125,846887,132688,41914,75500,277768,5754,533624,283522,0,1646716362,41800001,5263,[LG21]Lords of Gondor
188884243,HiagoLira,17942789,1285899,1,5567,1871,82946,94926,0,185310,94926,0,1659688115,0,2371,[21If]Immortal Falcons
188787622,MalandrageX,17897904,20690,0,2434,1687,245,1585,0,5951,1585,0,2533243655,0,3291,[LG21]Lords of Gondor
188865329,Việt hoang 07,17892195,607097,64769,419495,234049,900,5150,0,659594,5150,0,2214217502,1833721,888,[21M]Immortal Myrmidons
164927516,iven0007,17783464,10358299,800589,584997,950594,899393,426208,24023,2885215,450231,0,1127358711,29829009,6290,[LV21]Lords of Valinor
189231766,darkkiller666,17669854,3746982,286312,236683,195194,50737,294065,8283,784962,302348,0,2533244060,20289481,14046,[LG21]Lords of Gondor
188487100,Kir8,17630299,744292,46498,47082,45400,57564,41382,0,191428,41382,0,612457103,0,4410,[LG21]Lords of Gondor
190852683,BossAlien FARM,17618699,6771910,168409,19244,81805,135783,606132,0,842964,606132,0,4356169440,1694123182,2709,[LR21]Lords of Rohan
187016834,卂几Ҝ卂1,17461401,5969476,107689,89142,174787,122716,511121,0,897766,511121,0,2808116054,1649060086,4840,[LR21]Lords of Rohan
188904786,Shadow vahalla,17402285,951871,236630,6845,11062,4462,91053,0,113422,91053,0,2870902214,0,3021,[LG21]Lords of Gondor
189068044,Hsotits7,17357733,13123610,995230,966771,1440390,1040579,499742,44487,3991969,544229,0,2174229902,16241240,3476,[LG21]Lords of Gondor
188879533,Qertt7,17232208,188791,322,8039,23990,816,10230,1682,44757,11912,0,4162207942,38000000,2189,[LG21]Lords of Gondor
188368666,Derik 災,17193465,17311218,78795,189202,156137,96806,1633226,12081,2087452,1645307,0,1504456225,57910439,4670,-
196566747,Codrin4Valhalla,17149712,7931308,238487,278350,157181,127114,631250,37016,1230911,668266,0,653910155,89594454,6451,[LV21]Lords of Valinor
188868206,Quocbao05032012,17065087,1765350,652703,140343,12908,5049,169127,0,327427,169127,0,1786196890,6000000,2050,[LR21]Lords of Rohan
188585266,メDragønメ,17046256,6200803,260935,13008,75292,24207,548489,23295,684291,571784,0,1565973095,73489482,19339,-
188503741,SİYAH KAZ,16994656,2745204,35926,148261,185391,246920,121345,7182,709099,128527,0,1557000457,38351774,6878,-
188928573,Thànhteo,16834657,1269484,231737,5214,47138,152454,56435,0,261241,56435,0,1518718910,0,3090,[21M]Immortal Myrmidons
188824641,Sabesaur312,16783039,178017,72,61605,21023,10955,7983,0,101566,7983,0,717328751,0,1962,[LR21]Lords of Rohan
188432088,BandAid,16720935,6291099,303434,23738,88926,146960,503492,24287,787403,527779,0,3073340058,308659606,8337,[LG21]Lords of Gondor
189181702,222mb222,16664157,2096107,769471,199359,63662,40288,176776,0,480085,176776,0,3140617040,225401626,1748,[LR21]Lords of Rohan
188845980,Azadi,16629719,2414584,591878,280392,474111,105066,99002,0,958571,99002,0,1863882325,3366983,1072,[I-am]RoyalLoyalMembers
188861925,blackbandito,16532450,3299236,432177,181283,407143,143151,130863,28373,890813,159236,0,1572279351,24105565,2004,[LG21]Lords of Gondor
188894198,Tomioka senpai,16350778,379272,52185,4153,47557,61967,3546,0,117223,3546,0,2611310647,0,1813,[21If]Immortal Falcons
188513738,MooSáke,16318380,198927,96089,15385,14235,12870,11590,0,54080,11590,0,1810318491,0,1221,[RC21]ROYAL CROWN
190329472,F1Quang,16355703,14222941,1403680,76015,288128,303523,1225945,7897,1901508,1233842,0,3990829914,2942670794,8504,[LV21]Lords of Valinor
188436016,KiLLedYouhaha,16210101,7835320,255634,186713,224968,166588,620167,24001,1222437,644168,0,2651448521,135055118,10022,[LV21]Lords of Valinor
188852196,DarkExecutioner,16177458,1452447,100617,60616,84044,164244,61526,0,370430,61526,0,1216662089,28060602,1834,[TFS:]The Forsaken Souls
188876717,DEWO YEAGER,16103486,4877341,1101397,433008,785790,354455,180134,0,1753387,180134,0,2522819713,0,1769,[21if]farm 21If
188833114,Quent2,16039117,28402168,426151,334512,76938,382240,2357331,153956,3304977,2511287,0,1485235032,21298007,10697,[LV21]Lords of Valinor
187880560,wcwc,16017764,230115722,1527635,19485000,18674475,23053443,9591814,36893,70841625,9628707,0,3214040764,596448438,13547,[21if]farm 21If
188376429,ᴵᶜmySoul,15863805,447638,94861,165290,199177,4054,1,0,368522,1,0,1317663453,7488905,8468,[LR21]Lords of Rohan
188134384,ˢ carlossainz,15705284,6601011,1300774,21788,65922,52235,498539,63524,702008,562063,0,1190118090,25406959,4004,[LG21]Lords of Gondor
188825002,Namiq Cebrayilo,15616229,3934535,1259596,213707,290110,151386,270603,0,925806,270603,0,2242182692,0,769,[LG21]Lords of Gondor
188878343,Cheiron City,15496597,2006372,65708,76640,299335,127026,88427,0,591428,88427,0,1363137548,0,1666,[21if]farm 21If
187078010,Dr4gonsFarmerツ,15490724,22163921,1316246,641729,1799365,1256244,1338903,1142,5037383,1340045,0,2602487365,1725005764,7893,[21If]Immortal Falcons
188825941,S0SKA,15447745,1189854,237525,181770,115056,123932,42766,0,463524,42766,0,1573181792,17191302,2471,[21M]Immortal Myrmidons
188857667,Apoathou,15417948,1322660,1124764,128214,19733,13903,120194,0,282044,120194,0,230139173,156690,1089,[LG21]Lords of Gondor
188809474,Edgar15,15275743,46285,13168,43659,11087,2650,478,0,57874,478,0,2116886110,0,1245,[21M]Immortal Myrmidons
188879219,Akglate,15231878,247677,40137,19567,121882,0,0,0,141449,0,0,2071709078,1758755,592,[LR21]Lords of Rohan
187560016,Kyubi Farm1,15158347,43242083,1156562,1634869,1976614,1528733,3245429,19633,8405278,3265062,0,1354099339,409430369,6747,[LG21]Lords of Gondor
188877463,Se Tuath De,15122861,1904865,811661,93157,158781,182383,83914,0,518235,83914,0,2556532011,5600000,2432,[LG21]Lords of Gondor
186035363,Klgi20,15094050,1079100,1084576,54111,135908,7883,18115,29189,245206,47304,0,1898501662,1200000,3135,[21If]Immortal Falcons
188785649,priam,14992194,1750608,803133,48303,27617,11291,164055,0,251266,164055,0,1488721572,18007168,328,[tgqm1]amarl
188858878,lisabella,14978038,237752,277117,67710,112105,0,0,0,179815,0,0,579223911,0,1617,[21M]Immortal Myrmidons
188781490,Fra1d,14963604,1187031,100258,39857,116341,94712,56753,0,307663,56753,0,1220961083,5509155,3143,[LG21]Lords of Gondor
188800436,LilPiglet,14885068,769658,220953,34240,152043,47076,27042,0,260401,27042,0,1373555406,0,1295,[LR21]Lords of Rohan
188365295,ᴿᵃTsumiki,14849316,2089406,0,8924,38778,19749,193107,0,260558,193107,0,1063300942,3762398,6032,-
189036275,TheBlackDragon,14836976,163506,24134,22964,32186,14353,3713,0,73216,3713,0,2048601597,0,1777,[LG21]Lords of Gondor
188963486,GÖZTEPELİ35,14745890,131575,0,26938,85,5222,10513,0,42758,10513,0,1956299993,230887100,3805,-
12113325,Elena23EV,14743091,1817847,131418,8455,10921,55191,154067,1644,230278,155711,0,1131873275,24431024,5763,[LG21]Lords of Gondor
183848200,Ei Farm,14731064,38195393,1298931,2526718,1320489,1044558,2973860,56612,7922237,3030472,0,3111047090,519374881,13485,[LG21]Lords of Gondor
188802524,Yamato68,14724102,193221,131028,1699,7453,9839,13862,0,32853,13862,0,1224230305,13257436,2993,[LG21]Lords of Gondor
188863496,dark8582,14711908,408222,113485,9062,63839,37988,12678,0,123567,12678,0,1907331881,0,710,[jk10]jk 3621
188986083,KyoHN,14622586,58505,16806,10125,15173,711,2329,0,28338,2329,0,2343765710,69,2862,[LG21]Lords of Gondor
188847086,Dimiboy,14481575,75311,0,179,37638,0,0,0,37817,0,0,1239458223,0,26,[Tick]Tick tack
188873290,FarmЛиса,14403749,5775194,596991,64191,23711,6956,553801,7455,656114,561256,0,1495039799,122800001,4167,[LG21]Lords of Gondor
188796842,Menda2137,14401215,321687,136804,21106,48638,8855,18477,0,97076,18477,0,1116877840,0,1470,[LR21]Lords of Rohan
188858305,Palestine313,14245131,3028033,1334422,129577,527939,188640,119168,0,965324,119168,0,1414266214,0,4,[Alg]Palestine313
188806889,Gouverneur188806889,14240057,785370,316714,61610,182543,80923,8427,0,333503,8427,0,1092931811,0,1024,[21MS]Myrmidons Farm
188885945,whyreall,14191004,1427513,1410059,61686,45602,10688,128122,0,246098,128122,0,1497367838,862617,2035,-
188287771,ᅟᅠᅠᅠᅠᅟᅠᅠᅠᅠ ᅟᅠᅠ,14122751,55673152,491916,382510,936262,319444,5244635,0,6882851,5244635,0,5034718795,2212968833,28909,[LG21]Lords of Gondor
188856535,HOIANA,14032666,1190153,693357,435295,160981,54643,43890,6183,700992,50073,0,1805779858,400000,1179,[21if]farm 21If
188931757,ᴸʳANTHRAX,14007150,659165,84307,164935,187652,32931,11915,0,397433,11915,0,1443661971,0,2111,[LR21]Lords of Rohan
188832666,ChifOJ,13978016,2361104,125471,94442,41533,55215,203829,0,395019,203829,0,2600089443,0,543,[21IR] Corral
170835406,ᴵᶜ Has,13955620,1445859,679890,46009,32626,7559,101847,16135,204176,117982,0,687055286,298517,2940,-
188896546,БорисBao,13857624,1182765,168254,14668,118405,170863,25957,0,329893,25957,0,1761224189,22966398,1423,[LR21]Lords of Rohan
191177358,RtthyrFarm,13786960,52258,8925,14892,0,0,4928,0,19820,4928,0,3616965981,1594265331,1157,[LG21]Lords of Gondor
188953179,SarahVinyard017,13756390,5795264,260817,103502,87804,304494,438098,0,933898,438098,0,1388844714,31860199,3832,[LG21]Lords of Gondor
188787790,You  andl,13580293,920284,416012,51124,134014,82128,31352,0,298618,31352,0,1375619847,4084888,1960,[LR21]Lords of Rohan
44936497,젝스킹,15991483,6996924,923387,39204,54846,41378,523118,74135,732681,597253,0,2183506756,0,9052,-
188837379,안정아남자,13439378,885792,199719,262430,137821,8581,52334,0,461166,52334,0,1891643126,0,1119,[LG21]Lords of Gondor
186073361,卂尺丂Farm,13435636,4138657,585035,39537,204145,32135,344752,7320,627889,352072,0,2286157342,489706596,1515,[LG21]Lords of Gondor
187795145,SOTER,13422032,8447735,539910,529189,65018,309343,652149,22650,1578349,674799,0,1286481653,112215799,15304,[LG21]Lords of Gondor
191069538,Shinnygamyy,13280650,3037148,499817,235031,755080,228183,56725,0,1275019,56725,0,1083252012,5089962,691,-
187257305,HolySpirits,13221458,4186335,271743,116035,83670,59317,375642,105,634769,375747,0,1164962213,477259605,5804,[21If]Immortal Falcons
190539451,puyolF,13152854,972686,309560,2673,66571,105265,41795,0,216304,41795,0,4754639430,1818372170,2064,[LR21]Lords of Rohan
188836866,zlucifer,13134321,2684582,271491,220751,328964,145856,139908,0,835479,139908,0,1701695970,0,1524,-
185484265,Tors228,13083005,7740094,636018,1305674,1878812,627539,120762,178,3932965,120940,0,1312958755,25325363,7376,-
123456386,Igoryan,12962739,5049921,193112,1352415,222892,143876,374139,838,2094160,374977,0,1424732170,11392165,1366,[LG21]Lords of Gondor
188887466,Jensamtresen,12961460,2851467,834974,287219,392239,254799,99035,0,1033292,99035,0,880825536,10799999,842,[I-am]RoyalLoyalMembers
193596249,Korkusuz 51,12958052,239160,358859,12402,0,0,23668,0,36070,23668,0,1401609699,60357336,943,[LR21]Lords of Rohan
188817273,Munmon,12901737,1116310,211912,39551,42589,125343,52185,0,259668,52185,0,2476678488,0,125,-
188845348,ᴸʳLUNICTUS,12877100,104914,26926,6884,16888,8978,3385,0,36135,3385,0,1558632979,0,455,[LR21]Lords of Rohan
188899884,hanaaaa230,12837457,3656113,993138,112016,538707,284659,141766,0,1077148,141766,0,1523085907,3785937,1113,[K~R~]3621 Utility Box
188292201,쵸Bear,12762411,3636617,863462,127956,652623,13205,183272,21012,998068,204284,0,1398516677,0,8400,-
192581999,LilitЛиса,12534892,4099267,2586,4079,12074,27936,396256,0,440345,396256,0,2109473581,534525710,3616,[LG21]Lords of Gondor
188986347,Pimpammm,12386241,390745,21517,13926,70135,29655,12907,0,126623,12907,0,1444868924,9172286,4484,[OP1]OP CLAN
189266244,ᴵᴾRágnär,12376390,2424921,681640,338989,350984,104124,70352,26757,891206,97109,0,245500638,11642489,7444,-
188816893,WARRIOR FARM 10,12338581,242793,17769,22009,47558,10254,10226,0,90047,10226,0,1311205884,0,1892,[21If]Immortal Falcons
142371438,NokedliF11,12302691,3005981,754566,516818,830716,67154,61715,17771,1494174,79486,0,1496304971,2400001,10465,[21M]Immortal Myrmidons
190430624,IMPERADOR FARM,12207867,449281,436505,3716,0,322,44725,0,48763,44725,0,4925511234,2527734725,1598,[LR21]Lords of Rohan
187384799,C H A D 3 3 3,12154750,5025006,638494,336794,550030,58137,356220,3142,1304323,359362,0,963590883,0,4549,[LG21]Lords of Gondor
188829162,Mkジinsane,12152527,911799,856240,15867,56941,24326,65024,2360,164518,67384,0,1543783586,1400000,3486,[LR21]Lords of Rohan
188880051,qftydhunvfezbjj,12100235,18338939,1337013,1249255,1030656,1111224,1086802,35743,4513680,1122545,0,1422326310,88951930,7822,-
185259121,Lets go Os,12039214,913938,1168728,282,16846,7330,13445,35821,73724,49266,0,1378846196,4800000,1584,[LG21]Lords of Gondor
188900034,Rajpoots,12034565,854381,223016,55556,81433,13291,62724,0,213004,62724,0,1888970635,0,3116,[LG21]Lords of Gondor
188838338,boble 79,11984818,306757,46338,1697,52760,41937,3315,0,99709,3315,0,1284564870,0,2121,[21MA]Myrmidons Academy
188217778,ᴵᴰKing Nemo,11974922,1852509,716667,684238,272077,322,117022,0,1073659,117022,0,1857331281,0,12936,-
188479340,ㅡᅟᅟF2P 8      ㅡ,11973652,9974813,173571,883535,766581,262971,721306,0,2634393,721306,0,2742656121,956471741,8850,[LG21]Lords of Gondor
187155907,Yuzhi,11879963,5032590,1641848,115533,189407,294655,290433,27386,917414,317819,0,2066058490,257605,2032,[LR21]Lords of Rohan
188952266,ErDegui,11875134,7108681,230822,125436,58773,125367,620570,12944,943090,633514,0,1173596936,13045768,5398,[LG21]Lords of Gondor
188946350,BaabyyKiller,11764448,45777543,823248,1480408,3397133,2896319,2635750,37221,10446831,2672971,0,1760569996,20189360,9196,-
188819203,Cominogr,11749427,347521,71452,268238,123679,11074,222,0,403213,222,0,1698587337,0,850,[ANTB]ANnti Banned Club
188856725,Uranusuki,11637732,268914,32838,25630,66282,25841,2786,0,120539,2786,0,862515495,3859996,750,[LR21]Lords of Rohan
188887462,Dunks,11595270,1538565,760926,36818,198678,122594,64347,0,422437,64347,0,1107672787,0,1041,[LR21]Lords of Rohan
188900167,Charles grand 3,11544448,4207791,779277,591939,722430,168606,197012,0,1679987,197012,0,1807463824,8400000,918,[Tick]Tick tack
188363322,쵸Belmont,11471499,726781,18931,225245,250029,43961,583,0,519818,583,0,1185584888,1410552,11058,-
185877603,ㄴ Aurelio ㄱ,11433632,3426162,734268,194294,519109,17374,220713,3623,955113,224336,0,918025985,1758080,3483,[LG21]Lords of Gondor
188892262,Udi lopez,11407408,286475,30519,120358,27289,7419,17815,0,172881,17815,0,259364387,3001045,1840,[21If]Immortal Falcons
188818543,GodAnubis,11404418,3265470,842158,347813,333503,280538,140675,0,1102529,140675,0,1258710524,473118,756,[21IR] Corral
188885079,ᴵᶜnoobhuhu,11287294,4932153,869902,263679,640053,58918,316980,9692,1289322,326672,0,1694858992,26599999,5002,-
188840730,FurkiTolki,11279685,1839593,1140153,3217,12856,72657,143339,4461,236530,147800,0,1699607274,3600000,2047,[21M]Immortal Myrmidons
188840453,La pampara,11196019,4065536,1018214,200050,433845,478194,124506,0,1236595,124506,0,1512594666,0,322,[21if]farm 21If
188818957,alonsoisma,11171028,2300239,762386,25316,47973,75270,189815,0,338374,189815,0,1570857138,4826393,1427,[LR21]Lords of Rohan
188307234,ᴵᵀJessyS2,11159564,3418968,138406,130180,168640,9783,301652,0,610255,301652,0,1509177777,180913621,6306,-
174523518,ㅡᅟᅟF2P 5      ㅡ,11135688,4068578,375472,858694,1490716,123637,42086,0,2515133,42086,0,2261099995,828382628,2425,[LG21]Lords of Gondor
189182502,ᴵᶜVatson67F,11099535,137197,213594,1669,4693,617,12501,0,19480,12501,0,3532708716,1724148322,1612,[LR21]Lords of Rohan
188320795,Fïshböy F1,10995457,1130852,410313,146172,398,5918,103727,1994,258209,105721,0,1546308264,820170438,1116,[LR21]Lords of Rohan
189443468,Hubey,10948714,2171604,462536,189562,257421,35910,147521,0,630414,147521,0,918945909,0,1967,-
189182788,Vatson67f3,10870337,260412,485136,2684,4031,13106,19939,0,39760,19939,0,3522852190,1133268751,1368,[LR21]Lords of Rohan
189007908,vua đại du,10847143,2010095,594035,32817,68882,36737,135324,18279,292039,153603,0,1664459657,27506603,6095,-
188309795,ᴵᶜ TAZIEX,10844048,8618161,951227,435439,559362,399095,559725,10936,1964557,570661,0,1632163083,0,8839,-
189227933,Z  Hot Rain  Z,10762707,6460378,866429,52143,3457,47844,612586,6290,722320,618876,0,1457174944,13707113,1796,-
184327666,ツاحمدᴰᴮ,10758594,3030757,532767,681079,488185,101508,109018,21098,1400888,130116,0,1461565573,72130,2371,[LV21]Lords of Valinor
188817859,oktaev,10746001,401425,359467,33669,31021,2770,32157,0,99617,32157,0,1102334555,0,100,[DD21])Dragon of Death
188839518,Zaragoza,10706866,1181120,88062,120100,376712,100919,0,0,597731,0,0,1424532659,0,1158,[LR21]Lords of Rohan
188847841,Lj1208,10602108,314850,314434,984,0,1961,30681,0,33626,30681,0,1177309928,0,905,[21If]Immortal Falcons
188889920,Carolk,10405243,642390,541227,49383,96269,35954,29616,0,211222,29616,0,1160793734,1349311,322,[fagr]alpha table
195403312,môngcổ,10404788,1446809,783623,85946,65345,87040,95077,0,333408,95077,0,1268748115,0,1056,[LG21]Lords of Gondor
189442766,Gubernur189442766,10379474,77204,41779,1313,9937,12737,612,0,24599,612,0,2566574990,1989430704,714,[21IR] Corral
117517315,ᴵᶜBOTAN,10360428,13712356,945529,506093,1444925,965222,611992,37024,3565256,649016,0,1235813199,498018246,20006,-
188522411,Ваn,10346788,1095208,3365,36724,120447,26500,74097,0,257768,74097,0,727419882,1,2219,[21If]Immortal Falcons
189285062,Linh farm 2,10226348,9739359,1413236,1086939,10938,8479,938116,4251,2048723,942367,0,5498557998,3128768761,1827,[LR21]Lords of Rohan
188881481,678907,10216770,4054167,576543,566707,812285,378314,80300,0,1837606,80300,0,1265972490,53227,1518,[LLA]Lost legion academia
188295840,ッ Yakuza ッ 6,10205094,395204,0,3871,70818,40591,9043,0,124323,9043,0,992758872,82882904,4849,[21if]farm 21If
188899095,Minuz,10200319,1614469,364375,167345,306671,102167,55899,0,632082,55899,0,729556492,0,1704,[LR21]Lords of Rohan
188906315,ᴵᶜИвaн,10170251,1248369,45240,148765,274837,58418,43527,0,525547,43527,0,943901017,16348226,12804,-
188300029,Hoàng Saa,10150004,5137975,463048,87026,120041,279872,368510,3795,859244,372305,0,1297068352,9873378,8165,[LR21]Lords of Rohan
188721766,ᴵᶜZver225,10146168,5600948,578427,272790,772945,368830,252518,0,1667083,252518,0,1282562432,205403656,7602,[LG21]Lords of Gondor
188840603,andyrendy,10073872,1722850,894100,10373,99042,247058,53446,0,409919,53446,0,1032365452,0,459,[Slon]Slonii
194265891,쵸MØTÃSÊMツ쵸 2,10071453,2326155,0,5126,24684,21098,219137,0,270045,219137,0,1480428074,125453620,1402,[LG21]Lords of Gondor
188857096,Di 1,10019335,909985,10470,103819,160058,85834,22577,0,372288,22577,0,934774982,1843151,2952,-
189869613,Алёнааа,9878154,3146615,691598,31047,82951,360086,153416,0,627500,153416,0,1475255043,503089664,1095,[GW21]GOATED WARRIORS
188846435,psilva3,9878088,1390439,255473,331056,379662,122656,7428,0,840802,7428,0,958807138,0,589,[21IR] Corral
188898591,Dthomas,9838220,468487,81006,125157,122286,22516,10882,0,280841,10882,0,434478065,0,1343,[LR21]Lords of Rohan
188471943,NoCoboY,9816138,413116,95171,64153,54918,15880,22693,0,157644,22693,0,1081418218,0,3619,[LG21]Lords of Gondor
191785327,ᴿᵃQueen,9625702,3017237,247312,228656,300820,10824,232657,0,772957,232657,0,2123392947,813781963,1187,[LR21]Lords of Rohan
186988267,Panda ᴸᴺ,9616784,2766515,1120377,7927,2980,11995,264463,3318,290683,267781,0,3082740466,512115698,1981,-
188962647,卂几Ҝ卂2,9578262,2082291,325396,3405,6149,30163,194866,0,234583,194866,0,1618176948,1219440595,2004,[LR21]Lords of Rohan
186065635,MASONFTW WOOD,9565193,1910931,810165,6189,9403,5772,186780,0,208144,186780,0,1687360926,950725213,1287,[LR21]Lords of Rohan
188790900,Dom Daddy,9553678,3388766,1222043,27914,83403,91562,276497,4258,483634,280755,0,1773010253,0,1447,[OP1]OP CLAN
188815675,KōbøLord,9517898,145859,16647,15805,9235,19277,4712,0,49029,4712,0,843374303,0,1696,[LR21]Lords of Rohan
188462426,Tysson,9463093,1483696,191746,163161,372581,171003,2189,0,708934,2189,0,647738981,310,4386,[21MA]Myrmidons Academy
189238085,Christian33,9461254,471496,125768,75854,103315,62424,0,0,241593,0,0,711808811,0,1589,[21LK]legionary knight
188844276,tori,9424138,213019,54967,3007,1985,1182,20372,0,26546,20372,0,486406302,0,915,[21If]Immortal Falcons
188308863,Rock Farm ll,9385339,10088421,459789,450027,1066779,575927,546551,4782,2644066,551333,0,737133728,45352280,6170,-
188560833,Gorgona,9371349,1635913,58059,135968,120817,4039,135093,0,395917,135093,0,379010693,1749999,1348,[LR21]Lords of Rohan
105186699,Musti 13,9364627,647045,252843,43047,75095,24684,38951,0,181777,38951,0,1101186393,2316986,969,[21M]Immortal Myrmidons
99995740,Den Sama,9279960,3818653,761156,227066,81007,194524,283313,0,785910,283313,0,3917032777,1934258745,1355,[21if]farm 21If