ID,Name,Power,Killpoints,Deads,T1 Kills,T2 Kills,T3 Kills,T4 Kills,T5 Kills,Total Kills,T45 Kills,Ranged,Rss Gathered,Rss Assistance,Helps,Alliance
179940560,ᴸᵛ ink,101784881,706390931,4418255,2922076,868213,972035,42443035,13787580,60992939,56230615,0,6201360884,1873979817,82585,[LV21]Lords of Valinor
186145908,ʳᵉʸEscanor,83768542,1565821630,3898596,4790891,915485,1737993,129310873,13148589,149903831,142459462,0,3564773876,4498233340,22961,[LV21]Lords of Valinor
188540500,TakeMe2Valhalla,80775140,1554265890,5602860,13833904,5759409,11135628,116071924,16735927,163536792,132807851,0,2834280785,7101247251,45072,[LV21]Lords of Valinor
180304933,LilLƴ,79677634,347301948,3614622,3185660,2770233,3249820,19546609,6632949,35385271,26179558,0,1196613977,5020554697,22936,[LV21]Lords of Valinor
188858506,Cúchulainn 쵸,74723519,306868776,2153950,936833,278755,625535,26909492,1726342,30476957,28635834,0,5154380732,552651627,38563,[LV21]Lords of Valinor
179655012,ᴸᵛDØØPER,73163687,634329349,2869663,2824815,973727,1267573,42070318,10302173,57438606,52372491,0,8557082883,1571282008,39309,[LV21]Lords of Valinor
178695066,SokoDrake,67970914,139603048,2945480,1296111,106206,148891,10389225,1732180,13672613,12121405,0,8116368606,115903540,17943,[LV21]Lords of Valinor
180560115,TripEhh,62698566,482993940,1504950,3191022,822023,695405,31083529,8354739,44146718,39438268,0,6758650850,1409777077,11357,[LV21]Lords of Valinor
180060983,ᴸᵛRumRamsey,60816756,466459237,2651593,115891095,5049133,1001138,35100444,3908688,160950498,39009132,0,6195979004,417518493,95775,[LV21]Lords of Valinor
184964288,ᴾᴿFïshböy,59576831,290666990,2495330,2114031,4660047,3960145,22170897,2168727,35073847,24339624,0,3547129773,632742525,39789,[LV21]Lords of Valinor
179977300,ᴸᵛTmulla,59289716,905794577,1845514,5370999,421047,1513186,53948654,17916950,79170836,71865604,0,7014907238,5600679937,17837,[LV21]Lords of Valinor
188839265,A 10 Warthog,59210583,12765610,230642,42253,74269,128873,1010827,99243,1355465,1110070,0,3824044164,754780894,11529,[LV21]Lords of Valinor
186009654,Dooby ᴼᴺᴱ,58814671,351075780,958320,2646333,392289,879934,31425032,1599594,36943182,33024626,0,7659591255,137216122,36295,[LV21]Lords of Valinor
188341936,ᴸᵛ Vatson67,56566708,310431688,1758107,1362222,557836,606793,26181724,2239958,30948533,28421682,0,6706997332,384720155,42867,[LV21]Lords of Valinor
188918989,ᴼᴸ Kaymo,56244701,125177460,1092879,2484352,1386449,2529103,10279320,449904,17129128,10729224,0,3826371448,1075163587,41915,[LV21]Lords of Valinor
178814644,Øtòt x҉ Vail,55247367,444858744,3140400,18550973,3385819,2356133,31505688,5494775,61293388,37000463,0,2295222519,2329433716,15943,[LV21]Lords of Valinor
185836736,ᴸᵛMasonFTW,51583572,518664204,2663562,13762904,2238370,4941301,42826782,3170093,66939450,45996875,0,3427503146,2802859223,29293,[LV21]Lords of Valinor
186199010,Daphneᴵᴿ,50482454,227474059,2016208,1841208,1275812,3354286,17579907,1766899,25818112,19346806,0,4233549569,1883572399,56563,[LV21]Lords of Valinor
182514982,ᴸoᵛeSalmon,50006638,528531380,3795347,18839332,2064818,5055442,37033213,6503999,69496804,43537212,0,5541818972,1060488180,54542,[LV21]Lords of Valinor
186985518,HornyAPOLLOS,49374563,267626058,1830766,3558314,1749826,3484941,22575606,1185946,32554633,23761552,0,2765945331,614948054,19273,[LV21]Lords of Valinor
184871937,ScazBigLion,49216097,1251099924,4532246,59921311,23364142,26120857,97159533,5815431,212381274,102974964,0,5939774287,13704268108,20972,[LV21]Lords of Valinor
184826667,ᴸᵛAHERUS勇,49143604,573091292,1685082,13128161,6262337,12967909,49213517,696709,82268633,49910226,0,6046933907,1446853955,25309,[LV21]Lords of Valinor
185355768,Majaaaaaaa,48589363,577673018,6018425,3773833,2405479,3630391,50168691,2794941,62773335,52963632,0,1749957055,8071265646,20194,[LG21]Lords of Gondor
181308342,ᴸᵛRockSolid,47844360,208123289,2834121,2731456,711551,1569524,14172090,2907745,22092366,17079835,0,3463893427,6102949920,41725,[LV21]Lords of Valinor
176994964,Cpl Rage,45821035,125646735,556138,2430798,1506916,2122761,9817838,773866,16652179,10591704,0,1919593871,63265830,17299,[LV21]Lords of Valinor
142628224,Dae jang goon,45756617,205318528,2571470,2106271,732287,391595,16537482,1824575,21592210,18362057,0,5016776619,102794418,17346,[LV21]Lords of Valinor
185808036,Ze Bosh,45682185,324557669,903869,8598579,2626646,3862918,28938009,637645,44663797,29575654,0,5524831742,631820319,29935,-
181825355,ᴸoᵛePUMA,45583352,262482348,1684904,1617362,370704,550287,19125796,3397918,25062067,22523714,0,3290255968,3599759382,36068,[LV21]Lords of Valinor
188920797,FreyaFullBosom,44308600,135216795,2271264,2285165,1585014,2566131,10594547,768987,17799844,11363534,0,3684020454,1363334617,24791,[LV21]Lords of Valinor
179750493,GuiltyMahiru,43237257,237192236,1337746,3711432,2001369,3364248,19736690,1081166,29894905,20817856,0,1513242691,2025360302,41466,[LV21]Lords of Valinor
188241812,Gilgamesh2323,42726893,142285321,1066661,24534299,240264,461406,12155461,674885,38066315,12830346,0,5206672910,212620586,26643,[LV21]Lords of Valinor
185690465,Dictator  Goat,42329590,357470758,2170212,6092140,2162244,1318953,32523873,1070665,43167875,33594538,0,6244228677,1005155698,35358,[LV21]Lords of Valinor
179813923,ㄴ Bless ㄱ,42204921,262773135,2299774,7948187,6194983,5464858,21153320,770045,41531393,21923365,0,2553578309,978016636,23717,[LV21]Lords of Valinor
187423027,ᴸᴳPandaFr3d,42035533,190935207,2055069,1957376,794162,916562,14785690,1871613,20325403,16657303,0,2878489054,6820681844,26529,[LV21]Lords of Valinor
182423962,シValkyrieCillaﾒ,41863391,127170065,1924182,5641405,823181,754108,9727093,1205403,18151190,10932496,0,5122885341,1615202822,15344,[LV21]Lords of Valinor
188483360,ᴼᴸTryxan,41444060,200913899,1210760,21238115,2837274,2706917,15674964,1170721,43627991,16845685,0,6214882397,2169436768,40757,[LV21]Lords of Valinor
188969478,ᴰᴹMePaul,40773701,105563123,1013773,1991609,3290337,2582057,7345972,739809,15949784,8085781,0,3809738737,278578838,3742,[LV21]Lords of Valinor
188485523,ᴸᵛIMPERADOR,40429990,223964745,1213330,815946,48539,166392,18318283,1992804,21341964,20311087,0,6435631412,281752989,38078,[LV21]Lords of Valinor
188976136,ᴸᵛ MUSE,40072492,107796848,1269889,2095231,2355914,944966,8391819,748396,14536326,9140215,0,5243843353,405719425,48770,[LV21]Lords of Valinor
187247613,Queen Padmé,39886390,226026684,3572324,4493283,3032101,4098459,17938175,1164412,30726430,19102587,0,7800228942,4718542203,89247,[LV21]Lords of Valinor
188785515,Johnvin,39245265,202945522,2104829,1121021,1265406,2574624,17014805,987198,22963054,18002003,0,4996355518,93446315,57799,[LV21]Lords of Valinor
179816952,Hell CAT GTR,39002146,62282036,2921173,79058810,1765741,1889333,2800448,368849,85883181,3169297,0,5523244652,1636698071,11191,[LV21]Lords of Valinor
185282531,Annıɛ,38979776,45496988,2695521,469962,132883,175975,4001273,221030,5001123,4222303,0,3456998437,592793562,26323,[LV21]Lords of Valinor
185457048,Cman9918,38231477,133602129,1160939,3704156,1184975,873737,11641776,528932,17933576,12170708,0,1996001700,126071365,16769,-
178213242,ᶦˢLOCOOZ,37985516,142897517,3860481,2142456,957035,1554554,8548914,2442380,15645339,10991294,0,4432398134,1274602396,22291,[LV21]Lords of Valinor
189072394,ᴵᴾLaura,37944886,51126391,1312098,15223045,383206,780510,3891089,264122,20541972,4155211,0,6377585122,362529904,27644,[LV21]Lords of Valinor
180368631,ᴸᵛWinfields,37894652,168479915,4752877,23256287,190665,612282,12372478,1863671,38295383,14236149,0,5319937147,1877834074,14064,[LV21]Lords of Valinor
186765655,KönigsKlãsse,37811392,240208132,1201359,2443903,1408580,1939543,20333402,1290500,27415928,21623902,0,3650016376,407789115,8870,[LV21]Lords of Valinor
188651683,Sol Aliyaa,37715902,13645781,140221,204288,216649,153294,1152169,51838,1778238,1204007,0,4021153524,201676244,15799,[LV21]Lords of Valinor
188882878,Rtthyr,37668751,114334542,1073793,416831,164386,186036,9776636,770595,11314484,10547231,0,7558249606,93046400,19957,[LV21]Lords of Valinor
189060019,Tušiš,37553155,93247749,892658,793409,636796,1052564,7975910,392306,10850985,8368216,0,3055741001,572362931,20956,[LV21]Lords of Valinor
188880730,ᴸᵛMarlone,37358969,160169403,2240632,619139,375785,278204,13390335,1213892,15877355,14604227,0,6059382422,136720000,45680,[LV21]Lords of Valinor
187726069,ᵀᴿvSpryth,37789071,83784989,906655,1399758,170663,364308,7175800,497424,9607953,7673224,0,5565162944,15763287,24542,[LV21]Lords of Valinor
188789133,MiniMe,36614145,44203323,379199,266647,235538,207437,3953911,165503,4829036,4119414,0,5110952007,34179151,12035,[LV21]Lords of Valinor
188648613,Känguruᴵᴰ,36588762,25538784,340214,377701,272323,171077,2091875,165777,3078753,2257652,0,2953884233,286935074,13516,[LV21]Lords of Valinor
185986678,卂尺丂,36514627,96616452,1248612,681974,1395201,1304339,7984294,431468,11797276,8415762,0,3322878222,1253919485,15292,[LV21]Lords of Valinor
188303104,HokieHighlander,36494578,95005122,1815055,482383,116164,73422,7776391,830936,9279296,8607327,0,1096402342,84975248,14227,[LV21]Lords of Valinor
188805469,BossAlienᴾᴴ,36337961,69990201,1238059,250538,604492,927660,5961291,270378,8014359,6231669,0,5020720832,134750966,39904,-
189065897,W3llsFargo,35902610,37052434,668888,1191313,898257,213767,3198291,108984,5610612,3307275,0,3988485577,2754424297,19058,[LV21]Lords of Valinor
188333348,ᴷᴺLinh,35895380,71125617,935539,1904716,1645656,5139453,3986139,351708,13027672,4337847,0,4963258785,550111352,11136,[LV21]Lords of Valinor
182338045,亗ƧHiꟻT亗,35756977,150628524,1131937,2662150,1006449,1312309,10247812,2017792,17246512,12265604,0,5586206862,2545586970,32876,[LV21]Lords of Valinor
188276623,ᴸᵛArork,35518472,98955131,1136023,7400266,1269441,1425134,8150856,386355,18632052,8537211,0,3892438169,360935366,16934,[LV21]Lords of Valinor
186444772,Dr4gonツ,34802954,289750647,3333030,5956288,3581975,4320865,25056516,677341,39592985,25733857,0,5343377908,4917255328,39799,[LV21]Lords of Valinor
185341770,ᶜᵘRalfish,34769742,85826619,2793349,1077569,1155423,2769380,5972280,624997,11599649,6597277,0,2716984874,25760000,16259,[LV21]Lords of Valinor
188794709,ᶦᵗˢᵘRYU,34662173,125869230,1079708,1340014,2570858,2765448,10255868,341952,17274140,10597820,0,3804193044,94094214,36305,[LV21]Lords of Valinor
188969981,ᵸᵒWand0,34522464,65852934,1286067,2054730,706949,524275,5336241,428429,9050624,5764670,0,4299659159,306699275,22650,[LV21]Lords of Valinor
185048534,Han Sansan,34478173,170302894,1196315,1172992,524178,1119270,14997432,728427,18542299,15725859,0,6212765409,357367305,33070,[LV21]Lords of Valinor
185089489,ᴼᴾZOROGRANJ,34432058,89977952,1885507,550571,355159,737615,7809122,405792,9858259,8214914,0,5703855206,2083599610,21234,[LG21]Lords of Gondor
189017405,ᵸᵒWizzy,34429467,39347386,1128087,812593,976175,1093762,3001077,142335,6025942,3143412,0,2779574994,170159151,14788,[LV21]Lords of Valinor
188336265,ᴸᵛiGREC,34314615,42676627,387083,548377,205422,376262,3682100,191503,5003664,3873603,0,2450337118,175934276,17555,[LV21]Lords of Valinor
182713036,쵸ﾒMØTÃSÊMツ쵸,34132765,26368298,662283,107410,239091,451161,2334603,35898,3168163,2370501,0,5247966385,123301386,20843,[LV21]Lords of Valinor
190252265,Jamong,33844561,49001775,1022175,240286,331209,225030,4227220,255949,5279694,4483169,0,5366915464,81003240,23759,[LV21]Lords of Valinor
188970345,PitBlue,33320841,109397965,937327,1141287,1623732,1705806,8859774,525064,13855663,9384838,0,4054030277,1077393395,23362,[LV21]Lords of Valinor
189154415,ᵸᵒMDKMB,33461647,77739602,884773,2602673,887000,812752,6199882,509762,11012069,6709644,0,2221394541,2796649393,20784,[LV21]Lords of Valinor
181534760,ᴸᵛSongoku,33363867,96814752,1796523,978630,733915,1300734,8299448,347689,11660416,8647137,0,3966079167,855945265,16798,[LV21]Lords of Valinor
188837916,Silent Kakashi,33302543,111664058,901900,842930,754922,750377,10282314,208049,12838592,10490363,0,1807980471,103761097,14109,[LV21]Lords of Valinor
187029935,HolySpirit,33281463,139214472,1508586,1270651,1347299,1593326,12091148,449048,16751472,12540196,0,2699705942,1104079437,19020,[LV21]Lords of Valinor
188362493,亗MrDuck ツ,33168831,61085659,1277713,14227296,2044148,1147941,4534608,210703,22164696,4745311,0,2847642288,1019611190,17224,[LV21]Lords of Valinor
188501467,direraven,33152504,118538719,753756,5174288,2368802,2788352,8742257,709514,19783213,9451771,0,4944154215,4551820,27782,[LV21]Lords of Valinor
188651684,Milo San,33080765,8042340,256838,43601,89395,77920,674115,40100,925131,714215,0,2999578072,359753808,12125,[LV21]Lords of Valinor
186841127,Anossss,32916994,96732783,1396074,5831747,161764,119554,8346773,564848,15024686,8911621,0,4338828505,4253401,14783,[LV21]Lords of Valinor
185037763,ᵛBEARDY,32277187,51437912,2227119,28222212,2319488,801981,2906415,444121,34694217,3350536,0,4921911553,554484409,19513,-
190407807,동탄불주먹,32198639,31808814,1121413,1047850,330899,696549,2490389,162368,4728055,2652757,0,5388342022,433522789,15844,[LV21]Lords of Valinor
188826595,Saf1974,32184593,147125380,1983220,1508882,695424,712909,11494322,1381895,15793432,12876217,0,5281468892,230946040,52505,[LV21]Lords of Valinor
187559873,ｱ尺ﾉ丂ᄃﾉﾚﾚﾑ,31983704,62577567,524842,786256,540194,444292,5234590,360843,7366175,5595433,0,2629725287,626443180,15368,-
188368264,funne,31908578,34729346,1335493,898234,647164,618063,2510260,284026,4957747,2794286,0,3809138361,61698120,17006,[LV21]Lords of Valinor
188242643,hoahaizz,31769731,125342482,960344,3664404,983434,590291,10198875,914641,16351645,11113516,0,3851877465,4457191315,30548,[LV21]Lords of Valinor
188736727,Alex9003,31602429,41684245,1667921,2965695,704908,767680,2864205,398426,7700914,3262631,0,4234347596,38138060,14400,[LV21]Lords of Valinor
188451175,ᵸᵒTerra,31449629,63073264,870910,3422823,860914,534113,5094502,379270,10291622,5473772,0,4071917068,92432122,22610,[LV21]Lords of Valinor
188833519,JulieLaTueuse쵸,31563561,29744592,674110,146452,347727,94342,2556262,153993,3298776,2710255,0,3607394797,37720000,20201,[LV21]Lords of Valinor
185612447,Chaudary Zain,31549868,159361223,1497156,9495996,1625907,1047260,13700133,650992,26520288,14351125,0,4600669086,1323892732,26076,[LV21]Lords of Valinor
188847278,ᴸᵛQuang,31528558,184530611,1319057,2721178,1721855,2450854,16029615,522155,23445657,16551770,0,4160731251,1794614837,35047,[LV21]Lords of Valinor
182317160,G  O  P  A R,31347428,197879355,2241373,5357848,2321184,2745552,16860721,628800,27914105,17489521,0,4338431190,754465485,29465,[LV21]Lords of Valinor
188225231,ᴾᴿSko0p,31164150,34213211,383675,178306,89071,72567,3151408,109753,3601105,3261161,0,4574543737,0,27296,[LV21]Lords of Valinor
188352541,ᴾᴿ Mèoッ,31147107,132247542,1478051,7190642,1700314,1304919,10946283,636314,21778472,11582597,0,6234313557,0,14528,[LV21]Lords of Valinor
189045190,Azura21,30814749,29061325,1079446,528436,682624,3020265,1500577,25178,5757080,1525755,0,2814110758,423984134,8198,[LV21]Lords of Valinor
188316323,ᴸᵛ SAKURA,30898920,108404228,1419474,2387863,1142218,2029245,9181356,285584,15026266,9466940,0,4178916698,579454569,27069,[LV21]Lords of Valinor
188262339,Kitty27,30894248,9408722,170938,58400,178359,37776,641012,123955,1039502,764967,0,3917790261,23588840,11511,[LV21]Lords of Valinor
185724517,Feldgraŭ,30819720,148772897,1770420,439339,3849630,1436815,11220787,1151532,18098103,12372319,0,4251305527,178066760,33602,[LV21]Lords of Valinor
184882401,Ферма а,30689761,92480601,1751855,22831138,3000621,3316968,6293708,285409,35727844,6579117,0,2694259785,3538154179,17505,[LV21]Lords of Valinor
188364390,ᴸᵛLeonPoi,30579708,170126587,1484298,526466,421023,1039547,14744850,878628,17610514,15623478,0,3860742345,108004980,37486,[LV21]Lords of Valinor
186043643,ƐKA,30392249,66412584,1325466,948183,319988,430578,5706384,339841,7744974,6046225,0,3325408149,501165307,31078,[LV21]Lords of Valinor
188961098,Chocolalat,30387942,2667617,220977,51569,65233,15462,226419,10040,368723,236459,0,4251722817,21199999,3676,[LV21]Lords of Valinor
181581608,Fledermauz DB,30342085,38142703,702758,248895,300074,511759,3506250,19162,4586140,3525412,0,3616659454,377676127,7890,[LV21]Lords of Valinor
185923730,JFDLCA,30252384,302238977,625367,5208686,3815555,6080380,25489663,717399,41311683,26207062,0,4787488889,386336005,37254,[LV21]Lords of Valinor
188789684,ᴿᵃtMadson,30226285,27770647,661608,1330198,163113,257863,2236543,189075,4176792,2425618,0,3991480738,102421016,42609,[LV21]Lords of Valinor
177013392,ᴸᵛ UCC15,30138071,40198241,2690015,1200429,936753,881360,2998951,228485,6245978,3227436,0,5387662759,192271545,16288,[LV21]Lords of Valinor
188876886,ᴸᵛTheanh,30054788,167267152,1549285,17957444,336809,774884,14648691,670780,34388608,15319471,0,5601632309,107966937,36692,[LV21]Lords of Valinor
188598120,ᶻSharineko〤,29899775,121444933,1328614,945586,1457411,811096,9669567,920047,13803707,10589614,0,2378141837,259185747,18242,[LV21]Lords of Valinor
189001955,ᴸᵛTruNguyen,29899418,49626253,801992,1246026,233037,717051,4356775,123751,6676640,4480526,0,4513227448,243678867,17202,[LV21]Lords of Valinor
186295211,ᶠˡVENDETTA,29818198,115576250,2742984,4081984,1084740,528626,9229579,909004,15833933,10138583,0,3885646386,1050356942,20089,[LV21]Lords of Valinor
188335709,Rebel Rogue,29671596,74815707,1366902,1040029,700124,771386,6333643,339274,9184456,6672917,0,3481882713,34205137,33817,[LV21]Lords of Valinor
188285810,ᴵᴰJupanu,29369760,65563961,1313760,1004348,1641004,851636,5257880,304787,9059655,5562667,0,4899602464,57408174,20548,[LV21]Lords of Valinor
188944242,Đạt Feet,29111151,29631009,886755,829795,806084,1576473,1838221,158239,5208812,1996460,0,4736502579,16457231,9639,[LV21]Lords of Valinor
188797972,21LuviVilu21,28992783,28199260,1645872,603892,542868,396074,2198887,170979,3912700,2369866,0,4472419398,44539709,16283,[LV21]Lords of Valinor
185651937,ᴳᵃʸGrizzy,28913873,394704092,1530202,11881112,5833583,11664631,32492852,453683,62325861,32946535,0,3744084354,952357579,20305,-
188293704,ᴸᵛDrMusaab,28810485,47087038,1714401,193822,427716,173783,3969347,290212,5054880,4259559,0,3879138001,84578452,14898,[LV21]Lords of Valinor
185538462,UMAYKIZ,28676586,84067112,1234556,2429922,767351,902894,7178359,332563,11611089,7510922,0,4099526267,8566632,6500,[LV21]Lords of Valinor
186709522,ᴸᵛ SHERY,28505414,62185658,1562880,609853,401512,544566,5212806,347717,7116454,5560523,0,3409511725,99489407,9545,[LV21]Lords of Valinor
188819438,ᴸᴳLuca,28371247,46983742,616568,378993,894190,250296,4088058,161890,5773427,4249948,0,4256954061,626280200,24205,[LG21]Lords of Gondor
188543996,ᴸᴳﾒNØHOPEツ,28308046,31896070,919840,478590,187282,341417,2741942,132035,3881266,2873977,0,3421498896,31608954,12325,[LV21]Lords of Valinor
188788713,Sam smith,28148157,36247697,772626,601729,331796,180165,3096282,189014,4398986,3285296,0,3939865072,33958258,12704,[LV21]Lords of Valinor
182720562,ᶜᴹᵈSkyy,28092367,19752884,2388318,291902,77615,310791,1289299,270156,2239763,1559455,0,3999667646,685652689,12498,-
188547640,Kitty8152,28030598,1630693,12032,78078,153637,150776,70470,0,452961,70470,0,6472132173,2547000,7743,[LG21]Lords of Gondor
185282573,ᴸᵛ3621 BANK,27953641,63008676,809137,668111,1267167,649115,4886210,444108,7914711,5330318,0,1380539839,2253285969,8684,[LV21]Lords of Valinor
188880546,Graf000007,27852109,4086246,1602923,195112,206722,115320,276770,20240,814164,297010,0,3560954443,0,4159,[LG21]Lords of Gondor
188872694,DELİ ÜSTAD,27684680,5962066,716649,208561,290491,524323,257508,33350,1314233,290858,0,4386976345,39905983,2143,[LG21]Lords of Gondor
188806334,Emrah 51,27585947,3751158,1312229,1012,10602,4008,371372,0,386994,371372,0,4150229950,0,4428,[LR21]Lords of Rohan
188294260,CЦEПИOH,27503323,10421111,1855157,581297,556310,288078,772954,15519,2214158,788473,0,2754555570,173206292,7548,[LG21]Lords of Gondor
188830020,ᴸᴳVersized,27402048,82400875,1243485,675365,950506,483030,6778327,532470,9419698,7310797,0,3851348103,96055668,11311,[LV21]Lords of Valinor
185602720,ˢᵉAbdallah,27082653,37680310,200395,749910,727131,953454,2914261,155982,5500738,3070243,0,1730155469,127071312,10190,[LV21]Lords of Valinor
188853241,Алёнаа,27037250,31302992,900423,247992,344883,856812,2140828,286405,3876920,2427233,0,4599088497,45525540,13122,[LV21]Lords of Valinor
189141193,ᴸᵛJankels,26985654,66103829,899417,5409357,1932099,2347605,4745652,215541,14650254,4961193,0,3385568493,28726902,17000,[LV21]Lords of Valinor
189939798,ʰᵒDestructor,26944719,19723170,52616,21684,68111,82633,1909078,8065,2089571,1917143,0,2967801836,11281500,911,[LV21]Lords of Valinor
188192835,SвулканS,26967955,19967704,388225,2031363,306088,979874,1431780,35598,4784703,1467378,0,3369791466,52162299,9329,[LV21]Lords of Valinor
188453555,Puyols,26848216,71421561,1435576,453105,365901,249262,6130483,414863,7613614,6545346,0,6946832438,127173124,25446,[LV21]Lords of Valinor
188365363,diegokristy,26760230,55983704,504980,434161,640264,816141,4292900,421139,6604605,4714039,0,3732548960,246281206,15991,[LV21]Lords of Valinor
188939030,TBILISI,26747547,7839558,1253222,516250,1297487,330601,372081,4906,2521325,376987,0,3113506077,460258,11761,[LG21]Lords of Gondor
188544046,G4mine,26718340,28362778,2022351,262704,631545,296942,2242480,171729,3605400,2414209,0,4317317823,247760315,20193,-
188818127,ᴿᶝ风华,26679110,2158531,1064759,62955,74067,33164,157987,14264,342437,172251,0,4188408772,64472747,3943,[LG21]Lords of Gondor
189040679,ㄴHORIZONㄱ,26495211,74776471,764075,947828,1035889,885967,6855262,20932,9745878,6876194,0,4541245002,188105599,14271,[LG21]Lords of Gondor
188364525,ᴵᴾEmrys II,26412458,3119874,218964,53070,30135,8285,294045,3770,389305,297815,0,2091717356,0,2715,-
188877484,ᴵᵀBLOOM,26240463,73412319,1615750,429658,286070,678042,6496736,253736,8144242,6750472,0,1847010287,111895750,28933,-
188575943,BATUMSKİ08,26180329,126032238,2604699,8739204,9993384,6958475,7269515,188429,33149007,7457944,0,2842129027,529137921,21026,[LV21]Lords of Valinor
84905552,Schwazzier,26149201,13911756,621510,167620,94182,73167,1095908,121906,1552783,1217814,0,3258360858,60672597,8454,[LV21]Lords of Valinor
188836483,YenifferDeRivia,26044679,41837660,1714676,1784534,2318341,1691838,2868362,69655,8732730,2938017,0,3409146471,140738085,4889,[LR21]Lords of Rohan
186010544,Mehmet027,25746939,64314458,1626376,1870063,1718352,2118048,5065321,68917,10840701,5134238,0,3088163165,173638054,9478,[LV21]Lords of Valinor
188852900,Scorpionking乂,25715984,91770599,2944165,787298,725800,1727500,7725426,299864,11265888,8025290,0,2270544911,58256706,33184,[LV21]Lords of Valinor
188855274,GOLTEB,25524047,132842714,1336339,1219432,175391,426239,12157913,448198,14427173,12606111,0,3412858078,35237187,42256,[LV21]Lords of Valinor
188277784,ᴵᴾPecimura,25471519,28014853,96045,30115,106786,86982,2470635,137049,2831567,2607684,0,2004901092,30935666,8683,[LG21]Lords of Gondor
188891048,7BeLa,25348582,57642914,872000,370252,777201,2820258,4394591,39376,8401678,4433967,0,3249200119,137794496,5869,[LG21]Lords of Gondor
188912287,ᴸʳgCoelho,25220486,44139573,948566,2043756,931311,1116370,3377578,181347,7650362,3558925,0,2483190415,113818904,7648,[LV21]Lords of Valinor
188836051,Cheops Pyramide,25216846,83151673,1323682,709979,285764,469450,7414423,320806,9200422,7735229,0,4552067262,751419894,39483,[LV21]Lords of Valinor
188320476,ᴿᵃЛиса,25196663,50097349,1182473,367919,507133,552515,4203226,238359,5869152,4441585,0,4870908852,390428945,40466,[LV21]Lords of Valinor
146179581,lupepvp,25214181,17255559,694361,253956,122446,45339,1414718,131567,1968026,1546285,0,5455799806,228915418,16332,[LV21]Lords of Valinor
189236516,ᴿᶝ年华,24759721,2290337,936926,56107,169818,48265,162204,6219,442613,168423,0,3820896941,48671853,2997,[LG21]Lords of Gondor
188319008,ᴸᵛКэп21,24483757,10075514,29597,216150,128394,92909,914970,12708,1365131,927678,0,2233408969,0,10987,[LG21]Lords of Gondor
188324838,ХОНДА,24471753,7990779,1618420,319927,430706,215833,601619,9293,1577378,610912,0,2520072254,122738819,6024,[LR21]Lords of Rohan
185094982,Phi Dương F2P,24449460,39128186,2000294,2842133,5213473,4099201,1025931,73835,13254573,1099766,0,2125385525,147926355,5605,[LV21]Lords of Valinor
188899189,QuantSist,24359731,1720057,385409,11628,68715,76283,127517,0,284143,127517,0,2152730921,296458,5615,[LG21]Lords of Gondor
188937309,Velikiy Govard,24353988,9823194,638326,125640,141509,280242,795672,21868,1364931,817540,0,2765657623,125678023,5287,[LG21]Lords of Gondor
184845080,ᴸᵛSCAR德,24171712,63157304,854502,232083,317473,201813,5508015,329427,6588811,5837442,0,3960150272,46674299,28943,[LV21]Lords of Valinor
188840841,ᴸᵛNotZach,24048339,32939204,548532,661641,826162,444933,2565980,185751,4684467,2751731,0,1690729258,107725390,4676,[LV21]Lords of Valinor
188835262,vinzsou,23922255,31954974,821289,83223,189081,407792,2833128,79886,3593110,2913014,0,2316534362,0,13603,[LV21]Lords of Valinor
188376202,ᴵᴾ云霄,23850217,6580450,1214571,147461,159504,83670,521541,34093,946269,555634,0,2594984100,17020000,4283,[LV21]Lords of Valinor
181974650,IDEM City,23791400,2030305,1163258,142285,141908,58538,141798,3295,487824,145093,0,3776027518,86095121,2071,[LG21]Lords of Gondor
184872506,ᴾᴿF A J A R,23766513,81330450,1396757,2282220,2097345,3030279,6197714,129053,13736611,6326767,0,3250277163,28252952,13422,[LG21]Lords of Gondor
188793523,FerAmaya,23758850,15433678,506442,137201,231910,107247,1029947,210698,1717003,1240645,0,3619060960,43532335,5477,[LV21]Lords of Valinor
188880486,Kỳ tiktok,23535139,10194513,1169669,70126,30762,93811,740708,116832,1052239,857540,0,4141550172,0,3318,[LV21]Lords of Valinor
188994494,Snowplow,23479527,1094552,236306,8504,103749,19351,80795,0,212399,80795,0,2964372494,0,3482,[LR21]Lords of Rohan
191454845,ᴸᵛTueAnh,23341029,24754938,683409,6097691,110426,294887,1948174,132663,8583841,2080837,0,5779549431,1141408023,12582,[LV21]Lords of Valinor
188851823,ᴸʳMent001,23307676,706360,45963,213744,185983,43829,11633,0,455189,11633,0,2073176882,0,2809,[LR21]Lords of Rohan
188390528,ᶦᶠAkrosh,23306956,14179254,358164,80861,884019,546131,1021052,0,2532063,1021052,0,1408491622,139317710,2243,[21If]Immortal Falcons
144563085,ᴵᶜPARANOIA,22878266,4730553,1770534,15817,22531,23272,408292,25316,495228,433608,0,2831381744,1021382,4811,[LG21]Lords of Gondor
188937116,ᴵᶜTom,22847232,4798418,78668,26543,281358,25756,401873,5432,740962,407305,0,2254933220,6485919,12148,-
188661481,Kängurufarm,22685146,2847269,781585,208965,117034,10247,253042,0,589288,253042,0,2409834236,1128542199,4146,[LG21]Lords of Gondor
188830522,ᴸʳTylnmrl,22480750,1670861,37663,32839,20609,4164,155652,2495,215759,158147,0,2360326710,16585000,4680,[LG21]Lords of Gondor
188842111,JJ00,22357023,12793967,550395,13757,120082,40863,1085520,76620,1336842,1162140,0,2619609251,3999999,3689,[LV21]Lords of Valinor
187503097,Romulus1991,22363583,40204309,393781,245756,84426,288474,3410097,236572,4265325,3646669,0,3987816800,82802460,18373,[LV21]Lords of Valinor
188234979,iGRECfarm,22319661,15844038,286311,273003,46153,43158,1490992,30729,1884035,1521721,0,2703807026,315563112,10672,-
189057248,Cekko23,22266774,31548072,702037,195672,272850,402577,2585855,174719,3631673,2760574,0,3740449384,76002446,11543,[LV21]Lords of Valinor
188639928,The亗SCARFACE,22181323,2476955,64606,145589,285116,162864,116131,3242,712942,119373,0,3267411795,44040000,4361,[LG21]Lords of Gondor
188878743,Jetare,22162289,15256626,984262,914090,1762279,1205895,614779,28894,4525937,643673,0,3325383252,91210728,3150,[LV21]Lords of Valinor
188664465,ᴸᵛEren 勇,22074129,49965974,1623051,606890,681174,827892,4278040,119514,6513510,4397554,0,1902975921,650343921,22154,-
186016235,卂丂卂千,22012716,6337713,198555,179575,152860,49387,459527,60163,901512,519690,0,2018451024,12932669,3949,[LV21]Lords of Valinor
185905587,Ze Boshman,21929998,4802837,1158706,309125,97861,13805,369719,39644,830154,409363,0,2770839083,41584565,2619,-
188870613,xXVincinetteXx,21868756,8307709,1851059,867867,503902,29008,656394,22318,2079489,678712,0,4699104174,5876311,23600,-
184817793,meto 313,21709929,2940073,2001835,184629,125724,112750,75554,72258,570915,147812,0,3038087442,1827622,1812,[LR21]Lords of Rohan
188846843,BoboFranek,21704370,1436892,86860,96434,230127,133623,42286,0,502470,42286,0,1842439115,45731253,5585,[LG21]Lords of Gondor
188838640,Presidente CIAO,21702777,3248958,61803,13150,115426,83389,268192,0,480157,268192,0,1677045180,23800000,4598,[LG21]Lords of Gondor
188255601,Ant Man21,21587050,21740037,261646,303216,192688,238972,1939567,47123,2721566,1986690,0,3143089623,0,3958,[LG21]Lords of Gondor
188819819,fox77778,21448925,3782562,738594,75581,204618,428450,164441,0,873090,164441,0,3392715474,1037349,4776,[LG21]Lords of Gondor
188337674,ᴵᴸAxan,21421602,13852737,908861,382486,81728,81286,1314956,6904,1867360,1321860,0,2648080943,376836150,9619,[OP1]OP CLAN
186018265,yıldırımsefa,21276860,12642300,258459,159713,850626,471324,812371,45005,2339039,857376,0,3152665981,50620184,8907,[LV21]Lords of Valinor
188856715,ᴸᴳJackie,21250850,16273262,288624,86631,34385,42579,1427353,87166,1678114,1514519,0,1290194986,20000000,4235,[LV21]Lords of Valinor
189036655,Vitia back 1990,21211001,9551108,2056000,172660,105414,21917,821704,50052,1171747,871756,0,2757159508,9800000,8611,[LR21]Lords of Rohan
188889549,СЦEПИОН,21068401,2997871,1241527,21675,25683,72660,248333,8410,376761,256743,0,1929432752,102567597,3696,[LR21]Lords of Rohan
188884453,dm152,20934065,261473,0,20838,55033,4660,12860,0,93391,12860,0,2801192115,0,4400,[LG21]Lords of Gondor
188876948,Ruberoid,20822879,1308095,30041,24678,63862,55794,95226,0,239560,95226,0,1492296960,3846529,4626,[21If]Immortal Falcons
187197359,Demir Bilek,20778429,9273471,779097,120768,235808,174193,781889,13102,1325760,794991,0,2336763381,30192868,11275,[LG21]Lords of Gondor
189075824,NooByZ,20765710,8523920,1530004,77034,121760,128921,748617,13157,1089489,761774,0,3365718003,99259891,19016,-
188443825,йкйцк,20721165,48743894,1313992,1943111,2457331,1223280,2839555,507597,8970874,3347152,0,2532968576,1971457076,21172,-
188790227,СУЛИМАH,20689024,2937806,1265520,69552,52214,89972,230812,7573,450123,238385,0,1855508039,102878721,3417,[LR21]Lords of Rohan
188853064,TerrorBlade98,20613502,4698786,941546,120572,115534,39441,414286,7149,696982,421435,0,3420114243,0,1389,[LG21]Lords of Gondor
188836639,Ndiaye,20502985,5853377,660696,352077,491543,747064,181162,0,1771846,181162,0,3056632661,383503,1642,[LLA]Lost legion academia
145631489,BABA SON,20470310,8135752,291044,136434,494296,267396,384655,110187,1392968,494842,0,2344705330,4400000,5354,[LV21]Lords of Valinor
184819319,joe200,20426646,2022401,1197317,130789,249677,21520,45323,47879,495188,93202,0,1631673131,91263980,5852,[LG21]Lords of Gondor
183360513,ᵀᴸмønoメ,20415868,26110591,478300,186118,247673,221163,2277659,95839,3028452,2373498,0,2125813241,85509847,6981,[LG21]Lords of Gondor
188847403,Vali188847403,20404068,1805843,502942,88125,113717,240436,59904,0,502182,59904,0,1175700329,0,641,[_NDM]New Jersey Nol
188884272,ZHIANZD,20398835,1216090,246973,127800,150740,29760,77001,0,385301,77001,0,2488342395,0,2033,[LR21]Lords of Rohan
188903920,JoshuaSeil,20135382,9071566,910127,69104,316071,209606,637078,60820,1292679,697898,0,2975882651,301497,4329,[LV21]Lords of Valinor
188325495,쵸 See La Meet 쵸,20218723,26136473,714725,1038428,1614240,1553702,1521512,63519,5791401,1585031,0,3512199870,0,7931,-
188857113,GritNGravy,20218378,1953070,46395,39362,14347,20181,183578,0,257468,183578,0,2981158195,3200971,3748,[LG21]Lords of Gondor
191530671,ᶦᶠtMadsonn,20214541,1846035,34099,69047,86817,200703,85578,0,442145,85578,0,2700675327,910375198,4644,[LR21]Lords of Rohan
188814205,SUBUTAİ 38,20038418,1466044,274608,292102,181430,22696,95398,0,591626,95398,0,2061297132,3080000,2336,[LG21]Lords of Gondor
188898779,kral jon snow,20021340,113087,6227,15339,20427,859,6573,0,43198,6573,0,2758203077,8327554,2901,[21If]Immortal Falcons
188644411,IQ777,19951696,10297771,72917,271035,682547,244380,661655,64220,1923837,725875,0,1174120561,127703632,20889,-
186613612,Inigo Montoya1,19903348,4819124,1455414,349831,116242,28761,406977,16593,918404,423570,0,2736287417,103076547,8770,[LV21]Lords of Valinor
188261313,freezebee 21,19637312,2063501,394759,244875,375237,108803,81854,515,811284,82369,0,1790514978,5187959,14765,[LV21]Lords of Valinor
188232993,AKON311,19570367,17474104,658995,571073,531874,842388,1182997,54831,3183163,1237828,0,1770213436,850687088,12260,[LG21]Lords of Gondor
188806434,ᴸᴳ Bimz,19557599,6152359,844385,40869,30149,21752,477546,61071,631387,538617,0,3084600829,29458520,10059,[LV21]Lords of Valinor
188430882,JapayuKingBILAT,19226631,21349458,653519,266172,725874,399779,1727746,48395,3167966,1776141,0,2939995562,154262581,16345,[LV21]Lords of Valinor
188776545,ᴳᵒᵈ Ingle,19359558,1048600,93501,85140,135892,24107,66336,0,311475,66336,0,1724835691,3404666,5157,[LR21]Lords of Rohan
140534782,ᴵᴾCoCaSNX,19345651,21797010,531203,1203243,267031,348395,1715668,123602,3657939,1839270,0,3530980381,2108538017,6924,[RC21]ROYAL CROWN
188838663,ERON,19296885,8735808,732610,236513,802016,123451,647213,5927,1815120,653140,0,2032663099,20081022,12101,[LG21]Lords of Gondor
184859052,ᴸᵛamadxd1,19280187,11242441,1696065,175899,454668,303269,793425,57530,1784791,850955,0,2288006529,315992716,7341,[LV21]Lords of Valinor
164927516,Iᴠᴀɴツ07,19236722,10720999,801063,584997,950594,899393,462478,24023,2921485,486501,0,1164984781,29829009,6769,[LV21]Lords of Valinor
188360951,SATORUGOJO1,19232056,9648765,472927,508838,996498,575503,454115,35542,2570496,489657,0,1617479709,317828071,6866,[LV21]Lords of Valinor
186011194,RTHAlek607,19161674,35768985,529513,503086,617804,436955,3146088,61203,4765136,3207291,0,3174397393,271316554,20316,[OP1]OP CLAN
188818238,PoTaPyh,19156359,17945708,847850,488230,854873,981299,1155520,32896,3512818,1188416,0,3095818334,301072527,13054,[LV21]Lords of Valinor
188827507,Dug1man,19140717,106428,5346,18103,18794,0,6522,0,43419,6522,0,2622082752,0,2506,[LG21]Lords of Gondor
188367613,ᶦᶠKinkyTail,19123039,41260105,788664,1635976,866824,830778,3314523,136546,6784647,3451069,0,1031317464,58186939,13995,[LV21]Lords of Valinor
150165925,ᴸᴳken arok,19044716,30784203,739254,4518139,278206,119051,2610476,137160,7663032,2747636,0,2517091991,54909895,12684,[LV21]Lords of Valinor
188806199,Op khan,19028626,4774879,1311876,240925,827408,507637,83281,10426,1669677,93707,0,3044012072,4253716,3321,[LR21]Lords of Rohan
188844580,RedHoodJT,18937642,3724748,210774,117223,615129,546669,28437,0,1307458,28437,0,1760457210,0,1514,[LR21]Lords of Rohan
188869412,dân chơi đá,18877333,8228309,246570,288205,739830,1185717,194814,0,2408566,194814,0,2106256471,1154652,1641,-
188539042,Chieu F2p,19046881,42328381,754381,957438,1756061,780973,2951548,299270,6745290,3250818,0,2166843548,185342934,12059,[LV21]Lords of Valinor
188836606,Black AngEL,18427835,8655975,1937740,908418,995278,553139,422312,2403,2881550,424715,0,2141610562,18536152,1822,[LG21]Lords of Gondor
188490339,Eudaimonia,18378520,12634887,395629,105267,52348,51762,1121189,54510,1385076,1175699,0,3419713724,30962500,6473,[LV21]Lords of Valinor
188823442,VIP shooter,18265232,3305125,846887,132688,41914,75500,277768,5754,533624,283522,0,1690795667,41800001,5329,[LG21]Lords of Gondor
188336750,SKY EAGLE,18136313,7121747,985124,330019,49903,45477,677403,0,1102802,677403,0,1931799839,213802552,9588,-
189014302,magister,18060393,11593788,947900,205152,1188782,528161,695989,5133,2623217,701122,0,1327725746,15363819,7384,[LG21]Lords of Gondor
188787622,MalandrageX,18027503,20690,0,2434,1687,245,1585,0,5951,1585,0,2558627405,0,3297,[LG21]Lords of Gondor
188884243,HiagoLira,17984582,1402109,1,5567,1871,82946,106547,0,196931,106547,0,1677649111,0,2379,[21If]Immortal Falcons
188865329,Việt hoang 07,17892195,607097,64769,419495,234049,900,5150,0,659594,5150,0,2214217502,1833721,888,[21M]Immortal Myrmidons
196566747,Codrin4Valhalla,17715196,8049734,238960,278433,157181,127114,643091,37016,1242835,680107,0,659889753,105200399,6712,[LV21]Lords of Valinor
188487100,Kir8,17696099,744292,46498,47082,45400,57564,41382,0,191428,41382,0,612457103,0,4414,[LG21]Lords of Gondor
189231766,darkkiller666,17669854,3746982,286312,236683,195194,50737,294065,8283,784962,302348,0,2533244060,20289481,14046,[LG21]Lords of Gondor
190852683,BossAlien FARM,17618699,6771910,168409,19244,81805,135783,606132,0,842964,606132,0,4361562822,1694123182,2709,[LR21]Lords of Rohan
189068044,Hsotits7,17558235,13123610,995230,966771,1440390,1040579,499742,44487,3991969,544229,0,2236845819,16241240,3524,[LG21]Lords of Gondor
188904786,Shadow vahalla,17538685,951871,236630,6845,11062,4462,91053,0,113422,91053,0,2914372214,0,3041,[LG21]Lords of Gondor
187016834,卂几Ҝ卂1,17485369,5969476,107689,89142,174787,122716,511121,0,897766,511121,0,2808116054,1649060086,4842,-
188879533,Qertt7,17339634,188791,322,8039,23990,816,10230,1682,44757,11912,0,4228711100,38000000,2209,[LG21]Lords of Gondor
188368666,Derik 災,17193465,17311218,78795,189202,156137,96806,1633226,12081,2087452,1645307,0,1504456225,57910439,4670,-
188585266,メDragønメ,17046256,6200803,260935,13008,75292,24207,548489,23295,684291,571784,0,1565973095,73489482,19339,-
188503741,SİYAH KAZ,16994656,2745204,35926,148261,185391,246920,121345,7182,709099,128527,0,1557000457,38351774,6878,-
188432088,BandAid,16954406,7448556,374529,37544,89296,147014,558682,54379,886915,613061,0,3104827005,308659606,8639,[LV21]Lords of Valinor
189181702,222mb222,16873940,2096107,769471,199359,63662,40288,176776,0,480085,176776,0,3192091620,225401626,1763,[LR21]Lords of Rohan
188928573,Thànhteo,16834657,1269484,231737,5214,47138,152454,56435,0,261241,56435,0,1518718910,0,3090,[21M]Immortal Myrmidons
188833114,Quent2,16879505,28722158,469626,334512,76938,382240,2387396,154923,3336009,2542319,0,1511519319,21298007,11016,[LV21]Lords of Valinor
188824641,Sabesaur312,16783039,178017,72,61605,21023,10955,7983,0,101566,7983,0,717328751,0,1962,[LR21]Lords of Rohan
188845980,Azadi,16707316,2414584,591878,280392,474111,105066,99002,0,958571,99002,0,1863882325,3366983,1072,[I-am]RoyalLoyalMembers
188861925,blackbandito,16677007,3299236,432177,181283,407143,143151,130863,28373,890813,159236,0,1587463977,24105565,2010,[LG21]Lords of Gondor
190329472,F1Quang,16618283,14222941,1403680,76015,288128,303523,1225945,7897,1901508,1233842,0,4077349975,2942670794,8525,[LV21]Lords of Valinor
188894198,Tomioka senpai,16575542,379272,52185,4153,47557,61967,3546,0,117223,3546,0,2640605647,0,1821,[21If]Immortal Falcons
188876717,DEWO YEAGER,16510107,5955979,1113111,572647,822160,386945,262799,1068,2045619,263867,0,2567461218,0,1812,[21if]farm 21If
188513738,MooSáke,16390279,198927,96089,15385,14235,12870,11590,0,54080,11590,0,1825967691,0,1221,[RC21]ROYAL CROWN
188852196,DarkExecutioner,16177458,1452447,100617,60616,84044,164244,61526,0,370430,61526,0,1216662089,28060602,1834,[TFS:]The Forsaken Souls
188857667,Apoathou,16105247,1322660,1124764,128214,19733,13903,120194,0,282044,120194,0,230139173,156690,1097,[LG21]Lords of Gondor
187880560,wcwc,16017764,230115722,1527635,19485000,18674475,23053443,9591814,36893,70841625,9628707,0,3214040764,596448438,13547,[21if]farm 21If
188436016,KiLLedYouhaha,15922525,12992507,351221,195475,235040,222858,1071692,43749,1768814,1115441,0,2688035054,135055118,10329,[LV21]Lords of Valinor
188376429,ᴵᶜmySoul,15863805,447638,94861,165290,199177,4054,1,0,368522,1,0,1317663453,7488905,8468,[LR21]Lords of Rohan
188825002,Namiq Cebrayilo,15788807,3934535,1259596,213707,290110,151386,270603,0,925806,270603,0,2298887447,0,787,[LG21]Lords of Gondor
188868206,Quocbao05032012,15773280,2261620,1027424,140343,12908,5049,202922,7916,369138,210838,0,1812053582,23500000,2232,[LV21]Lords of Valinor
188134384,ˢ carlossainz,15756484,6601011,1300774,21788,65922,52235,498539,63524,702008,562063,0,1190118090,25406959,4008,[LG21]Lords of Gondor
188878343,Cheiron City,15582319,2006372,65708,76640,299335,127026,88427,0,591428,88427,0,1374267548,0,1669,[21if]farm 21If
186035363,Klgi20,15560290,1079100,1084576,54111,135908,7883,18115,29189,245206,47304,0,1932420862,1200000,3144,[21If]Immortal Falcons
187078010,Dr4gonsFarmerツ,15490724,22163921,1316246,641729,1799365,1256244,1338903,1142,5037383,1340045,0,2602487365,1725005764,7894,[21If]Immortal Falcons
188825941,S0SKA,15447745,1189854,237525,181770,115056,123932,42766,0,463524,42766,0,1573181792,17191302,2471,[21M]Immortal Myrmidons
150775231,Lind21,15387821,7690885,484858,498285,954081,721214,266273,6774,2446627,273047,0,1823420717,3048989,2494,-
188809474,Edgar15,15275743,46285,13168,43659,11087,2650,478,0,57874,478,0,2116886110,0,1245,[21M]Immortal Myrmidons
188879219,Akglate,15231878,247677,40137,19567,121882,0,0,0,141449,0,0,2071709078,1758755,592,[LR21]Lords of Rohan
188877463,Se Tuath De,15195141,1904865,811661,93157,158781,182383,83914,0,518235,83914,0,2586704811,5600000,2449,[LG21]Lords of Gondor
187560016,Kyubi Farm1,15167348,43705703,1159458,1634869,1976614,1528733,3277221,26918,8444355,3304139,0,1363686806,409430369,6783,-
188785649,priam,15107320,1750608,803133,48303,27617,11291,164055,0,251266,164055,0,1497162453,18007168,328,[tgqm1]amarl
188858878,lisabella,15044338,237752,277117,67710,112105,0,0,0,179815,0,0,585602661,0,1625,[21M]Immortal Myrmidons
188800436,LilPiglet,14965868,769658,220953,34240,152043,47076,27042,0,260401,27042,0,1378299306,0,1296,[LR21]Lords of Rohan
188781490,Fra1d,14963604,1187031,100258,39857,116341,94712,56753,0,307663,56753,0,1220961083,5509155,3143,[LG21]Lords of Gondor
189036275,TheBlackDragon,14939728,163506,24134,22964,32186,14353,3713,0,73216,3713,0,2058269997,0,1780,[LG21]Lords of Gondor
12113325,Elena23EV,14877461,1817847,131418,8455,10921,55191,154067,1644,230278,155711,0,1157251231,24431024,5770,[LG21]Lords of Gondor
188365295,ᴿᵃTsumiki,14849316,2089406,0,8924,38778,19749,193107,0,260558,193107,0,1063300942,3762398,6032,-
188863496,dark8582,14822465,408222,113485,9062,63839,37988,12678,0,123567,12678,0,1916361881,0,713,[jk10]jk 3621
188986083,KyoHN,14770298,58505,16806,10125,15173,711,2329,0,28338,2329,0,2349901910,69,2863,[LG21]Lords of Gondor
188963486,GÖZTEPELİ35,14745890,131575,0,26938,85,5222,10513,0,42758,10513,0,1956299993,230887100,3805,-
183848200,Ei Farm,14731064,38195393,1298931,2526718,1320489,1044558,2973860,56612,7922237,3030472,0,3111047090,519374881,13486,[LG21]Lords of Gondor
188802524,Yamato68,14724102,193221,131028,1699,7453,9839,13862,0,32853,13862,0,1224230305,13257436,2993,[LG21]Lords of Gondor
188902184,The Lost Legend,14664931,7058172,203577,72451,84459,10146,662590,10414,840060,673004,0,1204480667,0,6695,[LR21]Lords of Rohan
188847086,Dimiboy,14557777,75311,0,179,37638,0,0,0,37817,0,0,1263027888,0,32,[Tick]Tick tack
188873290,FarmЛиса,14514369,6946714,596991,64191,23711,6956,670953,7455,773266,678408,0,1541689294,122800001,4194,[LG21]Lords of Gondor
188796842,Menda2137,14452715,321687,136804,21106,48638,8855,18477,0,97076,18477,0,1124131552,0,1472,[LR21]Lords of Rohan
188806889,Gouverneur188806889,14400469,785370,316714,61610,182543,80923,8427,0,333503,8427,0,1103702173,0,1024,[21MS]Myrmidons Farm
188858305,Palestine313,14336526,3028033,1334422,129577,527939,188640,119168,0,965324,119168,0,1421455604,0,4,[Alg]Palestine313
188856535,HOIANA,14227381,1190153,693357,435295,160981,54643,43890,6183,700992,50073,0,1843249570,400000,1195,[21if]farm 21If
188832666,ChifOJ,14184928,2361104,125471,94442,41533,55215,203829,0,395019,203829,0,2651434443,0,551,[21IR] Corral
188287771,ᅟᅠᅠᅠᅠᅟᅠᅠᅠᅠ ᅟᅠᅠ,14175551,55673152,491916,382510,936262,319444,5244635,0,6882851,5244635,0,5064638544,2464968833,28979,[LG21]Lords of Gondor
123456386,Igoryan,14172873,5049921,193112,1352415,222892,143876,374139,838,2094160,374977,0,1478356936,11392165,1401,[LG21]Lords of Gondor
191177358,RtthyrFarm,14056274,52258,8925,14892,0,0,4928,0,19820,4928,0,3699450306,1594265331,1172,[LG21]Lords of Gondor
188931757,ᴸʳANTHRAX,14054197,659165,84307,164935,187652,32931,11915,0,397433,11915,0,1443661971,0,2114,[LR21]Lords of Rohan
170835406,ᴵᶜ Has,14053933,1445859,679890,46009,32626,7559,101847,16135,204176,117982,0,687055286,298517,2941,[P21J]PETANI IDAMAN
188787790,You  andl,13935346,920284,416012,51124,134014,82128,31352,0,298618,31352,0,1412946338,4084888,1977,[LR21]Lords of Rohan
188896546,БорисBao,13921093,1182765,168254,14668,118405,170863,25957,0,329893,25957,0,1761224189,22966398,1424,[LR21]Lords of Rohan
188953179,SarahVinyard017,13756390,5795264,260817,103502,87804,304494,438098,0,933898,438098,0,1388844714,31860199,3832,[LG21]Lords of Gondor
44936497,젝스킹,15991483,6996924,923387,39204,54846,41378,523118,74135,732681,597253,0,2183506756,0,9052,-
188837379,안정아남자,13532978,885792,199719,262430,137821,8581,52334,0,461166,52334,0,1917866876,0,1130,[LG21]Lords of Gondor
188527602,ᴵᴰROK 쵸 F2P,13501305,5484083,995214,421857,345578,97039,416904,7568,1288946,424472,0,1569741955,727650,10325,[P21J]PETANI IDAMAN
187795145,SOTER,13473232,8447735,539910,529189,65018,309343,652149,22650,1578349,674799,0,1286481653,112215799,15319,[LG21]Lords of Gondor
186073361,卂尺丂Farm,13435636,4138657,585035,39537,204145,32135,344752,7320,627889,352072,0,2286157342,489706596,1515,[LG21]Lords of Gondor
190539451,puyolF,13378927,972686,309560,2673,66571,105265,41795,0,216304,41795,0,4872503044,1818372170,2109,[LR21]Lords of Rohan
188899884,hanaaaa230,13288125,3656113,993138,112016,538707,284659,141766,0,1077148,141766,0,1564402163,3785937,1120,[K~R~]3621 Utility Box
191069538,Shinnygamyy,13280650,3037148,499817,235031,755080,228183,56725,0,1275019,56725,0,1083252012,5089962,691,-
193596249,Korkusuz 51,13257437,239160,358859,12402,0,0,23668,0,36070,23668,0,1407021399,60357336,945,[LR21]Lords of Rohan
187257305,HolySpirits,13242258,4186335,271743,116035,83670,59317,375642,105,634769,375747,0,1170651113,477259605,5805,[21If]Immortal Falcons
188836866,zlucifer,13134321,2684582,271491,220751,328964,145856,139908,0,835479,139908,0,1701695970,0,1524,-
185484265,Tors228,13083005,7740094,636018,1305674,1878812,627539,120762,178,3932965,120940,0,1312958755,25325363,7376,-
188887466,Jensamtresen,12961460,2851467,834974,287219,392239,254799,99035,0,1033292,99035,0,880825536,10799999,842,[I-am]RoyalLoyalMembers
188817273,Munmon,12901737,1116310,211912,39551,42589,125343,52185,0,259668,52185,0,2476678488,0,125,-
188845348,ᴸʳLUNICTUS,12877100,104914,26926,6884,16888,8978,3385,0,36135,3385,0,1558632979,0,455,[LR21]Lords of Rohan
188292201,쵸Bear,12762411,3636617,863462,127956,652623,13205,183272,21012,998068,204284,0,1398516677,0,8400,-
192581999,LilitЛиса,12617394,4558817,2586,4079,12074,27936,442211,0,486300,442211,0,2146012730,534525710,3630,[LG21]Lords of Gondor
185259121,Lets go Os,12545484,913938,1168728,282,16846,7330,13445,35821,73724,49266,0,1391127407,4800000,1593,[LG21]Lords of Gondor
188816893,WARRIOR FARM 10,12426418,242793,17769,22009,47558,10254,10226,0,90047,10226,0,1323090834,0,1897,[21If]Immortal Falcons
188986347,Pimpammm,12386241,390745,21517,13926,70135,29655,12907,0,126623,12907,0,1444868924,9172286,4484,[OP1]OP CLAN
190430624,IMPERADOR FARM,12382505,449281,436505,3716,0,322,44725,0,48763,44725,0,5068932051,2527734725,1628,[LR21]Lords of Rohan
189266244,ᴵᴾRágnär,12376390,2424921,681640,338989,350984,104124,70352,26757,891206,97109,0,245500638,11642489,7444,-
142371438,NokedliF11,12328082,3005981,754566,516818,830716,67154,61715,17771,1494174,79486,0,1498984833,2400001,10466,[21M]Immortal Myrmidons
187384799,C H A D 3 3 3,12226072,5025006,638494,336794,550030,58137,356220,3142,1304323,359362,0,969988533,0,4554,[LG21]Lords of Gondor
188829162,Mkジinsane,12152527,911799,856240,15867,56941,24326,65024,2360,164518,67384,0,1543783586,1400000,3486,[LR21]Lords of Rohan
188880051,qftydhunvfezbjj,12100235,18338939,1337013,1249255,1030656,1111224,1086802,35743,4513680,1122545,0,1422326310,88951930,7822,-
188900034,Rajpoots,12053765,854381,223016,55556,81433,13291,62724,0,213004,62724,0,1893809035,0,3120,[LG21]Lords of Gondor
174523518,ㅡᅟᅟF2P 5      ㅡ,12034288,4068578,375472,858694,1490716,123637,42086,0,2515133,42086,0,2291150995,968382628,2432,[LG21]Lords of Gondor
188838338,boble 79,12033618,306757,46338,1697,52760,41937,3315,0,99709,3315,0,1300050270,0,2122,[21MA]Myrmidons Academy
188479340,ㅡᅟᅟF2P 8      ㅡ,12006938,9974813,173571,883535,766581,262971,721306,0,2634393,721306,0,2771982621,1052471741,8854,[LG21]Lords of Gondor
187155907,Yuzhi,11986637,5032590,1641848,115533,189407,294655,290433,27386,917414,317819,0,2090220211,257605,2042,[LR21]Lords of Rohan
188217778,ᴵᴰKing Nemo,11974922,1852509,716667,684238,272077,322,117022,0,1073659,117022,0,1857331281,0,12936,-
188952266,ErDegui,11875134,7108681,230822,125436,58773,125367,620570,12944,943090,633514,0,1173596936,13045768,5398,[LG21]Lords of Gondor
188856725,Uranusuki,11829837,268924,32838,25630,66282,25841,2787,0,120540,2787,0,922767627,3859996,770,[LR21]Lords of Rohan
188819203,Cominogr,11807027,347521,71452,268238,123679,11074,222,0,403213,222,0,1723850337,0,850,[ANTB]ANnti Banned Club
188946350,BaabyyKiller,11764448,45777543,823248,1480408,3397133,2896319,2635750,37221,10446831,2672971,0,1760569996,20189360,9196,-
188818957,alonsoisma,11737083,2300239,762386,25316,47973,75270,189815,0,338374,189815,0,1612886353,4826393,1448,[LR21]Lords of Rohan
188900167,Charles grand 3,11690176,4207791,779277,591939,722430,168606,197012,0,1679987,197012,0,1829277574,8400000,919,[Tick]Tick tack
189182502,ᴵᶜVatson67F,11756444,137197,213594,1669,4693,617,12501,0,19480,12501,0,3613185611,1724148322,1626,[LR21]Lords of Rohan
188818543,GodAnubis,11647240,3265470,842158,347813,333503,280538,140675,0,1102529,140675,0,1282926149,473118,760,[21IR] Corral
188887462,Dunks,11620870,1538565,760926,36818,198678,122594,64347,0,422437,64347,0,1107672787,0,1042,[LR21]Lords of Rohan
188363322,쵸Belmont,11471499,726781,18931,225245,250029,43961,583,0,519818,583,0,1185584888,1410552,11058,-
188892262,Udi lopez,11470185,286475,30519,120358,27289,7419,17815,0,172881,17815,0,262310618,3001045,1861,[LR21]Lords of Rohan
188840730,FurkiTolki,11383252,1839593,1140153,3217,12856,72657,143339,4461,236530,147800,0,1719741024,3600000,2061,[21M]Immortal Myrmidons
188320795,Fïshböy F1,11373165,1130852,410313,146172,398,5918,103727,1994,258209,105721,0,1584576737,949797406,1155,[LR21]Lords of Rohan
188839518,Zaragoza,11323627,1181120,88062,120100,376712,100919,0,0,597731,0,0,1454966383,0,1189,[LR21]Lords of Rohan
188885079,ᴵᶜnoobhuhu,11287294,4932153,869902,263679,640053,58918,316980,9692,1289322,326672,0,1694858992,26599999,5002,-
185877603,ㄴ Aurelio ㄱ,11234632,4346792,844942,194294,519109,17374,297056,11483,1039316,308539,0,931498099,1758080,3734,[LV21]Lords of Valinor
188307234,ᴵᵀJessyS2,11159564,3418968,138406,130180,168640,9783,301652,0,610255,301652,0,1509177777,180913621,6306,-
189182788,Vatson67f3,11090248,260412,485136,2684,4031,13106,19939,0,39760,19939,0,3612665479,1133268751,1385,[LR21]Lords of Rohan
189443468,Hubey,10948714,2171604,462536,189562,257421,35910,147521,0,630414,147521,0,918945909,0,1967,-
188817859,oktaev,10878918,401425,359467,33669,31021,2770,32157,0,99617,32157,0,1114304555,0,100,[DD21])Dragon of Death
189007908,vua đại du,10847143,2010095,594035,32817,68882,36737,135324,18279,292039,153603,0,1664459657,27506603,6095,-
188309795,ᴵᶜ TAZIEX,10844048,8618161,951227,435439,559362,399095,559725,10936,1964557,570661,0,1632163083,0,8839,-
184327666,ツاحمدᴰᴮ,10787543,3839828,551833,681132,488185,101508,178100,27010,1475935,205110,0,1467445432,72130,2677,[LV21]Lords of Valinor
189227933,Z  Hot Rain  Z,10762707,6460378,866429,52143,3457,47844,612586,6290,722320,618876,0,1457174944,13707113,1796,-
117517315,ᴵᶜBOTAN,10684766,13712356,945529,506093,1444925,965222,611992,37024,3565256,649016,0,1235813199,498018246,20006,-
195403312,môngcổ,10679885,1446809,783623,85946,65345,87040,95077,0,333408,95077,0,1304034577,0,1075,[LG21]Lords of Gondor
188847841,Lj1208,10615508,314850,314434,984,0,1961,30681,0,33626,30681,0,1181089928,0,908,[21If]Immortal Falcons
189442766,Gubernur189442766,10435474,77204,41779,1313,9937,12737,612,0,24599,612,0,2621620590,2133430704,726,[21IR] Corral
188889920,Carolk,10419143,642390,541227,49383,96269,35954,29616,0,211222,29616,0,1174456889,1349311,322,[fagr]alpha table
188300029,Hoàng Saa,10378165,5137985,463048,87026,120041,279872,368511,3795,859245,372306,0,1338421191,9873378,8186,[LR21]Lords of Rohan
188881481,678907,10362415,4054167,576543,566707,812285,378314,80300,0,1837606,80300,0,1310067063,53227,1533,[LLA]Lost legion academia
188522411,Ваn,10346788,1095208,3365,36724,120447,26500,74097,0,257768,74097,0,727419882,1,2219,[21If]Immortal Falcons
188899095,Minuz,10287287,1614469,364375,167345,306671,102167,55899,0,632082,55899,0,733441492,0,1706,[LR21]Lords of Rohan
189285062,Linh farm 2,10273048,9739359,1413236,1086939,10938,8479,938116,4251,2048723,942367,0,5574932448,3128768761,1836,[LR21]Lords of Rohan
188295840,ッ Yakuza ッ 6,10205094,395204,0,3871,70818,40591,9043,0,124323,9043,0,992758872,82882904,4856,[21if]farm 21If
188906315,ᴵᶜИвaн,10194251,1248369,45240,148765,274837,58418,43527,0,525547,43527,0,943901017,16348226,12804,-
194265891,쵸MØTÃSÊMツ쵸 2,10176084,2387465,0,5126,24684,21098,225268,0,276176,225268,0,1525988624,125453620,1412,[LG21]Lords of Gondor
188721766,ᴵᶜZver225,10146168,5600948,578427,272790,772945,368830,252518,0,1667083,252518,0,1282562432,205403656,7602,[LG21]Lords of Gondor
188840603,andyrendy,10073872,1722850,894100,10373,99042,247058,53446,0,409919,53446,0,1032365452,0,459,[Slon]Slonii
188857096,Di 1,10019335,909985,10470,103819,160058,85834,22577,0,372288,22577,0,934774982,1843151,2952,-
188840453,La pampara,10010303,4378816,1599817,200050,433845,478194,131470,12182,1255741,143652,0,1516899680,0,334,[21if]farm 21If
188846435,psilva3,9925288,1390439,255473,331056,379662,122656,7428,0,840802,7428,0,968145455,0,590,[21IR] Corral
189869613,Алёнааа,9918709,3146615,691598,31047,82951,360086,153416,0,627500,153416,0,1480925043,503089664,1096,[GW21]GOATED WARRIORS
188898591,Dthomas,9838220,468487,81006,125157,122286,22516,10882,0,280841,10882,0,434478065,0,1343,[LR21]Lords of Rohan
188471943,NoCoboY,9816138,413116,95171,64153,54918,15880,22693,0,157644,22693,0,1081418218,0,3619,[LG21]Lords of Gondor
188790900,Dom Daddy,9639298,3388766,1222043,27914,83403,91562,276497,4258,483634,280755,0,1789483737,0,1454,[OP1]OP CLAN
186065635,MASONFTW WOOD,9644265,1910931,810165,6189,9403,5772,186780,0,208144,186780,0,1731802176,950725213,1297,[LR21]Lords of Rohan
191785327,ᴿᵃQueen,9625702,3017237,247312,228656,300820,10824,232657,0,772957,232657,0,2123392947,813781963,1187,[LR21]Lords of Rohan
186988267,Panda ᴸᴺ,9616784,2766515,1120377,7927,2980,11995,264463,3318,290683,267781,0,3082740466,512115698,1981,-
188962647,卂几Ҝ卂2,9578262,2082291,325396,3405,6149,30163,194866,0,234583,194866,0,1618176948,1219440595,2004,[LR21]Lords of Rohan
188815675,KōbøLord,9517898,145859,16647,15805,9235,19277,4712,0,49029,4712,0,843374303,0,1696,[LR21]Lords of Rohan
188462426,Tysson,9512419,1483696,191746,163161,372581,171003,2189,0,708934,2189,0,647738981,310,4388,[21MA]Myrmidons Academy
189238085,Christian33,9500256,471496,125768,75854,103315,62424,0,0,241593,0,0,720550091,0,1591,[21LK]legionary knight
188844276,tori,9474748,213019,54967,3007,1985,1182,20372,0,26546,20372,0,489310087,0,916,[21If]Immortal Falcons
188308863,Rock Farm ll,9385339,10088421,459789,450027,1066779,575927,546551,4782,2644066,551333,0,737133728,45352280,6170,-
188560833,Gorgona,9371349,1635913,58059,135968,120817,4039,135093,0,395917,135093,0,379010693,1749999,1348,[LR21]Lords of Rohan
